"Year","Team","Win","Loss","Tie","Pct","PF","PA","Delta","coach"
"1956","Air Force (CO)","6","2","1","0.72222","293","101","192","Lawrence T. ""Buck"" Shaw"
"1957","Air Force (CO)","3","6","1","0.35","125","184","-59","Lawrence T. ""Buck"" Shaw"
"1958","Air Force (CO)","9","0","2","0.90909","247","102","145","Ben Martin"
"1959","Air Force (CO)","5","4","1","0.55","160","124","36","Ben Martin"
"1960","Air Force (CO)","4","6","0","0.4","147","178","-31","Ben Martin"
"1961","Air Force (CO)","3","7","0","0.3","87","173","-86","Ben Martin"
"1962","Air Force (CO)","5","5","0","0.5","173","171","2","Ben Martin"
"1963","Air Force (CO)","7","4","0","0.63636","249","150","99","Ben Martin"
"1964","Air Force (CO)","4","5","1","0.45","106","146","-40","Ben Martin"
"1965","Air Force (CO)","3","6","1","0.35","166","156","10","Ben Martin"
"1966","Air Force (CO)","4","6","0","0.4","154","161","-7","Ben Martin"
"1967","Air Force (CO)","2","6","2","0.3","86","173","-87","Ben Martin"
"1968","Air Force (CO)","7","3","0","0.7","251","156","95","Ben Martin"
"1969","Air Force (CO)","6","4","0","0.6","267","177","90","Ben Martin"
"1970","Air Force (CO)","9","3","0","0.75","356","239","117","Ben Martin"
"1971","Air Force (CO)","6","4","0","0.6","187","187","0","Ben Martin"
"1972","Air Force (CO)","6","4","0","0.6","303","183","120","Ben Martin"
"1973","Air Force (CO)","6","4","0","0.6","223","239","-16","Ben Martin"
"1974","Air Force (CO)","2","9","0","0.18182","178","215","-37","Ben Martin"
"1975","Air Force (CO)","2","8","1","0.22727","156","265","-109","Ben Martin"
"1976","Air Force (CO)","4","7","0","0.36364","180","273","-93","Ben Martin"
"1977","Air Force (CO)","2","8","1","0.22727","114","296","-182","Ben Martin"
"1978","Air Force (CO)","3","8","0","0.27273","215","328","-113","Bill Parcells"
"1979","Air Force (CO)","2","9","0","0.18182","127","253","-126","Ken Hatfield"
"1980","Air Force (CO)","2","9","1","0.20833","161","290","-129","Ken Hatfield"
"1981","Air Force (CO)","4","7","0","0.36364","171","252","-81","Ken Hatfield"
"1982","Air Force (CO)","8","5","0","0.61538","395","367","28","Ken Hatfield"
"1983","Air Force (CO)","10","2","0","0.83333","367","221","146","Ken Hatfield"
"1984","Air Force (CO)","8","4","0","0.66667","369","198","171","Fisher DeBerry"
"1985","Air Force (CO)","12","1","0","0.92308","470","179","291","Fisher DeBerry"
"1986","Air Force (CO)","6","5","0","0.54545","229","215","14","Fisher DeBerry"
"1987","Air Force (CO)","9","4","0","0.69231","405","269","136","Fisher DeBerry"
"1988","Air Force (CO)","5","7","0","0.41667","422","392","30","Fisher DeBerry"
"1989","Air Force (CO)","8","4","1","0.65385","474","358","116","Fisher DeBerry"
"1990","Air Force (CO)","7","5","0","0.58333","262","283","-21","Fisher DeBerry"
"1991","Air Force (CO)","10","3","0","0.76923","382","263","119","Fisher DeBerry"
"1992","Air Force (CO)","7","5","0","0.58333","229","238","-9","Fisher DeBerry"
"1993","Air Force (CO)","4","8","0","0.33333","296","291","5","Fisher DeBerry"
"1994","Air Force (CO)","8","4","0","0.66667","371","285","86","Fisher DeBerry"
"1995","Air Force (CO)","8","5","0","0.61538","401","358","43","Fisher DeBerry"
"1996","Air Force (CO)","6","5","0","0.54545","360","231","129","Fisher DeBerry"
"1997","Air Force (CO)","10","3","0","0.76923","279","190","89","Fisher DeBerry"
"1998","Air Force (CO)","12","1","0","0.92308","468","185","283","Fisher DeBerry"
"1999","Air Force (CO)","6","5","0","0.54545","264","218","46","Fisher DeBerry"
"2000","Air Force (CO)","9","3","0","0.75","421","312","109","Fisher DeBerry"
"2001","Air Force (CO)","6","6","0","0.5","337","386","-49","Fisher DeBerry"
"2002","Air Force (CO)","8","5","0","0.61538","440","303","137","Fisher DeBerry"
"2003","Air Force (CO)","7","5","0","0.58333","322","242","80","Fisher DeBerry"
"2004","Air Force (CO)","5","6","0","0.45455","326","342","-16","Fisher DeBerry"
"2005","Air Force (CO)","4","7","0","0.36364","330","349","-19","Fisher DeBerry"
"2006","Air Force (CO)","4","8","0","0.33333","279","302","-23","Fisher DeBerry"
"2007","Air Force (CO)","9","4","0","0.69231","389","274","115","Troy Calhoun"
"2008","Air Force (CO)","8","5","0","0.61538","348","289","59","Troy Calhoun"
"2009","Air Force (CO)","8","5","0","0.61538","386","204","182","Troy Calhoun"
"2010","Air Force (CO)","9","4","0","0.69231","401","274","127","Troy Calhoun"
"2011","Air Force (CO)","7","6","0","0.53846","454","369","85","Troy Calhoun"
"2012","Air Force (CO)","6","7","0","0.46154","356","377","-21","Troy Calhoun"
"2013","Air Force (CO)","2","10","0","0.16667","296","480","-184","Troy Calhoun"
"2014","Air Force (CO)","10","3","0","0.76923","409","314","95","Troy Calhoun"
"1900","Akron (OH)","23","41","11","0.38","475","780","-305","No Coach"
"1892","Akron (OH)","3","4","0","0.42857","69","180","-111","Frank Cook"
"1893","Akron (OH)","5","2","0","0.71429","276","82","194","John W. Heisman"
"1894","Akron (OH)","1","0","0","1","12","6","6","John W. Heisman"
"1896","Akron (OH)","0","1","0","0","0","36","-36","Harry Wilson"
"1899","Akron (OH)","2","1","0","0.66667","26","11","15","Archie Eves"
"1902","Akron (OH)","2","5","0","0.28571","34","163","-129","Forest Firestone"
"1903","Akron (OH)","1","2","0","0.33333","11","43","-32","Rev. Alfred Place"
"1908","Akron (OH)","3","4","0","0.42857","32","80","-48","Dr. Dwight Bradley"
"1909","Akron (OH)","4","4","0","0.5","54","69","-15","Clarence Weed"
"1910","Akron (OH)","7","2","0","0.77778","136","83","53","Frank Haggerty"
"1911","Akron (OH)","3","4","1","0.4375","80","24","56","Frank Haggerty"
"1912","Akron (OH)","5","2","1","0.6875","105","36","69","Frank Haggerty"
"1913","Akron (OH)","3","4","0","0.42857","87","103","-16","Frank Haggerty"
"1914","Akron (OH)","4","4","1","0.5","122","134","-12","Frank Haggerty"
"1915","Akron (OH)","1","7","1","0.16667","20","239","-219","Fred Sefton"
"1916","Akron (OH)","2","7","0","0.22222","90","183","-93","Fred Sefton"
"1917","Akron (OH)","5","3","0","0.625","143","84","59","Fred Sefton"
"1918","Akron (OH)","2","2","1","0.5","69","47","22","Fred Sefton"
"1919","Akron (OH)","6","1","1","0.8125","139","38","101","Fred Sefton"
"1920","Akron (OH)","4","4","0","0.5","99","93","6","Fred Sefton"
"1921","Akron (OH)","5","3","0","0.625","117","69","48","Fred Sefton"
"1922","Akron (OH)","5","3","0","0.625","141","53","88","Fred Sefton"
"1923","Akron (OH)","4","3","1","0.5625","92","37","55","Fred Sefton"
"1924","Akron (OH)","5","3","0","0.625","89","75","14","James Coleman"
"1925","Akron (OH)","1","7","0","0.125","17","150","-133","James Coleman"
"1926","Akron (OH)","5","2","2","0.66667","107","74","33","George Babcock"
"1927","Akron (OH)","5","3","0","0.625","144","79","65","Howard H. ""Red"" Blair"
"1928","Akron (OH)","5","4","0","0.55556","158","99","59","Howard H. ""Red"" Blair"
"1929","Akron (OH)","9","1","0","0.9","149","21","128","Howard H. ""Red"" Blair"
"1930","Akron (OH)","7","1","0","0.875","130","38","92","Howard H. ""Red"" Blair"
"1931","Akron (OH)","1","7","0","0.125","38","115","-77","Howard H. ""Red"" Blair"
"1932","Akron (OH)","2","4","3","0.38889","37","92","-55","Howard H. ""Red"" Blair"
"1933","Akron (OH)","5","3","1","0.61111","97","50","47","Howard H. ""Red"" Blair"
"1934","Akron (OH)","3","4","1","0.4375","65","48","17","Howard H. ""Red"" Blair"
"1935","Akron (OH)","6","3","0","0.66667","81","71","10","Howard H. ""Red"" Blair"
"1936","Akron (OH)","6","2","1","0.72222","150","87","63","James W. ""Jim"" Aiken"
"1937","Akron (OH)","7","2","0","0.77778","139","53","86","James W. ""Jim"" Aiken"
"1938","Akron (OH)","6","3","0","0.66667","117","94","23","James W. ""Jim"" Aiken"
"1939","Akron (OH)","5","4","0","0.55556","122","129","-7","Thomas W. ""Tommy"" Dowler"
"1940","Akron (OH)","2","5","2","0.33333","90","106","-16","Thomas W. ""Tommy"" Dowler"
"1941","Akron (OH)","5","3","1","0.61111","114","76","38","Otis Douglas"
"1942","Akron (OH)","0","7","2","0.11111","26","183","-157","Otis Douglas"
"1946","Akron (OH)","5","4","0","0.55556","122","135","-13","Paul Baldacci"
"1947","Akron (OH)","2","6","0","0.25","44","162","-118","Paul Baldacci"
"1948","Akron (OH)","2","6","0","0.25","46","146","-100","William Houghton"
"1949","Akron (OH)","2","6","1","0.27778","114","257","-143","William Houghton"
"1950","Akron (OH)","2","7","0","0.22222","131","185","-54","William Houghton"
"1951","Akron (OH)","1","8","0","0.11111","115","252","-137","William Houghton"
"1952","Akron (OH)","2","6","1","0.27778","121","156","-35","Ken ""Red"" Cochrane"
"1953","Akron (OH)","6","3","0","0.66667","198","210","-12","Ken ""Red"" Cochrane"
"1954","Akron (OH)","3","5","0","0.375","169","233","-64","Joe McMullen"
"1955","Akron (OH)","6","2","0","0.75","245","73","172","Joe McMullen"
"1956","Akron (OH)","3","5","1","0.38889","216","171","45","Joe McMullen"
"1957","Akron (OH)","7","1","1","0.83333","208","87","121","Joe McMullen"
"1958","Akron (OH)","6","2","1","0.72222","166","82","84","Joe McMullen"
"1959","Akron (OH)","4","5","0","0.44444","111","155","-44","Joe McMullen"
"1960","Akron (OH)","1","8","0","0.11111","70","269","-199","Joe McMullen"
"1961","Akron (OH)","6","2","0","0.75","185","57","128","Gondon Larson"
"1962","Akron (OH)","7","2","0","0.77778","261","65","196","Gondon Larson"
"1963","Akron (OH)","6","3","0","0.66667","201","102","99","Gondon Larson"
"1964","Akron (OH)","6","3","0","0.66667","116","109","7","Gondon Larson"
"1965","Akron (OH)","5","3","1","0.61111","110","93","17","Gondon Larson"
"1966","Akron (OH)","6","3","0","0.66667","137","116","21","Gondon Larson"
"1967","Akron (OH)","4","4","1","0.5","162","155","7","Gondon Larson"
"1968","Akron (OH)","7","3","1","0.68182","327","172","155","Gondon Larson"
"1969","Akron (OH)","9","1","0","0.9","316","103","213","Gondon Larson"
"1970","Akron (OH)","7","3","0","0.7","259","92","167","Gondon Larson"
"1971","Akron (OH)","8","2","0","0.8","193","119","74","Gondon Larson"
"1972","Akron (OH)","3","4","2","0.44444","193","148","45","Gondon Larson"
"1973","Akron (OH)","6","5","0","0.54545","289","204","85","Jim Dennison"
"1974","Akron (OH)","5","5","0","0.5","162","197","-35","Jim Dennison"
"1975","Akron (OH)","7","4","0","0.63636","189","166","23","Jim Dennison"
"1976","Akron (OH)","10","3","0","0.76923","282","144","138","Jim Dennison"
"1977","Akron (OH)","6","4","1","0.59091","234","170","64","Jim Dennison"
"1978","Akron (OH)","6","5","0","0.54545","221","232","-11","Jim Dennison"
"1979","Akron (OH)","6","5","0","0.54545","232","223","9","Jim Dennison"
"1980","Akron (OH)","3","7","1","0.31818","134","183","-49","Jim Dennison"
"1981","Akron (OH)","5","5","0","0.5","132","183","-51","Jim Dennison"
"1982","Akron (OH)","6","5","0","0.54545","188","144","44","Jim Dennison"
"1983","Akron (OH)","8","3","0","0.72727","210","104","106","Jim Dennison"
"1984","Akron (OH)","4","7","0","0.36364","205","167","38","Jim Dennison"
"1985","Akron (OH)","8","4","0","0.66667","258","186","72","Jim Dennison"
"1986","Akron (OH)","7","4","0","0.63636","291","188","103","Gerry Faust"
"1987","Akron (OH)","4","7","0","0.36364","204","273","-69","Gerry Faust"
"1988","Akron (OH)","5","6","0","0.45455","233","214","19","Gerry Faust"
"1989","Akron (OH)","6","4","1","0.59091","296","241","55","Gerry Faust"
"1990","Akron (OH)","3","7","1","0.31818","233","263","-30","Gerry Faust"
"1991","Akron (OH)","5","6","0","0.45455","257","308","-51","Gerry Faust"
"1992","Akron (OH)","7","3","1","0.68182","218","186","32","Gerry Faust"
"1993","Akron (OH)","5","6","0","0.45455","192","222","-30","Gerry Faust"
"1994","Akron (OH)","1","10","0","0.09091","145","404","-259","Gerry Faust"
"1995","Akron (OH)","2","9","0","0.18182","141","428","-287","Lee Owens"
"1996","Akron (OH)","4","7","0","0.36364","175","269","-94","Lee Owens"
"1997","Akron (OH)","2","9","0","0.18182","218","435","-217","Lee Owens"
"1998","Akron (OH)","4","7","0","0.36364","265","299","-34","Lee Owens"
"1999","Akron (OH)","7","4","0","0.63636","315","314","1","Lee Owens"
"2000","Akron (OH)","6","5","0","0.54545","333","295","38","Lee Owens"
"2001","Akron (OH)","4","7","0","0.36364","281","360","-79","Lee Owens"
"2002","Akron (OH)","4","8","0","0.33333","325","379","-54","Lee Owens"
"2003","Akron (OH)","7","5","0","0.58333","435","353","82","Lee Owens"
"2004","Akron (OH)","6","5","0","0.54545","271","347","-76","J.D. Brookhart"
"2005","Akron (OH)","7","6","0","0.53846","307","318","-11","J.D. Brookhart"
"2006","Akron (OH)","5","7","0","0.41667","236","271","-35","J.D. Brookhart"
"2007","Akron (OH)","4","8","0","0.33333","254","350","-96","J.D. Brookhart"
"2008","Akron (OH)","5","7","0","0.41667","360","375","-15","J.D. Brookhart"
"2009","Akron (OH)","3","9","0","0.25","231","345","-114","J.D. Brookhart"
"2010","Akron (OH)","1","11","0","0.08333","187","421","-234","Rob Ianello"
"2011","Akron (OH)","1","11","0","0.08333","170","462","-292","Rob Ianello"
"2012","Akron (OH)","1","11","0","0.08333","313","428","-115","Terry Bowden"
"2013","Akron (OH)","5","7","0","0.41667","242","343","-101","Terry Bowden"
"2014","Akron (OH)","5","7","0","0.41667","271","277","-6","Terry Bowden"
"1980","Appalachian St. (NC)","6","4","1","0.59091","273","186","87","Mike Working"
"1981","Appalachian St. (NC)","3","7","1","0.31818","236","201","35","Mike Working"
"1982","Appalachian St. (NC)","4","7","0","0.36364","270","286","-16","Mike Working"
"1983","Appalachian St. (NC)","6","5","0","0.54545","212","265","-53","Mack Brown"
"1984","Appalachian St. (NC)","4","7","0","0.36364","151","218","-67","Sparky Woods"
"1985","Appalachian St. (NC)","8","3","0","0.72727","260","109","151","Sparky Woods"
"1986","Appalachian St. (NC)","9","2","1","0.79167","351","176","175","Sparky Woods"
"1987","Appalachian St. (NC)","11","3","0","0.78571","270","153","117","Sparky Woods"
"1988","Appalachian St. (NC)","6","4","1","0.59091","324","233","91","Sparky Woods"
"1989","Appalachian St. (NC)","9","3","0","0.75","306","177","129","Jerry Moore"
"1990","Appalachian St. (NC)","6","5","0","0.54545","171","266","-95","Jerry Moore"
"1991","Appalachian St. (NC)","8","4","0","0.66667","215","202","13","Jerry Moore"
"1992","Appalachian St. (NC)","7","5","0","0.58333","262","237","25","Jerry Moore"
"1993","Appalachian St. (NC)","4","7","0","0.36364","207","252","-45","Jerry Moore"
"1994","Appalachian St. (NC)","9","4","0","0.69231","363","209","154","Jerry Moore"
"1995","Appalachian St. (NC)","12","1","0","0.92308","375","251","124","Jerry Moore"
"1996","Appalachian St. (NC)","7","4","0","0.63636","223","196","27","Jerry Moore"
"1997","Appalachian St. (NC)","7","4","0","0.63636","294","215","79","Jerry Moore"
"1998","Appalachian St. (NC)","10","3","0","0.76923","356","222","134","Jerry Moore"
"1999","Appalachian St. (NC)","9","3","0","0.75","369","219","150","Jerry Moore"
"2000","Appalachian St. (NC)","10","4","0","0.71429","441","278","163","Jerry Moore"
"2001","Appalachian St. (NC)","9","4","0","0.69231","411","278","133","Jerry Moore"
"2002","Appalachian St. (NC)","8","4","0","0.66667","314","273","41","Jerry Moore"
"2003","Appalachian St. (NC)","7","4","0","0.63636","252","219","33","Jerry Moore"
"2004","Appalachian St. (NC)","6","5","0","0.54545","366","358","8","Jerry Moore"
"2005","Appalachian St. (NC)","12","3","0","0.8","455","282","173","Jerry Moore"
"2006","Appalachian St. (NC)","14","1","0","0.93333","528","223","305","Jerry Moore"
"2007","Appalachian St. (NC)","13","2","0","0.86667","641","400","241","Jerry Moore"
"2008","Appalachian St. (NC)","11","3","0","0.78571","522","303","219","Jerry Moore"
"2009","Appalachian St. (NC)","11","3","0","0.78571","465","313","152","Jerry Moore"
"2010","Appalachian St. (NC)","10","3","0","0.76923","446","307","139","Jerry Moore"
"2011","Appalachian St. (NC)","8","4","0","0.66667","344","286","58","Jerry Moore"
"2012","Appalachian St. (NC)","8","4","0","0.66667","395","352","43","Jerry Moore"
"2013","Appalachian St. (NC)","4","8","0","0.33333","283","336","-53","Scott Satterfield"
"2014","Appalachian St. (NC)","7","5","0","0.58333","428","328","100","Scott Satterfield"
"1899","Arizona","2","1","1","0.625","29","16","13","Stuart Forbes"
"1900","Arizona","3","1","0","0.75","131","6","125","William Skinner"
"1901","Arizona","4","1","0","0.8","115","19","96","William Skinner"
"1902","Arizona","5","0","0","1","134","0","134","Leslie Gillett"
"1903","Arizona","2","0","0","1","41","10","31","Orin A. Kates"
"1904","Arizona","3","1","2","0.66667","66","48","18","Orin A. Kates"
"1905","Arizona","4","2","0","0.66667","84","96","-12","William M. Ruthrauff"
"1908","Arizona","5","0","0","1","136","6","130","H.B. Galbraith"
"1909","Arizona","3","1","0","0.75","71","23","48","H.B. Galbraith"
"1910","Arizona","5","0","0","1","87","8","79","George F. Shipp"
"1911","Arizona","3","1","1","0.7","16","3","13","George F. Shipp"
"1912","Arizona","2","1","0","0.66667","55","30","25","Raymond L. Quigley"
"1913","Arizona","2","2","0","0.5","26","42","-16","Frank A. King"
"1914","Arizona","5","1","0","0.83333","85","20","65","James F. ""Pop"" McKale"
"1915","Arizona","6","3","0","0.66667","152","34","118","James F. ""Pop"" McKale"
"1916","Arizona","5","3","0","0.625","247","93","154","James F. ""Pop"" McKale"
"1917","Arizona","3","2","0","0.6","118","41","77","James F. ""Pop"" McKale"
"1919","Arizona","7","1","0","0.875","253","19","234","James F. ""Pop"" McKale"
"1920","Arizona","6","1","0","0.85714","381","65","316","James F. ""Pop"" McKale"
"1921","Arizona","7","2","0","0.77778","418","68","350","James F. ""Pop"" McKale"
"1922","Arizona","6","3","0","0.66667","109","53","56","James F. ""Pop"" McKale"
"1923","Arizona","5","3","0","0.625","146","127","19","James F. ""Pop"" McKale"
"1924","Arizona","2","4","0","0.33333","40","93","-53","James F. ""Pop"" McKale"
"1925","Arizona","3","3","1","0.5","70","88","-18","James F. ""Pop"" McKale"
"1926","Arizona","5","1","1","0.78571","143","18","125","James F. ""Pop"" McKale"
"1927","Arizona","4","2","1","0.64286","165","59","106","James F. ""Pop"" McKale"
"1928","Arizona","5","1","2","0.75","152","110","42","James F. ""Pop"" McKale"
"1929","Arizona","7","1","0","0.875","182","22","160","James F. ""Pop"" McKale"
"1930","Arizona","6","1","1","0.8125","122","33","89","James F. ""Pop"" McKale"
"1931","Arizona","3","5","1","0.38889","72","149","-77","Fred Enke"
"1932","Arizona","4","5","0","0.44444","82","106","-24","A.W. Farwick"
"1933","Arizona","5","3","0","0.625","113","35","78","Gerald A. ""Tex"" Oliver"
"1934","Arizona","7","2","1","0.75","138","54","84","Gerald A. ""Tex"" Oliver"
"1935","Arizona","7","2","0","0.77778","218","45","173","Gerald A. ""Tex"" Oliver"
"1936","Arizona","5","2","3","0.65","190","54","136","Gerald A. ""Tex"" Oliver"
"1937","Arizona","8","2","0","0.8","194","88","106","Gerald A. ""Tex"" Oliver"
"1938","Arizona","3","6","0","0.33333","75","146","-71","Orian Landreth"
"1939","Arizona","6","4","0","0.6","109","113","-4","Miles W. Casteel"
"1940","Arizona","7","2","0","0.77778","204","83","121","Miles W. Casteel"
"1941","Arizona","7","3","0","0.7","253","146","107","Miles W. Casteel"
"1942","Arizona","6","4","0","0.6","189","139","50","Miles W. Casteel"
"1945","Arizona","5","0","0","1","193","12","181","Miles W. Casteel"
"1946","Arizona","4","4","2","0.5","218","136","82","Miles W. Casteel"
"1947","Arizona","5","4","1","0.55","233","241","-8","Miles W. Casteel"
"1948","Arizona","6","5","0","0.54545","167","246","-79","Miles W. Casteel"
"1949","Arizona","2","7","1","0.25","118","298","-180","Robert ""Bob"" Winslow"
"1950","Arizona","4","6","0","0.4","214","257","-43","Robert ""Bob"" Winslow"
"1951","Arizona","6","5","0","0.54545","246","270","-24","Robert ""Bob"" Winslow"
"1952","Arizona","6","4","0","0.6","285","155","130","Warren B. Woodson"
"1953","Arizona","4","5","1","0.45","234","181","53","Warren B. Woodson"
"1954","Arizona","7","3","0","0.7","385","215","170","Warren B. Woodson"
"1955","Arizona","5","4","1","0.55","184","169","15","Warren B. Woodson"
"1956","Arizona","4","6","0","0.4","180","182","-2","Warren B. Woodson"
"1957","Arizona","1","8","1","0.15","125","299","-174","Edward A. ""Ed"" Doherty"
"1958","Arizona","3","7","0","0.3","83","276","-193","Edward A. ""Ed"" Doherty"
"1959","Arizona","4","6","0","0.4","118","211","-93","Jim LaRue"
"1960","Arizona","7","3","0","0.7","233","152","81","Jim LaRue"
"1961","Arizona","8","1","1","0.85","288","131","157","Jim LaRue"
"1962","Arizona","5","5","0","0.5","134","171","-37","Jim LaRue"
"1963","Arizona","5","5","0","0.5","136","165","-29","Jim LaRue"
"1964","Arizona","6","3","1","0.65","147","76","71","Jim LaRue"
"1965","Arizona","3","7","0","0.3","77","172","-95","Jim LaRue"
"1966","Arizona","3","7","0","0.3","192","250","-58","Jim LaRue"
"1967","Arizona","3","6","1","0.35","162","231","-69","Darrell ""Dan"" Mudra"
"1968","Arizona","8","3","0","0.72727","186","149","37","Darrell ""Dan"" Mudra"
"1969","Arizona","3","7","0","0.3","210","276","-66","Bob Weber"
"1970","Arizona","4","6","0","0.4","168","213","-45","Bob Weber"
"1971","Arizona","5","6","0","0.45455","191","232","-41","Bob Weber"
"1972","Arizona","4","7","0","0.36364","226","271","-45","Bob Weber"
"1973","Arizona","8","3","0","0.72727","286","213","73","Jim Young"
"1974","Arizona","9","2","0","0.81818","263","174","89","Jim Young"
"1975","Arizona","9","2","0","0.81818","330","169","161","Jim Young"
"1976","Arizona","5","6","0","0.45455","283","273","10","Jim Young"
"1977","Arizona","5","7","0","0.41667","256","250","6","Tony Mason"
"1978","Arizona","5","6","0","0.45455","245","205","40","Tony Mason"
"1979","Arizona","6","5","1","0.54167","244","243","1","Tony Mason"
"1980","Arizona","5","6","0","0.45455","215","275","-60","Larry Smith"
"1981","Arizona","6","5","0","0.54545","253","205","48","Larry Smith"
"1982","Arizona","6","4","1","0.59091","311","219","92","Larry Smith"
"1983","Arizona","7","3","1","0.68182","343","188","155","Larry Smith"
"1984","Arizona","7","4","0","0.63636","272","192","80","Larry Smith"
"1985","Arizona","8","3","1","0.70833","252","146","106","Larry Smith"
"1986","Arizona","9","3","0","0.75","352","204","148","Larry Smith"
"1987","Arizona","4","4","3","0.5","263","220","43","Dick Tomey"
"1988","Arizona","7","4","0","0.63636","279","218","61","Dick Tomey"
"1989","Arizona","8","4","0","0.66667","248","178","70","Dick Tomey"
"1990","Arizona","7","5","0","0.58333","267","311","-44","Dick Tomey"
"1991","Arizona","4","7","0","0.36364","248","361","-113","Dick Tomey"
"1992","Arizona","6","5","1","0.54167","232","118","114","Dick Tomey"
"1993","Arizona","10","2","0","0.83333","294","161","133","Dick Tomey"
"1994","Arizona","8","4","0","0.66667","278","190","88","Dick Tomey"
"1995","Arizona","6","5","0","0.54545","207","199","8","Dick Tomey"
"1996","Arizona","5","6","0","0.45455","310","280","30","Dick Tomey"
"1997","Arizona","7","5","0","0.58333","317","312","5","Dick Tomey"
"1998","Arizona","12","1","0","0.92308","439","236","203","Dick Tomey"
"1999","Arizona","6","6","0","0.5","339","364","-25","Dick Tomey"
"2000","Arizona","5","6","0","0.45455","254","237","17","Dick Tomey"
"2001","Arizona","5","6","0","0.45455","320","377","-57","John Mackovic"
"2002","Arizona","4","8","0","0.33333","227","310","-83","John Mackovic"
"2003","Arizona","1","4","0","0.2","82","186","-104","John Mackovic"
"2003","Arizona","1","6","0","0.14286","99","243","-144","Mike Hankwitz"
"2004","Arizona","3","8","0","0.27273","164","275","-111","Mike Stoops"
"2005","Arizona","3","8","0","0.27273","252","290","-38","Mike Stoops"
"2006","Arizona","6","6","0","0.5","199","235","-36","Mike Stoops"
"2007","Arizona","5","7","0","0.41667","336","322","14","Mike Stoops"
"2008","Arizona","8","5","0","0.61538","476","277","199","Mike Stoops"
"2009","Arizona","8","5","0","0.61538","356","311","45","Mike Stoops"
"2010","Arizona","7","6","0","0.53846","367","295","72","Mike Stoops"
"2011","Arizona","1","5","0","0.16667","164","225","-61","Mike Stoops"
"2011","Arizona","3","3","0","0.5","205","200","5","Tim Kish"
"2012","Arizona","8","5","0","0.61538","496","459","37","Rich Rodriguez"
"2013","Arizona","8","5","0","0.61538","435","315","120","Rich Rodriguez"
"2014","Arizona","10","4","0","0.71429","483","395","88","Rich Rodriguez"
"1896","Arizona St.","0","1","0","0","20","38","-18","Frederick M. Irish"
"1899","Arizona St.","3","0","0","1","23","2","21","Frederick M. Irish"
"1900","Arizona St.","2","2","0","0.5","31","11","20","Frederick M. Irish"
"1902","Arizona St.","2","1","0","0.66667","73","12","61","Frederick M. Irish"
"1903","Arizona St.","2","0","0","1","33","0","33","Frederick M. Irish"
"1904","Arizona St.","4","0","0","1","116","0","116","Frederick M. Irish"
"1905","Arizona St.","0","3","0","0","8","28","-20","Frederick M. Irish"
"1906","Arizona St.","0","2","0","0","6","22","-16","Frederick M. Irish"
"1914","Arizona St.","4","3","0","0.57143","143","97","46","George H. Schaeffer"
"1915","Arizona St.","3","2","0","0.6","125","36","89","George H. Schaeffer"
"1916","Arizona St.","0","3","0","0","13","51","-38","George H. Schaeffer"
"1919","Arizona St.","0","2","0","0","3","104","-101","George Cooper"
"1922","Arizona St.","0","3","1","0.125","31","74","-43","Ernest C. Wills"
"1923","Arizona St.","4","2","0","0.66667","152","102","50","Aaron M. McCreary"
"1924","Arizona St.","6","1","1","0.8125","160","85","75","Aaron M. McCreary"
"1925","Arizona St.","6","2","0","0.75","154","59","95","Aaron M. McCreary"
"1926","Arizona St.","4","1","1","0.75","97","42","55","Aaron M. McCreary"
"1927","Arizona St.","2","3","1","0.41667","63","50","13","Aaron M. McCreary"
"1928","Arizona St.","3","2","1","0.58333","133","73","60","Aaron M. McCreary"
"1929","Arizona St.","0","6","0","0","13","143","-130","Aaron M. McCreary"
"1930","Arizona St.","3","5","1","0.38889","111","94","17","Ted E. Shipkey"
"1931","Arizona St.","6","2","0","0.75","170","66","104","Ted E. Shipkey"
"1932","Arizona St.","4","3","1","0.5625","182","92","90","Ted E. Shipkey"
"1933","Arizona St.","3","5","0","0.375","73","125","-52","Rudy H. Lavik"
"1934","Arizona St.","4","3","1","0.5625","91","113","-22","Rudy H. Lavik"
"1935","Arizona St.","2","5","1","0.3125","29","66","-37","Rudy H. Lavik"
"1936","Arizona St.","4","5","0","0.44444","83","109","-26","Rudy H. Lavik"
"1937","Arizona St.","0","8","1","0.05556","32","140","-108","Rudy H. Lavik"
"1938","Arizona St.","3","6","0","0.33333","89","98","-9","Millard F. ""Dixie"" Howell"
"1939","Arizona St.","8","2","1","0.77273","212","56","156","Millard F. ""Dixie"" Howell"
"1940","Arizona St.","7","2","2","0.72727","198","99","99","Millard F. ""Dixie"" Howell"
"1941","Arizona St.","5","5","1","0.5","111","137","-26","Millard F. ""Dixie"" Howell"
"1942","Arizona St.","2","8","0","0.2","53","235","-182","Hilman B. Walker"
"1946","Arizona St.","2","7","2","0.27273","93","313","-220","Steve A. Coutchie"
"1947","Arizona St.","4","7","0","0.36364","168","234","-66","Edward A. ""Ed"" Doherty"
"1948","Arizona St.","5","5","0","0.5","276","192","84","Edward A. ""Ed"" Doherty"
"1949","Arizona St.","7","3","0","0.7","342","204","138","Edward A. ""Ed"" Doherty"
"1950","Arizona St.","9","2","0","0.81818","404","154","250","Edward A. ""Ed"" Doherty"
"1951","Arizona St.","6","3","1","0.65","308","176","132","Laurence ""Larry"" Siemering"
"1952","Arizona St.","6","3","0","0.66667","247","121","126","Clyde B. Smith"
"1953","Arizona St.","4","5","1","0.45","207","203","4","Clyde B. Smith"
"1954","Arizona St.","5","5","0","0.5","178","228","-50","Clyde B. Smith"
"1955","Arizona St.","8","2","1","0.77273","343","107","236","Dan Devine"
"1956","Arizona St.","9","1","0","0.9","306","83","223","Dan Devine"
"1957","Arizona St.","10","0","0","1","397","66","331","Dan Devine"
"1958","Arizona St.","7","3","0","0.7","271","131","140","Frank Kush"
"1959","Arizona St.","10","1","0","0.90909","272","150","122","Frank Kush"
"1960","Arizona St.","7","3","0","0.7","223","120","103","Frank Kush"
"1961","Arizona St.","7","3","0","0.7","287","163","124","Frank Kush"
"1962","Arizona St.","7","2","1","0.75","304","126","178","Frank Kush"
"1963","Arizona St.","8","1","0","0.88889","249","122","127","Frank Kush"
"1964","Arizona St.","8","2","0","0.8","230","125","105","Frank Kush"
"1965","Arizona St.","6","4","0","0.6","132","142","-10","Frank Kush"
"1966","Arizona St.","5","5","0","0.5","166","174","-8","Frank Kush"
"1967","Arizona St.","8","2","0","0.8","350","210","140","Frank Kush"
"1968","Arizona St.","8","2","0","0.8","414","163","251","Frank Kush"
"1969","Arizona St.","8","2","0","0.8","383","179","204","Frank Kush"
"1970","Arizona St.","11","0","0","1","405","148","257","Frank Kush"
"1971","Arizona St.","11","1","0","0.91667","462","201","261","Frank Kush"
"1972","Arizona St.","10","2","0","0.83333","562","296","266","Frank Kush"
"1973","Arizona St.","11","1","0","0.91667","519","171","348","Frank Kush"
"1974","Arizona St.","7","5","0","0.58333","267","163","104","Frank Kush"
"1975","Arizona St.","12","0","0","1","347","127","220","Frank Kush"
"1976","Arizona St.","4","7","0","0.36364","223","241","-18","Frank Kush"
"1977","Arizona St.","9","3","0","0.75","399","196","203","Frank Kush"
"1978","Arizona St.","9","3","0","0.75","347","236","111","Frank Kush"
"1979","Arizona St.","0","5","0","0","118","55","63","Frank Kush"
"1979","Arizona St.","1","6","0","0.14286","188","153","35","Bob Owens"
"1980","Arizona St.","7","4","0","0.63636","311","216","95","Darryl D. Rogers"
"1981","Arizona St.","9","2","0","0.81818","394","193","201","Darryl D. Rogers"
"1982","Arizona St.","10","2","0","0.83333","294","145","149","Darryl D. Rogers"
"1983","Arizona St.","6","4","1","0.59091","320","200","120","Darryl D. Rogers"
"1984","Arizona St.","5","6","0","0.45455","297","203","94","Darryl D. Rogers"
"1985","Arizona St.","8","4","0","0.66667","285","168","117","John Cooper"
"1986","Arizona St.","10","1","1","0.875","379","167","212","John Cooper"
"1987","Arizona St.","7","4","1","0.625","334","263","71","John Cooper"
"1988","Arizona St.","6","5","0","0.54545","192","277","-85","Larry Marmie"
"1989","Arizona St.","6","4","1","0.59091","241","258","-17","Larry Marmie"
"1990","Arizona St.","4","7","0","0.36364","272","294","-22","Larry Marmie"
"1991","Arizona St.","6","5","0","0.54545","218","210","8","Larry Marmie"
"1992","Arizona St.","6","5","0","0.54545","235","185","50","Bruce Snyder"
"1993","Arizona St.","6","5","0","0.54545","282","248","34","Bruce Snyder"
"1994","Arizona St.","3","8","0","0.27273","242","347","-105","Bruce Snyder"
"1995","Arizona St.","6","5","0","0.54545","308","330","-22","Bruce Snyder"
"1996","Arizona St.","11","1","0","0.91667","488","216","272","Bruce Snyder"
"1997","Arizona St.","9","3","0","0.75","324","210","114","Bruce Snyder"
"1998","Arizona St.","5","6","0","0.45455","333","338","-5","Bruce Snyder"
"1999","Arizona St.","7","5","0","0.58333","285","311","-26","Bruce Snyder"
"2000","Arizona St.","6","6","0","0.5","313","303","10","Bruce Snyder"
"2001","Arizona St.","4","7","0","0.36364","374","361","13","Dirk Koetter"
"2002","Arizona St.","8","6","0","0.57143","452","407","45","Dirk Koetter"
"2003","Arizona St.","5","7","0","0.41667","298","328","-30","Dirk Koetter"
"2004","Arizona St.","9","3","0","0.75","358","294","64","Dirk Koetter"
"2005","Arizona St.","7","5","0","0.58333","442","359","83","Dirk Koetter"
"2006","Arizona St.","7","6","0","0.53846","348","326","22","Dirk Koetter"
"2007","Arizona St.","10","3","0","0.76923","420","293","127","Dennis Erickson"
"2008","Arizona St.","5","7","0","0.41667","274","272","2","Dennis Erickson"
"2009","Arizona St.","4","8","0","0.33333","268","253","15","Dennis Erickson"
"2010","Arizona St.","6","6","0","0.5","387","300","87","Dennis Erickson"
"2011","Arizona St.","6","7","0","0.46154","431","372","59","Dennis Erickson"
"2012","Arizona St.","8","5","0","0.61538","499","316","183","Todd Graham"
"2013","Arizona St.","10","4","0","0.71429","556","373","183","Todd Graham"
"2014","Arizona St.","10","3","0","0.76923","480","363","117","Todd Graham"
"1894","Arkansas","2","1","0","0.66667","80","54","26","John C. Futrall"
"1895","Arkansas","1","0","0","1","30","0","30","John C. Futrall"
"1896","Arkansas","2","1","0","0.66667","16","36","-20","John C. Futrall"
"1897","Arkansas","2","0","1","0.83333","42","6","36","B.N. Wilson"
"1898","Arkansas","2","1","0","0.66667","37","42","-5","B.N. Wilson"
"1899","Arkansas","3","1","1","0.7","37","21","16","Colbert Searles"
"1900","Arkansas","2","1","1","0.625","36","23","13","Colbert Searles"
"1901","Arkansas","3","5","0","0.375","98","52","46","Charles Thomas"
"1902","Arkansas","6","3","0","0.66667","148","73","75","Charles Thomas"
"1903","Arkansas","3","4","0","0.42857","50","63","-13","D.A. McDaniel"
"1904","Arkansas","4","5","0","0.44444","68","133","-65","Ancil Delos Brown"
"1905","Arkansas","2","6","0","0.25","32","50","-18","Ancil Delos Brown"
"1906","Arkansas","2","4","2","0.375","45","70","-25","Frank C. ""Shorty"" Longman"
"1907","Arkansas","3","4","1","0.4375","73","110","-37","Frank C. ""Shorty"" Longman"
"1908","Arkansas","5","4","0","0.55556","213","120","93","Hugo F. Bezdek"
"1909","Arkansas","7","0","0","1","186","18","168","Hugo F. Bezdek"
"1910","Arkansas","7","1","0","0.875","221","19","202","Hugo F. Bezdek"
"1911","Arkansas","6","2","1","0.72222","268","23","245","Hugo F. Bezdek"
"1912","Arkansas","4","6","0","0.4","149","179","-30","Hugo F. Bezdek"
"1913","Arkansas","7","2","0","0.77778","137","43","94","E.T. Pickering"
"1914","Arkansas","3","6","0","0.33333","96","206","-110","E.T. Pickering"
"1915","Arkansas","4","2","1","0.64286","121","55","66","T.T. McConnell"
"1916","Arkansas","4","4","0","0.5","261","124","137","T.T. McConnell"
"1917","Arkansas","5","1","1","0.78571","118","27","91","Norman C. Paine"
"1918","Arkansas","3","2","0","0.6","41","121","-80","Norman C. Paine"
"1919","Arkansas","3","4","0","0.42857","55","164","-109","J.B. Craig"
"1920","Arkansas","3","2","2","0.57143","42","22","20","George W. McLaren"
"1921","Arkansas","5","3","1","0.61111","144","48","96","George W. McLaren"
"1922","Arkansas","4","5","0","0.44444","143","136","7","Francis A. Schmidt"
"1923","Arkansas","6","2","1","0.72222","158","40","118","Francis A. Schmidt"
"1924","Arkansas","7","2","1","0.75","227","69","158","Francis A. Schmidt"
"1925","Arkansas","4","4","1","0.5","95","62","33","Francis A. Schmidt"
"1926","Arkansas","5","5","0","0.5","179","88","91","Francis A. Schmidt"
"1927","Arkansas","8","1","0","0.88889","218","76","142","Francis A. Schmidt"
"1928","Arkansas","7","2","0","0.77778","251","63","188","Francis A. Schmidt"
"1929","Arkansas","7","2","0","0.77778","230","93","137","Fred C. Thomsen"
"1930","Arkansas","3","6","0","0.33333","78","154","-76","Fred C. Thomsen"
"1931","Arkansas","3","5","1","0.38889","82","126","-44","Fred C. Thomsen"
"1932","Arkansas","1","6","2","0.22222","65","133","-68","Fred C. Thomsen"
"1933","Arkansas","7","3","1","0.68182","213","61","152","Fred C. Thomsen"
"1934","Arkansas","4","4","2","0.5","95","76","19","Fred C. Thomsen"
"1935","Arkansas","5","5","0","0.5","152","109","43","Fred C. Thomsen"
"1936","Arkansas","7","3","0","0.7","178","87","91","Fred C. Thomsen"
"1937","Arkansas","6","2","2","0.7","186","89","97","Fred C. Thomsen"
"1938","Arkansas","2","7","1","0.25","128","125","3","Fred C. Thomsen"
"1939","Arkansas","4","5","1","0.45","115","117","-2","Fred C. Thomsen"
"1940","Arkansas","4","6","0","0.4","112","174","-62","Fred C. Thomsen"
"1941","Arkansas","3","7","0","0.3","118","149","-31","Fred C. Thomsen"
"1942","Arkansas","3","7","0","0.3","89","228","-139","George Cole"
"1943","Arkansas","2","7","0","0.22222","105","192","-87","John Tomlin"
"1944","Arkansas","5","5","1","0.5","120","161","-41","Glen Rose"
"1945","Arkansas","3","7","0","0.3","112","222","-110","Glen Rose"
"1946","Arkansas","6","3","2","0.63636","136","92","44","John Barnhill"
"1947","Arkansas","6","4","1","0.59091","191","145","46","John Barnhill"
"1948","Arkansas","5","5","0","0.5","227","136","91","John Barnhill"
"1949","Arkansas","5","5","0","0.5","167","175","-8","John Barnhill"
"1950","Arkansas","2","8","0","0.2","156","163","-7","Otis Douglas"
"1951","Arkansas","5","5","0","0.5","178","162","16","Otis Douglas"
"1952","Arkansas","2","8","0","0.2","166","282","-116","Otis Douglas"
"1953","Arkansas","3","7","0","0.3","116","161","-45","Bowden Wyatt"
"1954","Arkansas","8","3","0","0.72727","195","104","91","Bowden Wyatt"
"1955","Arkansas","5","4","1","0.55","126","114","12","Jack Mitchell"
"1956","Arkansas","6","4","0","0.6","160","155","5","Jack Mitchell"
"1957","Arkansas","6","4","0","0.6","187","134","53","Jack Mitchell"
"1958","Arkansas","4","6","0","0.4","147","150","-3","Frank Broyles"
"1959","Arkansas","9","2","0","0.81818","163","101","62","Frank Broyles"
"1960","Arkansas","8","3","0","0.72727","185","87","98","Frank Broyles"
"1961","Arkansas","8","3","0","0.72727","183","97","86","Frank Broyles"
"1962","Arkansas","9","2","0","0.81818","299","115","184","Frank Broyles"
"1963","Arkansas","5","5","0","0.5","179","96","83","Frank Broyles"
"1964","Arkansas","11","0","0","1","231","64","167","Frank Broyles"
"1965","Arkansas","10","1","0","0.90909","331","118","213","Frank Broyles"
"1966","Arkansas","8","2","0","0.8","218","73","145","Frank Broyles"
"1967","Arkansas","4","5","1","0.45","200","149","51","Frank Broyles"
"1968","Arkansas","10","1","0","0.90909","350","189","161","Frank Broyles"
"1969","Arkansas","9","2","0","0.81818","353","103","250","Frank Broyles"
"1970","Arkansas","9","2","0","0.81818","402","144","258","Frank Broyles"
"1971","Arkansas","8","3","1","0.70833","356","169","187","Frank Broyles"
"1972","Arkansas","6","5","0","0.54545","228","227","1","Frank Broyles"
"1973","Arkansas","5","5","1","0.5","124","184","-60","Frank Broyles"
"1974","Arkansas","6","4","1","0.59091","285","164","121","Frank Broyles"
"1975","Arkansas","10","2","0","0.83333","336","123","213","Frank Broyles"
"1976","Arkansas","5","5","1","0.5","220","204","16","Frank Broyles"
"1977","Arkansas","11","1","0","0.91667","389","101","288","Lou Holtz"
"1978","Arkansas","9","2","1","0.79167","336","147","189","Lou Holtz"
"1979","Arkansas","10","2","0","0.83333","284","132","152","Lou Holtz"
"1980","Arkansas","7","5","0","0.58333","272","236","36","Lou Holtz"
"1981","Arkansas","8","4","0","0.66667","325","219","106","Lou Holtz"
"1982","Arkansas","9","2","1","0.79167","303","139","164","Lou Holtz"
"1983","Arkansas","6","5","0","0.54545","204","172","32","Lou Holtz"
"1984","Arkansas","7","4","1","0.625","268","159","109","Ken Hatfield"
"1985","Arkansas","10","2","0","0.83333","323","146","177","Ken Hatfield"
"1986","Arkansas","9","3","0","0.75","311","184","127","Ken Hatfield"
"1987","Arkansas","9","4","0","0.69231","300","219","81","Ken Hatfield"
"1988","Arkansas","10","2","0","0.83333","349","190","159","Ken Hatfield"
"1989","Arkansas","10","2","0","0.83333","385","230","155","Ken Hatfield"
"1990","Arkansas","3","8","0","0.27273","263","360","-97","Jack Crowe"
"1991","Arkansas","6","6","0","0.5","175","203","-28","Jack Crowe"
"1992","Arkansas","0","1","0","0","3","10","-7","Jack Crowe"
"1992","Arkansas","3","6","1","0.35","169","199","-30","Joe Kines"
"1993","Arkansas","6","4","1","0.59091","165","208","-43","Danny Ford"
"1994","Arkansas","4","7","0","0.36364","212","213","-1","Danny Ford"
"1995","Arkansas","8","5","0","0.61538","284","283","1","Danny Ford"
"1996","Arkansas","4","7","0","0.36364","174","267","-93","Danny Ford"
"1997","Arkansas","4","7","0","0.36364","181","284","-103","Danny Ford"
"1998","Arkansas","9","3","0","0.75","390","227","163","Houston Nutt"
"1999","Arkansas","8","4","0","0.66667","353","214","139","Houston Nutt"
"2000","Arkansas","6","6","0","0.5","278","289","-11","Houston Nutt"
"2001","Arkansas","7","5","0","0.58333","294","279","15","Houston Nutt"
"2002","Arkansas","9","5","0","0.64286","370","277","93","Houston Nutt"
"2003","Arkansas","9","4","0","0.69231","436","305","131","Houston Nutt"
"2004","Arkansas","5","6","0","0.45455","328","270","58","Houston Nutt"
"2005","Arkansas","4","7","0","0.36364","283","271","12","Houston Nutt"
"2006","Arkansas","10","4","0","0.71429","404","256","148","Houston Nutt"
"2007","Arkansas","8","4","0","0.66667","478","307","171","Houston Nutt"
"2007","Arkansas","0","1","0","0","7","38","-31","Reggie Herring"
"2008","Arkansas","5","7","0","0.41667","263","374","-111","Bobby ""Bob"" Petrino"
"2009","Arkansas","8","5","0","0.61538","468","326","142","Bobby ""Bob"" Petrino"
"2010","Arkansas","10","3","0","0.76923","474","304","170","Bobby ""Bob"" Petrino"
"2011","Arkansas","11","2","0","0.84615","478","289","189","Bobby ""Bob"" Petrino"
"2012","Arkansas","4","8","0","0.33333","282","365","-83","John L. Smith"
"2013","Arkansas","3","9","0","0.25","248","369","-121","Bret Bielema"
"2014","Arkansas","7","6","0","0.53846","415","250","165","Bret Bielema"
"1911","Arkansas St.","1","1","0","0.5","12","11","1","F.T. Parks"
"1912","Arkansas St.","3","1","0","0.75","39","20","19","F.T. Parks"
"1913","Arkansas St.","5","2","1","0.6875","254","39","215","Clinton Young"
"1914","Arkansas St.","5","4","0","0.55556","148","156","-8","Earl Brannon"
"1915","Arkansas St.","4","1","1","0.75","99","13","86","Earl Brannon"
"1916","Arkansas St.","5","3","0","0.625","86","51","35","Earl Brannon"
"1917","Arkansas St.","4","2","1","0.64286","157","54","103","Earl Brannon"
"1918","Arkansas St.","13","24","4","0.36585","357","577","-220","Unknown"
"1919","Arkansas St.","2","5","0","0.28571","27","101","-74","Foy Hammons"
"1920","Arkansas St.","3","3","0","0.5","56","97","-41","Foy Hammons"
"1921","Arkansas St.","3","2","1","0.58333","47","33","14","Foy Hammons"
"1922","Arkansas St.","0","8","0","0","0","466","-466","Tom Dandelet"
"1923","Arkansas St.","0","6","1","0.07143","0","164","-164","Tom Dandelet"
"1924","Arkansas St.","4","5","0","0.44444","101","89","12","Bill Stanley"
"1925","Arkansas St.","4","3","1","0.5625","76","120","-44","Herbert Schwartz"
"1926","Arkansas St.","4","3","1","0.5625","60","69","-9","Herbert Schwartz"
"1927","Arkansas St.","4","3","0","0.57143","61","67","-6","Herbert Schwartz"
"1928","Arkansas St.","3","3","1","0.5","105","65","40","Herbert Schwartz"
"1929","Arkansas St.","2","5","0","0.28571","60","137","-77","Herbert Schwartz"
"1930","Arkansas St.","1","4","3","0.3125","20","84","-64","Herbert Schwartz"
"1931","Arkansas St.","6","2","0","0.75","98","53","45","Jack Dale"
"1932","Arkansas St.","3","4","0","0.42857","98","73","25","Jack Dale"
"1933","Arkansas St.","2","4","2","0.375","34","79","-45","E.T. Renfro"
"1934","Arkansas St.","2","5","1","0.3125","31","80","-49","Thomas E. ""Tommy"" Mills"
"1935","Arkansas St.","2","7","0","0.22222","38","196","-158","Thomas E. ""Tommy"" Mills"
"1936","Arkansas St.","3","5","0","0.375","47","188","-141","Leslie Speck"
"1937","Arkansas St.","1","5","0","0.16667","16","267","-251","Leslie Speck"
"1938","Arkansas St.","3","3","0","0.5","54","68","-14","Leslie Speck"
"1939","Arkansas St.","4","3","0","0.57143","65","98","-33","Bill Adams"
"1940","Arkansas St.","1","4","2","0.28571","45","98","-53","Bill Adams"
"1941","Arkansas St.","0","7","0","0","0","308","-308","Bill Adams"
"1945","Arkansas St.","2","4","1","0.35714","51","95","-44","J.A. Tomlinson"
"1946","Arkansas St.","4","3","3","0.55","99","103","-4","Forrest W. England"
"1947","Arkansas St.","4","2","3","0.61111","159","91","68","Forrest W. England"
"1948","Arkansas St.","4","4","1","0.5","131","186","-55","Forrest W. England"
"1949","Arkansas St.","4","5","0","0.44444","87","176","-89","Forrest W. England"
"1950","Arkansas St.","6","3","0","0.66667","201","179","22","Forrest W. England"
"1951","Arkansas St.","10","2","0","0.83333","456","111","345","Forrest W. England"
"1952","Arkansas St.","8","3","0","0.72727","351","123","228","Forrest W. England"
"1953","Arkansas St.","8","0","2","0.9","239","65","174","Forrest W. England"
"1954","Arkansas St.","1","8","0","0.11111","74","353","-279","Glen W. Harmeson"
"1955","Arkansas St.","6","3","0","0.66667","203","127","76","Gene Harlow"
"1956","Arkansas St.","5","4","0","0.55556","193","170","23","Gene Harlow"
"1957","Arkansas St.","4","5","0","0.44444","138","180","-42","Gene Harlow"
"1958","Arkansas St.","4","5","0","0.44444","162","176","-14","Hugh ""Bones"" Taylor"
"1959","Arkansas St.","3","6","0","0.33333","171","176","-5","Hugh ""Bones"" Taylor"
"1960","Arkansas St.","4","5","0","0.44444","116","137","-21","King Block"
"1961","Arkansas St.","3","6","0","0.33333","84","179","-95","King Block"
"1962","Arkansas St.","6","3","0","0.66667","146","96","50","King Block"
"1963","Arkansas St.","2","6","0","0.25","159","174","-15","Bennie Ellender"
"1964","Arkansas St.","7","0","2","0.88889","148","61","87","Bennie Ellender"
"1965","Arkansas St.","6","3","0","0.66667","157","107","50","Bennie Ellender"
"1966","Arkansas St.","7","2","0","0.77778","222","109","113","Bennie Ellender"
"1967","Arkansas St.","4","5","0","0.44444","126","116","10","Bennie Ellender"
"1968","Arkansas St.","7","3","1","0.68182","245","172","73","Bennie Ellender"
"1969","Arkansas St.","8","1","1","0.85","262","140","122","Bennie Ellender"
"1970","Arkansas St.","11","0","0","1","360","134","226","Bennie Ellender"
"1971","Arkansas St.","4","4","1","0.5","175","147","28","Bill Davidson"
"1972","Arkansas St.","3","8","0","0.27273","163","198","-35","Bill Davidson"
"1973","Arkansas St.","7","3","0","0.7","249","166","83","Bill Davidson"
"1974","Arkansas St.","7","3","0","0.7","215","122","93","Bill Davidson"
"1975","Arkansas St.","11","0","0","1","355","81","274","Bill Davidson"
"1976","Arkansas St.","5","6","0","0.45455","274","221","53","Bill Davidson"
"1977","Arkansas St.","7","4","0","0.63636","184","214","-30","Bill Davidson"
"1978","Arkansas St.","7","4","0","0.63636","163","144","19","Bill Davidson"
"1979","Arkansas St.","4","7","0","0.36364","167","188","-21","Larry Lacewell"
"1980","Arkansas St.","2","9","0","0.18182","129","269","-140","Larry Lacewell"
"1981","Arkansas St.","6","5","0","0.54545","177","159","18","Larry Lacewell"
"1982","Arkansas St.","5","6","0","0.45455","170","244","-74","Larry Lacewell"
"1983","Arkansas St.","5","5","1","0.5","195","226","-31","Larry Lacewell"
"1984","Arkansas St.","8","4","1","0.65385","347","187","160","Larry Lacewell"
"1985","Arkansas St.","9","4","0","0.69231","322","169","153","Larry Lacewell"
"1986","Arkansas St.","12","2","1","0.83333","452","210","242","Larry Lacewell"
"1987","Arkansas St.","8","4","1","0.65385","395","277","118","Larry Lacewell"
"1988","Arkansas St.","5","6","0","0.45455","261","245","16","Larry Lacewell"
"1989","Arkansas St.","5","6","0","0.45455","261","265","-4","Larry Lacewell"
"1990","Arkansas St.","3","7","1","0.31818","200","313","-113","Al Kincaid"
"1991","Arkansas St.","1","10","0","0.09091","189","361","-172","Al Kincaid"
"1992","Arkansas St.","2","9","0","0.18182","118","402","-284","Ray Perkins"
"1993","Arkansas St.","2","8","1","0.22727","122","274","-152","John Bobo"
"1994","Arkansas St.","1","10","0","0.09091","123","316","-193","John Bobo"
"1995","Arkansas St.","6","5","0","0.54545","265","270","-5","John Bobo"
"1996","Arkansas St.","4","7","0","0.36364","272","365","-93","John Bobo"
"1997","Arkansas St.","2","9","0","0.18182","200","394","-194","Joe Hollis"
"1998","Arkansas St.","4","8","0","0.33333","216","385","-169","Joe Hollis"
"1999","Arkansas St.","4","7","0","0.36364","246","332","-86","Joe Hollis"
"2000","Arkansas St.","1","10","0","0.09091","247","410","-163","Joe Hollis"
"2001","Arkansas St.","2","9","0","0.18182","177","357","-180","Joe Hollis"
"2002","Arkansas St.","6","7","0","0.46154","259","361","-102","Steve Roberts"
"2003","Arkansas St.","5","7","0","0.41667","242","401","-159","Steve Roberts"
"2004","Arkansas St.","3","8","0","0.27273","215","365","-150","Steve Roberts"
"2005","Arkansas St.","6","6","0","0.5","294","303","-9","Steve Roberts"
"2006","Arkansas St.","6","6","0","0.5","182","289","-107","Steve Roberts"
"2007","Arkansas St.","5","7","0","0.41667","291","331","-40","Steve Roberts"
"2008","Arkansas St.","6","6","0","0.5","324","285","39","Steve Roberts"
"2009","Arkansas St.","4","8","0","0.33333","272","279","-7","Steve Roberts"
"2010","Arkansas St.","4","8","0","0.33333","360","369","-9","Steve Roberts"
"2011","Arkansas St.","10","2","0","0.83333","402","232","170","Hugh Freeze"
"2011","Arkansas St.","0","1","0","0","20","38","-18","David Gunn"
"2012","Arkansas St.","1","0","0","1","17","13","4","John Thompson"
"2013","Arkansas St.","1","0","0","1","23","20","3","John Thompson"
"2012","Arkansas St.","9","3","0","0.75","437","305","132","Gus Malzahn"
"2013","Arkansas St.","7","5","0","0.58333","356","320","36","Bryan Harsin"
"2014","Arkansas St.","7","6","0","0.53846","477","396","81","Blake Anderson"
"1891","Army (NY)","4","1","1","0.75","80","73","7","Henry L. ""Doc"" Williams"
"1890","Army (NY)","0","1","0","0","0","24","-24","Dennis M. Michie"
"1892","Army (NY)","3","1","1","0.7","90","18","72","Dennis M. Michie"
"1893","Army (NY)","4","5","0","0.44444","84","109","-25","Laurence T. Bliss"
"1894","Army (NY)","3","2","0","0.6","95","22","73","Harmon S. Graves"
"1895","Army (NY)","5","2","0","0.71429","141","32","109","Harmon S. Graves"
"1896","Army (NY)","3","2","1","0.58333","93","45","48","George P. Dyer"
"1897","Army (NY)","6","1","1","0.8125","194","41","153","Herman J. Koehler"
"1898","Army (NY)","3","2","1","0.58333","90","51","39","Herman J. Koehler"
"1899","Army (NY)","4","5","0","0.44444","57","100","-43","Herman J. Koehler"
"1900","Army (NY)","7","3","1","0.68182","109","68","41","Herman J. Koehler"
"1901","Army (NY)","5","1","2","0.75","98","22","76","Leon B. Kromer"
"1902","Army (NY)","6","1","1","0.8125","180","28","152","Dennis E. Nolan"
"1903","Army (NY)","6","2","1","0.72222","164","33","131","Edward L. King"
"1904","Army (NY)","7","2","0","0.77778","136","27","109","Robert E. Boyers"
"1905","Army (NY)","4","4","1","0.5","104","60","44","Robert E. Boyers"
"1906","Army (NY)","2","5","1","0.3125","47","37","10","Ernest Graves"
"1912","Army (NY)","5","3","0","0.625","108","59","49","Ernest Graves"
"1906","Army (NY)","1","0","0","1","12","0","12","Henry C. Smither"
"1907","Army (NY)","6","2","1","0.72222","125","24","101","Henry C. Smither"
"1908","Army (NY)","6","1","2","0.77778","87","21","66","Harry M. Nelly"
"1909","Army (NY)","3","2","0","0.6","57","32","25","Harry M. Nelly"
"1910","Army (NY)","6","2","0","0.75","96","12","84","Harry M. Nelly"
"1911","Army (NY)","6","1","1","0.8125","88","11","77","Joseph W. Beacham"
"1913","Army (NY)","8","1","0","0.88889","253","57","196","Charles D. Daly"
"1914","Army (NY)","9","0","0","1","219","20","199","Charles D. Daly"
"1915","Army (NY)","5","3","1","0.61111","114","57","57","Charles D. Daly"
"1916","Army (NY)","9","0","0","1","235","36","199","Charles D. Daly"
"1919","Army (NY)","6","3","0","0.66667","140","38","102","Charles D. Daly"
"1920","Army (NY)","7","2","0","0.77778","314","47","267","Charles D. Daly"
"1921","Army (NY)","6","4","0","0.6","217","65","152","Charles D. Daly"
"1922","Army (NY)","8","0","2","0.9","228","27","201","Charles D. Daly"
"1917","Army (NY)","7","1","0","0.875","203","24","179","Geoffrey Keyes"
"1918","Army (NY)","1","0","0","1","20","0","20","Hugh Mitchell"
"1923","Army (NY)","6","2","1","0.72222","237","56","181","John J. McEwan"
"1924","Army (NY)","5","1","2","0.75","111","41","70","John J. McEwan"
"1925","Army (NY)","7","2","0","0.77778","185","71","114","John J. McEwan"
"1926","Army (NY)","7","1","1","0.83333","240","71","169","Lawrence M. ""Biff"" Jones"
"1927","Army (NY)","9","1","0","0.9","197","37","160","Lawrence M. ""Biff"" Jones"
"1928","Army (NY)","8","2","0","0.8","215","79","136","Lawrence M. ""Biff"" Jones"
"1929","Army (NY)","6","4","1","0.59091","276","132","144","Lawrence M. ""Biff"" Jones"
"1930","Army (NY)","9","1","1","0.86364","268","22","246","Ralph I. Sasse"
"1931","Army (NY)","8","2","1","0.77273","296","72","224","Ralph I. Sasse"
"1932","Army (NY)","8","2","0","0.8","261","39","222","Ralph I. Sasse"
"1933","Army (NY)","9","1","0","0.9","227","26","201","Garrison H. ""Gar"" Davidson"
"1934","Army (NY)","7","3","0","0.7","215","40","175","Garrison H. ""Gar"" Davidson"
"1935","Army (NY)","6","2","1","0.72222","176","62","114","Garrison H. ""Gar"" Davidson"
"1936","Army (NY)","6","3","0","0.66667","238","71","167","Garrison H. ""Gar"" Davidson"
"1937","Army (NY)","7","2","0","0.77778","176","72","104","Garrison H. ""Gar"" Davidson"
"1938","Army (NY)","8","2","0","0.8","243","95","148","William H. Wood"
"1939","Army (NY)","3","4","2","0.44444","106","105","1","William H. Wood"
"1940","Army (NY)","1","7","1","0.16667","54","197","-143","William H. Wood"
"1941","Army (NY)","5","3","1","0.61111","105","87","18","Earl H. ""Red"" Blaik"
"1942","Army (NY)","6","3","0","0.66667","149","74","75","Earl H. ""Red"" Blaik"
"1943","Army (NY)","7","2","1","0.75","299","66","233","Earl H. ""Red"" Blaik"
"1944","Army (NY)","9","0","0","1","504","35","469","Earl H. ""Red"" Blaik"
"1945","Army (NY)","9","0","0","1","412","46","366","Earl H. ""Red"" Blaik"
"1946","Army (NY)","9","0","1","0.95","263","80","183","Earl H. ""Red"" Blaik"
"1947","Army (NY)","5","2","2","0.66667","220","68","152","Earl H. ""Red"" Blaik"
"1948","Army (NY)","8","0","1","0.94444","294","89","205","Earl H. ""Red"" Blaik"
"1949","Army (NY)","9","0","0","1","354","68","286","Earl H. ""Red"" Blaik"
"1950","Army (NY)","8","1","0","0.88889","267","40","227","Earl H. ""Red"" Blaik"
"1951","Army (NY)","2","7","0","0.22222","116","183","-67","Earl H. ""Red"" Blaik"
"1952","Army (NY)","4","4","1","0.5","155","151","4","Earl H. ""Red"" Blaik"
"1953","Army (NY)","7","1","1","0.83333","210","81","129","Earl H. ""Red"" Blaik"
"1954","Army (NY)","7","2","0","0.77778","325","127","198","Earl H. ""Red"" Blaik"
"1955","Army (NY)","6","3","0","0.66667","256","72","184","Earl H. ""Red"" Blaik"
"1956","Army (NY)","5","3","1","0.61111","223","153","70","Earl H. ""Red"" Blaik"
"1957","Army (NY)","7","2","0","0.77778","251","129","122","Earl H. ""Red"" Blaik"
"1958","Army (NY)","8","0","1","0.94444","264","49","215","Earl H. ""Red"" Blaik"
"1959","Army (NY)","4","4","1","0.5","174","141","33","Dale S. Hall"
"1960","Army (NY)","6","3","1","0.65","222","95","127","Dale S. Hall"
"1961","Army (NY)","6","4","0","0.6","224","118","106","Dale S. Hall"
"1962","Army (NY)","6","4","0","0.6","152","104","48","Paul Dietzel"
"1963","Army (NY)","7","3","0","0.7","177","97","80","Paul Dietzel"
"1964","Army (NY)","4","6","0","0.4","118","143","-25","Paul Dietzel"
"1965","Army (NY)","4","5","1","0.45","119","132","-13","Paul Dietzel"
"1966","Army (NY)","8","2","0","0.8","141","105","36","Tom Cahill"
"1967","Army (NY)","8","2","0","0.8","183","94","89","Tom Cahill"
"1968","Army (NY)","7","3","0","0.7","270","137","133","Tom Cahill"
"1969","Army (NY)","4","5","1","0.45","161","160","1","Tom Cahill"
"1970","Army (NY)","1","9","1","0.13636","151","281","-130","Tom Cahill"
"1971","Army (NY)","6","4","0","0.6","146","206","-60","Tom Cahill"
"1972","Army (NY)","6","4","0","0.6","160","282","-122","Tom Cahill"
"1973","Army (NY)","0","10","0","0","67","382","-315","Tom Cahill"
"1974","Army (NY)","3","8","0","0.27273","156","306","-150","Homer Smith"
"1975","Army (NY)","2","9","0","0.18182","165","337","-172","Homer Smith"
"1976","Army (NY)","5","6","0","0.45455","201","267","-66","Homer Smith"
"1977","Army (NY)","7","4","0","0.63636","287","245","42","Homer Smith"
"1978","Army (NY)","4","6","1","0.40909","184","255","-71","Homer Smith"
"1979","Army (NY)","2","8","1","0.22727","96","308","-212","Louis Henry ""Lou"" Saban"
"1980","Army (NY)","3","7","1","0.31818","204","295","-91","Ed Cavanaugh"
"1981","Army (NY)","3","7","1","0.31818","126","212","-86","Ed Cavanaugh"
"1982","Army (NY)","4","7","0","0.36364","164","271","-107","Ed Cavanaugh"
"1983","Army (NY)","2","9","0","0.18182","140","304","-164","Jim Young"
"1984","Army (NY)","8","3","1","0.70833","320","218","102","Jim Young"
"1985","Army (NY)","9","3","0","0.75","396","232","164","Jim Young"
"1986","Army (NY)","6","5","0","0.54545","276","292","-16","Jim Young"
"1987","Army (NY)","5","6","0","0.45455","277","223","54","Jim Young"
"1988","Army (NY)","9","3","0","0.75","336","226","110","Jim Young"
"1989","Army (NY)","6","5","0","0.54545","316","212","104","Jim Young"
"1990","Army (NY)","6","5","0","0.54545","295","264","31","Jim Young"
"1991","Army (NY)","4","7","0","0.36364","196","226","-30","Bob Sutton"
"1992","Army (NY)","5","6","0","0.45455","225","251","-26","Bob Sutton"
"1993","Army (NY)","6","5","0","0.54545","289","243","46","Bob Sutton"
"1994","Army (NY)","4","7","0","0.36364","215","252","-37","Bob Sutton"
"1995","Army (NY)","5","5","1","0.5","325","211","114","Bob Sutton"
"1996","Army (NY)","10","2","0","0.83333","379","224","155","Bob Sutton"
"1997","Army (NY)","4","7","0","0.36364","221","311","-90","Bob Sutton"
"1998","Army (NY)","3","8","0","0.27273","257","325","-68","Bob Sutton"
"1999","Army (NY)","3","8","0","0.27273","225","317","-92","Bob Sutton"
"2000","Army (NY)","1","10","0","0.09091","224","372","-148","Todd Berry"
"2001","Army (NY)","3","8","0","0.27273","229","365","-136","Todd Berry"
"2002","Army (NY)","1","11","0","0.08333","226","491","-265","Todd Berry"
"2003","Army (NY)","0","6","0","0","85","223","-138","Todd Berry"
"2003","Army (NY)","0","7","0","0","121","253","-132","John Mumford"
"2004","Army (NY)","2","9","0","0.18182","260","388","-128","Bobby Ross"
"2005","Army (NY)","4","7","0","0.36364","220","294","-74","Bobby Ross"
"2006","Army (NY)","3","9","0","0.25","232","335","-103","Bobby Ross"
"2007","Army (NY)","3","9","0","0.25","203","364","-161","Stan Brock"
"2008","Army (NY)","3","9","0","0.25","177","284","-107","Stan Brock"
"2009","Army (NY)","5","7","0","0.41667","184","263","-79","Rich Ellerson"
"2010","Army (NY)","7","6","0","0.53846","346","316","30","Rich Ellerson"
"2011","Army (NY)","3","9","0","0.25","298","339","-41","Rich Ellerson"
"2012","Army (NY)","2","10","0","0.16667","291","424","-133","Rich Ellerson"
"2013","Army (NY)","3","9","0","0.25","293","379","-86","Rich Ellerson"
"2014","Army (NY)","4","8","0","0.33333","299","395","-96","Jeff Monken"
"1899","Baylor (TX)","2","1","1","0.625","26","33","-7","R.H. Hamilton"
"1900","Baylor (TX)","3","0","0","1","44","0","44","R.H. Hamilton"
"1901","Baylor (TX)","5","3","0","0.625","173","61","112","W.J. Ritchie"
"1902","Baylor (TX)","3","4","2","0.44444","71","89","-18","J.C. Ewing"
"1903","Baylor (TX)","4","3","1","0.5625","46","69","-23","R.N. Watts"
"1904","Baylor (TX)","2","5","1","0.3125","34","106","-72","Sol S. Metzger"
"1905","Baylor (TX)","1","6","0","0.14286","20","159","-139","Archie R. Web"
"1907","Baylor (TX)","5","2","1","0.6875","91","103","-12","Luther F. Burleson"
"1908","Baylor (TX)","3","5","0","0.375","48","164","-116","Enoch Josiah ""Joe"" Mills"
"1909","Baylor (TX)","5","3","0","0.625","112","41","71","Enoch Josiah ""Joe"" Mills"
"1910","Baylor (TX)","6","1","1","0.8125","217","17","200","Ralph Glaze"
"1911","Baylor (TX)","2","4","2","0.375","40","53","-13","Ralph Glaze"
"1912","Baylor (TX)","3","5","0","0.375","79","123","-44","Ralph Glaze"
"1913","Baylor (TX)","4","5","2","0.45455","74","222","-148","Norman C. Paine"
"1914","Baylor (TX)","3","5","2","0.4","70","159","-89","Charles P. ""Bubbs"" Mosley"
"1915","Baylor (TX)","7","1","0","0.875","188","22","166","Charles P. ""Bubbs"" Mosley"
"1916","Baylor (TX)","9","1","0","0.9","315","27","288","Charles P. ""Bubbs"" Mosley"
"1917","Baylor (TX)","6","2","1","0.72222","221","41","180","Charles P. ""Bubbs"" Mosley"
"1918","Baylor (TX)","0","6","0","0","19","92","-73","Charles P. ""Bubbs"" Mosley"
"1919","Baylor (TX)","5","3","1","0.61111","146","73","73","Charles P. ""Bubbs"" Mosley"
"1920","Baylor (TX)","4","4","1","0.5","65","89","-24","Frank B. Bridges"
"1921","Baylor (TX)","8","3","0","0.72727","214","83","131","Frank B. Bridges"
"1922","Baylor (TX)","8","3","0","0.72727","295","128","167","Frank B. Bridges"
"1923","Baylor (TX)","5","1","2","0.75","104","39","65","Frank B. Bridges"
"1924","Baylor (TX)","7","2","1","0.75","149","66","83","Frank B. Bridges"
"1925","Baylor (TX)","3","5","2","0.4","79","115","-36","Frank B. Bridges"
"1926","Baylor (TX)","6","3","1","0.65","103","93","10","Morley Jennings"
"1927","Baylor (TX)","2","7","0","0.22222","74","139","-65","Morley Jennings"
"1928","Baylor (TX)","8","2","0","0.8","219","53","166","Morley Jennings"
"1929","Baylor (TX)","7","3","1","0.68182","291","106","185","Morley Jennings"
"1930","Baylor (TX)","6","3","1","0.65","205","80","125","Morley Jennings"
"1931","Baylor (TX)","3","6","0","0.33333","100","134","-34","Morley Jennings"
"1932","Baylor (TX)","3","5","1","0.38889","77","92","-15","Morley Jennings"
"1933","Baylor (TX)","6","4","0","0.6","85","84","1","Morley Jennings"
"1934","Baylor (TX)","3","7","0","0.3","91","140","-49","Morley Jennings"
"1935","Baylor (TX)","8","3","0","0.72727","122","75","47","Morley Jennings"
"1936","Baylor (TX)","6","3","1","0.65","128","90","38","Morley Jennings"
"1937","Baylor (TX)","7","3","0","0.7","178","64","114","Morley Jennings"
"1938","Baylor (TX)","7","2","1","0.75","165","89","76","Morley Jennings"
"1939","Baylor (TX)","7","3","0","0.7","136","81","55","Morley Jennings"
"1940","Baylor (TX)","4","6","0","0.4","109","114","-5","Morley Jennings"
"1941","Baylor (TX)","3","6","1","0.35","106","161","-55","Frank H. Kimbrough"
"1942","Baylor (TX)","6","4","1","0.59091","148","116","32","Frank H. Kimbrough"
"1945","Baylor (TX)","5","5","1","0.5","178","141","37","Frank H. Kimbrough"
"1946","Baylor (TX)","1","8","0","0.11111","56","181","-125","Frank H. Kimbrough"
"1947","Baylor (TX)","5","5","0","0.5","127","138","-11","George R. ""Bob"" Woodruff"
"1948","Baylor (TX)","6","3","2","0.63636","167","125","42","George R. ""Bob"" Woodruff"
"1949","Baylor (TX)","8","2","0","0.8","232","126","106","George R. ""Bob"" Woodruff"
"1950","Baylor (TX)","7","3","0","0.7","183","128","55","George H. Sauer"
"1951","Baylor (TX)","8","2","1","0.77273","245","131","114","George H. Sauer"
"1952","Baylor (TX)","4","4","2","0.5","187","181","6","George H. Sauer"
"1953","Baylor (TX)","7","3","0","0.7","219","166","53","George H. Sauer"
"1954","Baylor (TX)","7","4","0","0.63636","250","174","76","George H. Sauer"
"1955","Baylor (TX)","5","5","0","0.5","146","143","3","George H. Sauer"
"1956","Baylor (TX)","9","2","0","0.81818","202","73","129","Sam B. Boyd"
"1957","Baylor (TX)","3","6","1","0.35","80","125","-45","Sam B. Boyd"
"1958","Baylor (TX)","3","7","0","0.3","159","181","-22","Sam B. Boyd"
"1959","Baylor (TX)","4","6","0","0.4","106","154","-48","John D. Bridgers"
"1960","Baylor (TX)","8","3","0","0.72727","181","91","90","John D. Bridgers"
"1961","Baylor (TX)","6","5","0","0.54545","212","173","39","John D. Bridgers"
"1962","Baylor (TX)","4","6","0","0.4","159","169","-10","John D. Bridgers"
"1963","Baylor (TX)","8","3","0","0.72727","205","120","85","John D. Bridgers"
"1964","Baylor (TX)","5","5","0","0.5","162","176","-14","John D. Bridgers"
"1965","Baylor (TX)","5","5","0","0.5","156","171","-15","John D. Bridgers"
"1966","Baylor (TX)","5","5","0","0.5","168","140","28","John D. Bridgers"
"1967","Baylor (TX)","1","8","1","0.15","101","199","-98","John D. Bridgers"
"1968","Baylor (TX)","3","7","0","0.3","206","322","-116","John D. Bridgers"
"1969","Baylor (TX)","0","10","0","0","87","344","-257","Bill Beall"
"1970","Baylor (TX)","2","9","0","0.18182","133","259","-126","Bill Beall"
"1971","Baylor (TX)","1","9","0","0.1","74","236","-162","Bill Beall"
"1972","Baylor (TX)","5","6","0","0.45455","180","156","24","Grant Teaff"
"1973","Baylor (TX)","2","9","0","0.18182","192","359","-167","Grant Teaff"
"1974","Baylor (TX)","8","4","0","0.66667","252","223","29","Grant Teaff"
"1975","Baylor (TX)","3","6","2","0.36364","181","235","-54","Grant Teaff"
"1976","Baylor (TX)","7","3","1","0.68182","209","183","26","Grant Teaff"
"1977","Baylor (TX)","5","6","0","0.45455","228","220","8","Grant Teaff"
"1978","Baylor (TX)","3","8","0","0.27273","225","242","-17","Grant Teaff"
"1979","Baylor (TX)","8","4","0","0.66667","258","187","71","Grant Teaff"
"1980","Baylor (TX)","10","2","0","0.83333","317","159","158","Grant Teaff"
"1981","Baylor (TX)","5","6","0","0.45455","252","245","7","Grant Teaff"
"1982","Baylor (TX)","4","6","1","0.40909","233","261","-28","Grant Teaff"
"1983","Baylor (TX)","7","4","1","0.625","339","266","73","Grant Teaff"
"1984","Baylor (TX)","5","6","0","0.45455","248","261","-13","Grant Teaff"
"1985","Baylor (TX)","9","3","0","0.75","293","152","141","Grant Teaff"
"1986","Baylor (TX)","9","3","0","0.75","325","207","118","Grant Teaff"
"1987","Baylor (TX)","6","5","0","0.54545","221","228","-7","Grant Teaff"
"1988","Baylor (TX)","6","5","0","0.54545","232","196","36","Grant Teaff"
"1989","Baylor (TX)","5","6","0","0.45455","245","190","55","Grant Teaff"
"1990","Baylor (TX)","6","4","1","0.59091","225","202","23","Grant Teaff"
"1991","Baylor (TX)","8","4","0","0.66667","282","204","78","Grant Teaff"
"1992","Baylor (TX)","7","5","0","0.58333","344","278","66","Grant Teaff"
"1993","Baylor (TX)","5","6","0","0.45455","265","331","-66","Chuck Reedy"
"1994","Baylor (TX)","7","5","0","0.58333","362","277","85","Chuck Reedy"
"1995","Baylor (TX)","7","4","0","0.63636","273","166","107","Chuck Reedy"
"1996","Baylor (TX)","4","7","0","0.36364","266","320","-54","Chuck Reedy"
"1997","Baylor (TX)","2","9","0","0.18182","200","375","-175","Dave Roberts"
"1998","Baylor (TX)","2","9","0","0.18182","195","323","-128","Dave Roberts"
"1999","Baylor (TX)","1","10","0","0.09091","137","414","-277","Kevin Steele"
"2000","Baylor (TX)","2","9","0","0.18182","139","397","-258","Kevin Steele"
"2001","Baylor (TX)","3","8","0","0.27273","205","357","-152","Kevin Steele"
"2002","Baylor (TX)","3","9","0","0.25","202","496","-294","Kevin Steele"
"2003","Baylor (TX)","3","9","0","0.25","191","455","-264","Guy Morriss"
"2004","Baylor (TX)","3","8","0","0.27273","224","406","-182","Guy Morriss"
"2005","Baylor (TX)","5","6","0","0.45455","236","291","-55","Guy Morriss"
"2006","Baylor (TX)","4","8","0","0.33333","283","391","-108","Guy Morriss"
"2007","Baylor (TX)","3","9","0","0.25","218","444","-226","Guy Morriss"
"2008","Baylor (TX)","4","8","0","0.33333","336","352","-16","Art Briles"
"2009","Baylor (TX)","4","8","0","0.33333","249","327","-78","Art Briles"
"2010","Baylor (TX)","7","6","0","0.53846","405","396","9","Art Briles"
"2011","Baylor (TX)","10","3","0","0.76923","589","484","105","Art Briles"
"2012","Baylor (TX)","8","5","0","0.61538","578","484","94","Art Briles"
"2013","Baylor (TX)","11","2","0","0.84615","681","306","375","Art Briles"
"2014","Baylor (TX)","11","2","0","0.84615","627","332","295","Art Briles"
"1968","Boise St. (ID)","8","2","0","0.8","324","124","200","Tony Knap"
"1969","Boise St. (ID)","9","1","0","0.9","391","98","293","Tony Knap"
"1970","Boise St. (ID)","8","3","0","0.72727","293","129","164","Tony Knap"
"1971","Boise St. (ID)","10","2","0","0.83333","351","247","104","Tony Knap"
"1972","Boise St. (ID)","7","4","0","0.63636","345","240","105","Tony Knap"
"1973","Boise St. (ID)","10","3","0","0.76923","470","221","249","Tony Knap"
"1974","Boise St. (ID)","10","2","0","0.83333","497","259","238","Tony Knap"
"1975","Boise St. (ID)","9","2","1","0.79167","401","265","136","Tony Knap"
"1976","Boise St. (ID)","5","5","1","0.5","283","197","86","Jim Criner"
"1977","Boise St. (ID)","9","2","0","0.81818","317","181","136","Jim Criner"
"1978","Boise St. (ID)","7","4","0","0.63636","269","182","87","Jim Criner"
"1979","Boise St. (ID)","10","1","0","0.90909","347","140","207","Jim Criner"
"1980","Boise St. (ID)","10","3","0","0.76923","317","179","138","Jim Criner"
"1981","Boise St. (ID)","10","3","0","0.76923","317","213","104","Jim Criner"
"1982","Boise St. (ID)","8","3","0","0.72727","252","211","41","Jim Criner"
"1983","Boise St. (ID)","6","5","0","0.54545","281","194","87","Lyle Setencich"
"1984","Boise St. (ID)","6","5","0","0.54545","256","227","29","Lyle Setencich"
"1985","Boise St. (ID)","7","4","0","0.63636","288","211","77","Lyle Setencich"
"1986","Boise St. (ID)","5","6","0","0.45455","262","183","79","Lyle Setencich"
"1987","Boise St. (ID)","6","5","0","0.54545","361","261","100","Skip Hall"
"1988","Boise St. (ID)","8","4","0","0.66667","280","274","6","Skip Hall"
"1989","Boise St. (ID)","6","5","0","0.54545","261","245","16","Skip Hall"
"1990","Boise St. (ID)","10","4","0","0.71429","382","258","124","Skip Hall"
"1991","Boise St. (ID)","7","4","0","0.63636","355","197","158","Skip Hall"
"1992","Boise St. (ID)","5","6","0","0.45455","220","286","-66","Skip Hall"
"1996","Boise St. (ID)","1","9","0","0.1","188","363","-175","Tom Mason"
"1993","Boise St. (ID)","3","8","0","0.27273","210","319","-109","Pokey Allen"
"1994","Boise St. (ID)","13","2","0","0.86667","433","291","142","Pokey Allen"
"1995","Boise St. (ID)","7","4","0","0.63636","361","265","96","Pokey Allen"
"1996","Boise St. (ID)","1","1","0","0.5","52","96","-44","Pokey Allen"
"1997","Boise St. (ID)","5","6","0","0.45455","285","358","-73","Houston Nutt"
"1998","Boise St. (ID)","6","5","0","0.54545","329","350","-21","Dirk Koetter"
"1999","Boise St. (ID)","10","3","0","0.76923","430","277","153","Dirk Koetter"
"2000","Boise St. (ID)","10","2","0","0.83333","532","274","258","Dirk Koetter"
"2001","Boise St. (ID)","8","4","0","0.66667","411","280","131","Dan Hawkins"
"2002","Boise St. (ID)","12","1","0","0.92308","593","240","353","Dan Hawkins"
"2003","Boise St. (ID)","13","1","0","0.92857","602","239","363","Dan Hawkins"
"2004","Boise St. (ID)","11","1","0","0.91667","587","308","279","Dan Hawkins"
"2005","Boise St. (ID)","9","4","0","0.69231","469","317","152","Dan Hawkins"
"2006","Boise St. (ID)","13","0","0","1","516","229","287","Chris Petersen"
"2007","Boise St. (ID)","10","3","0","0.76923","551","281","270","Chris Petersen"
"2008","Boise St. (ID)","12","1","0","0.92308","489","164","325","Chris Petersen"
"2009","Boise St. (ID)","14","0","0","1","591","240","351","Chris Petersen"
"2010","Boise St. (ID)","12","1","0","0.92308","586","166","420","Chris Petersen"
"2011","Boise St. (ID)","12","1","0","0.92308","575","243","332","Chris Petersen"
"2012","Boise St. (ID)","11","2","0","0.84615","393","205","188","Chris Petersen"
"2013","Boise St. (ID)","8","4","0","0.66667","465","285","180","Chris Petersen"
"2013","Boise St. (ID)","0","1","0","0","23","38","-15","Bob Gregory"
"2014","Boise St. (ID)","12","2","0","0.85714","556","375","181","Bryan Harsin"
"1893","Boston College (MA)","1","2","0","0.33333","10","22","-12","Joseph Drum"
"1894","Boston College (MA)","1","6","0","0.14286","20","116","-96","William Nagle"
"1895","Boston College (MA)","2","4","2","0.375","36","106","-70","Joseph Lawless"
"1896","Boston College (MA)","5","3","0","0.625","54","64","-10","Frank Carney"
"1897","Boston College (MA)","4","4","0","0.5","58","58","0","John Dunlop"
"1898","Boston College (MA)","2","5","1","0.3125","22","41","-19","John Dunlop"
"1899","Boston College (MA)","8","1","1","0.85","85","18","67","John Dunlop"
"1901","Boston College (MA)","2","7","0","0.22222","28","108","-80","John Dunlop"
"1900","Boston College (MA)","1","0","0","1","5","0","5","No Team"
"1902","Boston College (MA)","0","9","0","0","17","180","-163","Arthur White"
"1908","Boston College (MA)","2","4","2","0.375","30","54","-24","Joseph ""Joe"" Reilly & Joseph Kenney"
"1909","Boston College (MA)","3","4","1","0.4375","71","42","29","Charles McCarthy"
"1910","Boston College (MA)","0","4","2","0.16667","16","73","-57","James Hart"
"1911","Boston College (MA)","0","7","0","0","3","97","-94","Joseph Courtney"
"1912","Boston College (MA)","2","4","1","0.35714","33","157","-124","Willliam P. ""Hiker"" Joy"
"1913","Boston College (MA)","4","3","1","0.5625","166","72","94","Willliam P. ""Hiker"" Joy"
"1914","Boston College (MA)","5","4","0","0.55556","119","80","39","Stephen Mahoney"
"1915","Boston College (MA)","3","4","0","0.42857","45","69","-24","Stephen Mahoney"
"1916","Boston College (MA)","6","2","0","0.75","167","66","101","Charles E. Brickley"
"1917","Boston College (MA)","6","2","0","0.75","208","33","175","Charles E. Brickley"
"1918","Boston College (MA)","5","2","0","0.71429","142","35","107","Frank Morrisey"
"1919","Boston College (MA)","5","3","0","0.625","78","62","16","Frank W. Cavanaugh"
"1920","Boston College (MA)","8","0","0","1","181","16","165","Frank W. Cavanaugh"
"1921","Boston College (MA)","4","3","1","0.5625","85","90","-5","Frank W. Cavanaugh"
"1922","Boston College (MA)","6","2","1","0.72222","133","58","75","Frank W. Cavanaugh"
"1923","Boston College (MA)","7","1","1","0.83333","167","14","153","Frank W. Cavanaugh"
"1924","Boston College (MA)","6","3","0","0.66667","198","74","124","Frank W. Cavanaugh"
"1925","Boston College (MA)","6","2","0","0.75","152","53","99","Frank W. Cavanaugh"
"1926","Boston College (MA)","6","0","2","0.875","222","34","188","Frank W. Cavanaugh"
"1927","Boston College (MA)","4","4","0","0.5","101","105","-4","D. Leo Daley"
"1928","Boston College (MA)","9","0","0","1","263","39","224","Joseph ""Joe"" McKenney"
"1929","Boston College (MA)","7","2","1","0.75","202","65","137","Joseph ""Joe"" McKenney"
"1930","Boston College (MA)","5","5","0","0.5","167","70","97","Joseph ""Joe"" McKenney"
"1931","Boston College (MA)","6","4","0","0.6","115","74","41","Joseph ""Joe"" McKenney"
"1932","Boston College (MA)","4","2","2","0.625","73","59","14","Joseph ""Joe"" McKenney"
"1933","Boston College (MA)","8","1","0","0.88889","169","50","119","Joseph ""Joe"" McKenney"
"1934","Boston College (MA)","5","4","0","0.55556","64","72","-8","Joseph ""Joe"" McKenney"
"1935","Boston College (MA)","3","2","0","0.6","96","44","52","Harry J. Downes"
"1935","Boston College (MA)","3","1","0","0.75","50","33","17","John R. ""Dinny"" McNamara"
"1936","Boston College (MA)","6","1","2","0.77778","109","55","54","Gilmour ""Gloomy Gil"" Dobie"
"1937","Boston College (MA)","4","4","1","0.5","109","68","41","Gilmour ""Gloomy Gil"" Dobie"
"1938","Boston College (MA)","6","1","2","0.77778","186","87","99","Gilmour ""Gloomy Gil"" Dobie"
"1939","Boston College (MA)","9","2","0","0.81818","219","46","173","Frank W. Leahy"
"1940","Boston College (MA)","11","0","0","1","339","65","274","Frank W. Leahy"
"1941","Boston College (MA)","7","3","0","0.7","235","106","129","Dennis E. ""Denny"" Myers"
"1942","Boston College (MA)","8","2","0","0.8","282","111","171","Dennis E. ""Denny"" Myers"
"1946","Boston College (MA)","6","3","0","0.66667","234","123","111","Dennis E. ""Denny"" Myers"
"1947","Boston College (MA)","5","4","0","0.55556","184","134","50","Dennis E. ""Denny"" Myers"
"1948","Boston College (MA)","5","2","2","0.66667","152","134","18","Dennis E. ""Denny"" Myers"
"1949","Boston College (MA)","4","4","1","0.5","209","187","22","Dennis E. ""Denny"" Myers"
"1950","Boston College (MA)","0","9","1","0.05","78","270","-192","Dennis E. ""Denny"" Myers"
"1943","Boston College (MA)","4","0","1","0.9","156","18","138","Amerino ""Moody"" Sarno"
"1944","Boston College (MA)","4","3","0","0.57143","132","134","-2","Amerino ""Moody"" Sarno"
"1945","Boston College (MA)","3","4","0","0.42857","79","171","-92","Amerino ""Moody"" Sarno"
"1951","Boston College (MA)","3","6","0","0.33333","135","198","-63","Michael J. ""Mike"" Holovak"
"1952","Boston College (MA)","4","4","1","0.5","92","129","-37","Michael J. ""Mike"" Holovak"
"1953","Boston College (MA)","5","3","1","0.61111","137","139","-2","Michael J. ""Mike"" Holovak"
"1954","Boston College (MA)","8","1","0","0.88889","196","74","122","Michael J. ""Mike"" Holovak"
"1955","Boston College (MA)","5","2","1","0.6875","176","79","97","Michael J. ""Mike"" Holovak"
"1956","Boston College (MA)","5","4","0","0.55556","149","91","58","Michael J. ""Mike"" Holovak"
"1957","Boston College (MA)","7","2","0","0.77778","158","129","29","Michael J. ""Mike"" Holovak"
"1958","Boston College (MA)","7","3","0","0.7","229","127","102","Michael J. ""Mike"" Holovak"
"1959","Boston College (MA)","5","4","0","0.55556","162","143","19","Michael J. ""Mike"" Holovak"
"1960","Boston College (MA)","3","6","1","0.35","144","148","-4","Ernie Hefferle"
"1961","Boston College (MA)","4","6","0","0.4","117","189","-72","Ernie Hefferle"
"1962","Boston College (MA)","8","2","0","0.8","251","123","128","James H. ""Jim"" Miller"
"1963","Boston College (MA)","6","3","0","0.66667","168","130","38","James H. ""Jim"" Miller"
"1964","Boston College (MA)","6","3","0","0.66667","112","110","2","James H. ""Jim"" Miller"
"1965","Boston College (MA)","6","4","0","0.6","209","117","92","James H. ""Jim"" Miller"
"1966","Boston College (MA)","4","6","0","0.4","133","202","-69","James H. ""Jim"" Miller"
"1967","Boston College (MA)","4","6","0","0.4","227","212","15","James H. ""Jim"" Miller"
"1968","Boston College (MA)","6","3","0","0.66667","253","196","57","Joseph ""Joe"" Yukica"
"1969","Boston College (MA)","5","4","0","0.55556","218","245","-27","Joseph ""Joe"" Yukica"
"1970","Boston College (MA)","8","2","0","0.8","307","142","165","Joseph ""Joe"" Yukica"
"1971","Boston College (MA)","9","2","0","0.81818","259","117","142","Joseph ""Joe"" Yukica"
"1972","Boston College (MA)","4","7","0","0.36364","240","258","-18","Joseph ""Joe"" Yukica"
"1973","Boston College (MA)","7","4","0","0.63636","311","174","137","Joseph ""Joe"" Yukica"
"1974","Boston College (MA)","8","3","0","0.72727","375","154","221","Joseph ""Joe"" Yukica"
"1975","Boston College (MA)","7","4","0","0.63636","227","146","81","Joseph ""Joe"" Yukica"
"1976","Boston College (MA)","8","3","0","0.72727","239","125","114","Joseph ""Joe"" Yukica"
"1977","Boston College (MA)","6","5","0","0.54545","242","269","-27","Joseph ""Joe"" Yukica"
"1978","Boston College (MA)","0","11","0","0","153","294","-141","Ed Chlebek"
"1979","Boston College (MA)","5","6","0","0.45455","215","217","-2","Ed Chlebek"
"1980","Boston College (MA)","7","4","0","0.63636","199","186","13","Ed Chlebek"
"1981","Boston College (MA)","5","6","0","0.45455","243","298","-55","Jack Bicknell, Sr."
"1982","Boston College (MA)","8","3","1","0.70833","294","219","75","Jack Bicknell, Sr."
"1983","Boston College (MA)","9","3","0","0.75","351","190","161","Jack Bicknell, Sr."
"1984","Boston College (MA)","10","2","0","0.83333","449","296","153","Jack Bicknell, Sr."
"1985","Boston College (MA)","4","8","0","0.33333","222","307","-85","Jack Bicknell, Sr."
"1986","Boston College (MA)","9","3","0","0.75","338","233","105","Jack Bicknell, Sr."
"1987","Boston College (MA)","5","6","0","0.45455","244","281","-37","Jack Bicknell, Sr."
"1988","Boston College (MA)","3","8","0","0.27273","237","326","-89","Jack Bicknell, Sr."
"1989","Boston College (MA)","2","9","0","0.18182","207","253","-46","Jack Bicknell, Sr."
"1990","Boston College (MA)","4","7","0","0.36364","190","288","-98","Jack Bicknell, Sr."
"1991","Boston College (MA)","4","7","0","0.36364","247","246","1","Tom Coughlin"
"1992","Boston College (MA)","8","3","1","0.70833","330","238","92","Tom Coughlin"
"1993","Boston College (MA)","9","3","0","0.75","408","240","168","Tom Coughlin"
"1994","Boston College (MA)","7","4","1","0.625","271","169","102","Dan Henning"
"1995","Boston College (MA)","4","8","0","0.33333","207","322","-115","Dan Henning"
"1996","Boston College (MA)","5","7","0","0.41667","264","364","-100","Dan Henning"
"1997","Boston College (MA)","4","7","0","0.36364","237","314","-77","Tom O'Brien"
"1998","Boston College (MA)","4","7","0","0.36364","273","311","-38","Tom O'Brien"
"1999","Boston College (MA)","8","4","0","0.66667","297","308","-11","Tom O'Brien"
"2000","Boston College (MA)","7","5","0","0.58333","378","277","101","Tom O'Brien"
"2001","Boston College (MA)","8","4","0","0.66667","337","227","110","Tom O'Brien"
"2002","Boston College (MA)","9","4","0","0.69231","392","253","139","Tom O'Brien"
"2003","Boston College (MA)","8","5","0","0.61538","370","331","39","Tom O'Brien"
"2004","Boston College (MA)","9","3","0","0.75","296","203","93","Tom O'Brien"
"2005","Boston College (MA)","9","3","0","0.75","310","191","119","Tom O'Brien"
"2006","Boston College (MA)","9","3","0","0.75","313","180","133","Tom O'Brien"
"2007","Boston College (MA)","11","3","0","0.78571","396","285","111","Jeff Jagodzinski"
"2008","Boston College (MA)","9","5","0","0.64286","346","257","89","Jeff Jagodzinski"
"2006","Boston College (MA)","1","0","0","1","25","24","1","Frank Spaziani"
"2009","Boston College (MA)","8","5","0","0.61538","322","257","65","Frank Spaziani"
"2010","Boston College (MA)","7","6","0","0.53846","240","254","-14","Frank Spaziani"
"2011","Boston College (MA)","4","8","0","0.33333","218","282","-64","Frank Spaziani"
"2012","Boston College (MA)","2","10","0","0.16667","238","356","-118","Frank Spaziani"
"2013","Boston College (MA)","7","6","0","0.53846","360","376","-16","Steve Addazio"
"2014","Boston College (MA)","7","6","0","0.53846","341","277","64","Steve Addazio"
"1919","Bowling Green (OH)","0","3","0","0","0","28","-28","John Sitt"
"1920","Bowling Green (OH)","1","4","0","0.2","41","138","-97","Walter Jean"
"1921","Bowling Green (OH)","3","1","1","0.7","178","34","144","Earl Krieger"
"1922","Bowling Green (OH)","4","2","1","0.64286","98","46","52","Allen Snyder"
"1923","Bowling Green (OH)","3","5","0","0.375","68","131","-63","R.B. McCandless"
"1924","Bowling Green (OH)","3","4","0","0.42857","60","73","-13","Warren Steller"
"1925","Bowling Green (OH)","3","1","3","0.64286","34","28","6","Warren Steller"
"1926","Bowling Green (OH)","4","3","1","0.5625","88","70","18","Warren Steller"
"1927","Bowling Green (OH)","5","1","1","0.78571","52","14","38","Warren Steller"
"1928","Bowling Green (OH)","5","0","2","0.85714","84","18","66","Warren Steller"
"1929","Bowling Green (OH)","4","2","1","0.64286","76","54","22","Warren Steller"
"1930","Bowling Green (OH)","6","0","2","0.875","107","38","69","Warren Steller"
"1931","Bowling Green (OH)","3","1","4","0.625","31","21","10","Warren Steller"
"1932","Bowling Green (OH)","3","3","1","0.5","33","77","-44","Warren Steller"
"1933","Bowling Green (OH)","2","3","2","0.42857","44","91","-47","Warren Steller"
"1934","Bowling Green (OH)","2","3","2","0.42857","36","54","-18","Warren Steller"
"1935","Bowling Green (OH)","1","6","0","0.14286","25","246","-221","Harry Ockerman"
"1936","Bowling Green (OH)","4","2","3","0.61111","66","60","6","Harry Ockerman"
"1937","Bowling Green (OH)","3","4","1","0.4375","56","80","-24","Harry Ockerman"
"1938","Bowling Green (OH)","3","2","3","0.5625","95","41","54","Harry Ockerman"
"1939","Bowling Green (OH)","6","1","1","0.8125","159","46","113","Harry Ockerman"
"1940","Bowling Green (OH)","3","4","1","0.4375","62","122","-60","Harry Ockerman"
"1941","Bowling Green (OH)","7","1","1","0.83333","173","40","133","Robert Whittaker"
"1942","Bowling Green (OH)","6","2","1","0.72222","135","55","80","Robert Whittaker"
"1943","Bowling Green (OH)","5","3","1","0.61111","194","104","90","Robert Whittaker"
"1944","Bowling Green (OH)","5","3","0","0.625","133","117","16","Robert Whittaker"
"1945","Bowling Green (OH)","4","3","0","0.57143","79","81","-2","Robert Whittaker"
"1946","Bowling Green (OH)","5","3","0","0.625","95","39","56","Robert Whittaker"
"1947","Bowling Green (OH)","5","5","0","0.5","134","149","-15","Robert Whittaker"
"1948","Bowling Green (OH)","8","0","1","0.94444","230","100","130","Robert Whittaker"
"1949","Bowling Green (OH)","4","5","0","0.44444","206","161","45","Robert Whittaker"
"1950","Bowling Green (OH)","3","4","2","0.44444","134","188","-54","Robert Whittaker"
"1951","Bowling Green (OH)","4","4","1","0.5","150","178","-28","Robert Whittaker"
"1952","Bowling Green (OH)","7","2","0","0.77778","257","155","102","Robert Whittaker"
"1953","Bowling Green (OH)","1","8","0","0.11111","119","252","-133","Robert Whittaker"
"1954","Bowling Green (OH)","2","7","0","0.22222","125","196","-71","Robert Whittaker"
"1955","Bowling Green (OH)","7","1","1","0.83333","224","53","171","Doyt Perry"
"1956","Bowling Green (OH)","8","0","1","0.94444","311","99","212","Doyt Perry"
"1957","Bowling Green (OH)","6","1","2","0.77778","167","55","112","Doyt Perry"
"1958","Bowling Green (OH)","7","2","0","0.77778","218","91","127","Doyt Perry"
"1959","Bowling Green (OH)","9","0","0","1","274","83","191","Doyt Perry"
"1960","Bowling Green (OH)","8","1","0","0.88889","196","61","135","Doyt Perry"
"1961","Bowling Green (OH)","8","2","0","0.8","194","78","116","Doyt Perry"
"1962","Bowling Green (OH)","7","1","1","0.83333","204","91","113","Doyt Perry"
"1963","Bowling Green (OH)","8","2","0","0.8","201","116","85","Doyt Perry"
"1964","Bowling Green (OH)","9","1","0","0.9","275","87","188","Doyt Perry"
"1965","Bowling Green (OH)","7","2","0","0.77778","123","107","16","Bob Gibson"
"1966","Bowling Green (OH)","6","3","0","0.66667","187","124","63","Bob Gibson"
"1967","Bowling Green (OH)","6","4","0","0.6","131","130","1","Bob Gibson"
"1968","Bowling Green (OH)","6","3","1","0.65","267","147","120","Don Nehlen"
"1969","Bowling Green (OH)","6","4","0","0.6","179","146","33","Don Nehlen"
"1970","Bowling Green (OH)","2","6","1","0.27778","118","178","-60","Don Nehlen"
"1971","Bowling Green (OH)","6","4","0","0.6","263","207","56","Don Nehlen"
"1972","Bowling Green (OH)","6","3","1","0.65","184","127","57","Don Nehlen"
"1973","Bowling Green (OH)","7","3","0","0.7","266","209","57","Don Nehlen"
"1974","Bowling Green (OH)","6","4","1","0.59091","249","203","46","Don Nehlen"
"1975","Bowling Green (OH)","8","3","0","0.72727","278","166","112","Don Nehlen"
"1976","Bowling Green (OH)","6","5","0","0.54545","292","249","43","Don Nehlen"
"1977","Bowling Green (OH)","5","7","0","0.41667","275","296","-21","Dennis E. ""Denny"" Stolz"
"1978","Bowling Green (OH)","4","7","0","0.36364","277","267","10","Dennis E. ""Denny"" Stolz"
"1979","Bowling Green (OH)","4","7","0","0.36364","194","265","-71","Dennis E. ""Denny"" Stolz"
"1980","Bowling Green (OH)","4","7","0","0.36364","189","186","3","Dennis E. ""Denny"" Stolz"
"1981","Bowling Green (OH)","5","5","1","0.5","155","132","23","Dennis E. ""Denny"" Stolz"
"1982","Bowling Green (OH)","7","5","0","0.58333","265","199","66","Dennis E. ""Denny"" Stolz"
"1983","Bowling Green (OH)","8","3","0","0.72727","277","242","35","Dennis E. ""Denny"" Stolz"
"1984","Bowling Green (OH)","8","3","0","0.72727","327","198","129","Dennis E. ""Denny"" Stolz"
"1985","Bowling Green (OH)","11","1","0","0.91667","355","223","132","Dennis E. ""Denny"" Stolz"
"1986","Bowling Green (OH)","5","6","0","0.45455","148","222","-74","Moe Ankney"
"1987","Bowling Green (OH)","5","6","0","0.45455","215","249","-34","Moe Ankney"
"1988","Bowling Green (OH)","2","8","1","0.22727","159","333","-174","Moe Ankney"
"1989","Bowling Green (OH)","5","6","0","0.45455","233","319","-86","Moe Ankney"
"1990","Bowling Green (OH)","3","5","2","0.4","138","163","-25","Moe Ankney"
"1991","Bowling Green (OH)","11","1","0","0.91667","279","168","111","Gary Blackney"
"1992","Bowling Green (OH)","10","2","0","0.83333","324","235","89","Gary Blackney"
"1993","Bowling Green (OH)","6","3","2","0.63636","268","173","95","Gary Blackney"
"1994","Bowling Green (OH)","9","2","0","0.81818","391","174","217","Gary Blackney"
"1995","Bowling Green (OH)","5","6","0","0.45455","226","228","-2","Gary Blackney"
"1996","Bowling Green (OH)","4","7","0","0.36364","176","240","-64","Gary Blackney"
"1997","Bowling Green (OH)","3","8","0","0.27273","191","341","-150","Gary Blackney"
"1998","Bowling Green (OH)","5","6","0","0.45455","292","312","-20","Gary Blackney"
"1999","Bowling Green (OH)","5","6","0","0.45455","296","312","-16","Gary Blackney"
"2000","Bowling Green (OH)","2","9","0","0.18182","174","289","-115","Gary Blackney"
"2001","Bowling Green (OH)","8","3","0","0.72727","333","215","118","Urban Meyer"
"2002","Bowling Green (OH)","9","3","0","0.75","490","304","186","Urban Meyer"
"2003","Bowling Green (OH)","11","3","0","0.78571","470","304","166","Gregg Brandon"
"2004","Bowling Green (OH)","9","3","0","0.75","532","282","250","Gregg Brandon"
"2005","Bowling Green (OH)","6","5","0","0.54545","372","304","68","Gregg Brandon"
"2006","Bowling Green (OH)","4","8","0","0.33333","234","340","-106","Gregg Brandon"
"2007","Bowling Green (OH)","8","5","0","0.61538","392","417","-25","Gregg Brandon"
"2008","Bowling Green (OH)","6","6","0","0.5","332","278","54","Gregg Brandon"
"2009","Bowling Green (OH)","7","6","0","0.53846","370","357","13","Dave Clawson"
"2010","Bowling Green (OH)","2","10","0","0.16667","255","403","-148","Dave Clawson"
"2011","Bowling Green (OH)","5","7","0","0.41667","318","346","-28","Dave Clawson"
"2012","Bowling Green (OH)","8","5","0","0.61538","298","218","80","Dave Clawson"
"2013","Bowling Green (OH)","10","3","0","0.76923","460","192","268","Dave Clawson"
"2013","Bowling Green (OH)","0","1","0","0","27","30","-3","Adam Scheier"
"2014","Bowling Green (OH)","8","6","0","0.57143","420","469","-49","Dino Babers"
"1922","Brigham Young (UT)","1","5","0","0.16667","10","184","-174","Alvin G. Twitchell"
"1923","Brigham Young (UT)","2","5","0","0.28571","47","156","-109","Alvin G. Twitchell"
"1924","Brigham Young (UT)","2","3","1","0.41667","44","61","-17","Alvin G. Twitchell"
"1925","Brigham Young (UT)","3","3","0","0.5","69","81","-12","Charles J. Hart"
"1926","Brigham Young (UT)","1","5","1","0.21429","49","115","-66","Charles J. Hart"
"1927","Brigham Young (UT)","2","4","1","0.35714","105","118","-13","Charles J. Hart"
"1928","Brigham Young (UT)","3","3","1","0.5","75","56","19","G. Ottinger ""Ott"" Romney"
"1929","Brigham Young (UT)","6","3","1","0.65","184","122","62","G. Ottinger ""Ott"" Romney"
"1930","Brigham Young (UT)","6","2","4","0.66667","207","179","28","G. Ottinger ""Ott"" Romney"
"1931","Brigham Young (UT)","4","4","0","0.5","69","104","-35","G. Ottinger ""Ott"" Romney"
"1932","Brigham Young (UT)","8","1","0","0.88889","188","50","138","G. Ottinger ""Ott"" Romney"
"1933","Brigham Young (UT)","5","4","0","0.55556","81","67","14","G. Ottinger ""Ott"" Romney"
"1934","Brigham Young (UT)","4","5","0","0.44444","144","169","-25","G. Ottinger ""Ott"" Romney"
"1935","Brigham Young (UT)","4","4","0","0.5","78","90","-12","G. Ottinger ""Ott"" Romney"
"1936","Brigham Young (UT)","4","5","0","0.44444","123","123","0","G. Ottinger ""Ott"" Romney"
"1937","Brigham Young (UT)","6","3","0","0.66667","164","41","123","Edwin R. ""Eddie"" Kimball"
"1938","Brigham Young (UT)","4","3","1","0.5625","93","49","44","Edwin R. ""Eddie"" Kimball"
"1939","Brigham Young (UT)","5","2","2","0.66667","110","90","20","Edwin R. ""Eddie"" Kimball"
"1940","Brigham Young (UT)","2","4","2","0.375","79","93","-14","Edwin R. ""Eddie"" Kimball"
"1941","Brigham Young (UT)","4","3","2","0.55556","136","100","36","Edwin R. ""Eddie"" Kimball"
"1946","Brigham Young (UT)","5","4","1","0.55","94","119","-25","Edwin R. ""Eddie"" Kimball"
"1947","Brigham Young (UT)","3","7","0","0.3","168","182","-14","Edwin R. ""Eddie"" Kimball"
"1948","Brigham Young (UT)","5","6","0","0.45455","135","199","-64","Edwin R. ""Eddie"" Kimball"
"1942","Brigham Young (UT)","2","5","0","0.28571","55","133","-78","W. Floyd Millet"
"1949","Brigham Young (UT)","0","11","0","0","105","372","-267","Charles L. ""Chick"" Atkinson"
"1950","Brigham Young (UT)","4","5","1","0.45","169","292","-123","Charles L. ""Chick"" Atkinson"
"1951","Brigham Young (UT)","6","3","1","0.65","215","184","31","Charles L. ""Chick"" Atkinson"
"1952","Brigham Young (UT)","4","6","0","0.4","154","240","-86","Charles L. ""Chick"" Atkinson"
"1953","Brigham Young (UT)","2","7","1","0.25","172","228","-56","Charles L. ""Chick"" Atkinson"
"1954","Brigham Young (UT)","1","8","0","0.11111","96","188","-92","Charles L. ""Chick"" Atkinson"
"1955","Brigham Young (UT)","1","9","0","0.1","104","300","-196","Charles L. ""Chick"" Atkinson"
"1956","Brigham Young (UT)","2","7","1","0.25","147","232","-85","Harold W. ""Hal"" Kopp"
"1957","Brigham Young (UT)","5","3","2","0.6","134","138","-4","Harold W. ""Hal"" Kopp"
"1958","Brigham Young (UT)","6","4","0","0.6","189","150","39","Harold W. ""Hal"" Kopp"
"1959","Brigham Young (UT)","3","7","0","0.3","101","169","-68","Floyd ""Tally"" Stevens"
"1960","Brigham Young (UT)","3","8","0","0.27273","102","207","-105","Floyd ""Tally"" Stevens"
"1961","Brigham Young (UT)","2","8","0","0.2","130","289","-159","Hal Mitchell"
"1962","Brigham Young (UT)","4","6","0","0.4","197","170","27","Hal Mitchell"
"1963","Brigham Young (UT)","2","8","0","0.2","91","222","-131","Hal Mitchell"
"1964","Brigham Young (UT)","3","6","1","0.35","173","210","-37","Tommy Hudspeth"
"1965","Brigham Young (UT)","6","4","0","0.6","229","178","51","Tommy Hudspeth"
"1966","Brigham Young (UT)","8","2","0","0.8","269","163","106","Tommy Hudspeth"
"1967","Brigham Young (UT)","6","4","0","0.6","278","215","63","Tommy Hudspeth"
"1968","Brigham Young (UT)","2","8","0","0.2","179","247","-68","Tommy Hudspeth"
"1969","Brigham Young (UT)","6","4","0","0.6","186","158","28","Tommy Hudspeth"
"1970","Brigham Young (UT)","3","8","0","0.27273","138","255","-117","Tommy Hudspeth"
"1971","Brigham Young (UT)","5","6","0","0.45455","227","199","28","Tommy Hudspeth"
"1972","Brigham Young (UT)","7","4","0","0.63636","251","227","24","LaVell Edwards"
"1973","Brigham Young (UT)","5","6","0","0.45455","334","248","86","LaVell Edwards"
"1974","Brigham Young (UT)","7","4","1","0.625","302","199","103","LaVell Edwards"
"1975","Brigham Young (UT)","6","5","0","0.54545","244","228","16","LaVell Edwards"
"1976","Brigham Young (UT)","9","3","0","0.75","372","231","141","LaVell Edwards"
"1977","Brigham Young (UT)","9","2","0","0.81818","433","165","268","LaVell Edwards"
"1978","Brigham Young (UT)","9","4","0","0.69231","320","199","121","LaVell Edwards"
"1979","Brigham Young (UT)","11","1","0","0.91667","484","163","321","LaVell Edwards"
"1980","Brigham Young (UT)","12","1","0","0.92308","606","243","363","LaVell Edwards"
"1981","Brigham Young (UT)","11","2","0","0.84615","503","256","247","LaVell Edwards"
"1982","Brigham Young (UT)","8","4","0","0.66667","375","214","161","LaVell Edwards"
"1983","Brigham Young (UT)","11","1","0","0.91667","505","247","258","LaVell Edwards"
"1984","Brigham Young (UT)","13","0","0","1","456","183","273","LaVell Edwards"
"1985","Brigham Young (UT)","11","3","0","0.78571","442","186","256","LaVell Edwards"
"1986","Brigham Young (UT)","8","5","0","0.61538","310","236","74","LaVell Edwards"
"1987","Brigham Young (UT)","9","4","0","0.69231","350","293","57","LaVell Edwards"
"1988","Brigham Young (UT)","9","4","0","0.69231","421","281","140","LaVell Edwards"
"1989","Brigham Young (UT)","10","3","0","0.76923","523","369","154","LaVell Edwards"
"1990","Brigham Young (UT)","10","3","0","0.76923","524","350","174","LaVell Edwards"
"1991","Brigham Young (UT)","8","3","2","0.69231","433","321","112","LaVell Edwards"
"1992","Brigham Young (UT)","8","5","0","0.61538","375","298","77","LaVell Edwards"
"1993","Brigham Young (UT)","6","6","0","0.5","411","435","-24","LaVell Edwards"
"1994","Brigham Young (UT)","10","3","0","0.76923","385","300","85","LaVell Edwards"
"1995","Brigham Young (UT)","7","4","0","0.63636","307","268","39","LaVell Edwards"
"1996","Brigham Young (UT)","14","1","0","0.93333","590","277","313","LaVell Edwards"
"1997","Brigham Young (UT)","6","5","0","0.54545","250","254","-4","LaVell Edwards"
"1998","Brigham Young (UT)","9","5","0","0.64286","402","290","112","LaVell Edwards"
"1999","Brigham Young (UT)","8","4","0","0.66667","335","251","84","LaVell Edwards"
"2000","Brigham Young (UT)","6","6","0","0.5","280","310","-30","LaVell Edwards"
"2001","Brigham Young (UT)","12","2","0","0.85714","618","424","194","Gary Crowton"
"2002","Brigham Young (UT)","5","7","0","0.41667","272","333","-61","Gary Crowton"
"2003","Brigham Young (UT)","4","8","0","0.33333","196","310","-114","Gary Crowton"
"2004","Brigham Young (UT)","5","6","0","0.45455","267","295","-28","Gary Crowton"
"2005","Brigham Young (UT)","6","6","0","0.5","396","351","45","Bronco Mendenhall"
"2006","Brigham Young (UT)","11","2","0","0.84615","478","191","287","Bronco Mendenhall"
"2007","Brigham Young (UT)","11","2","0","0.84615","391","241","150","Bronco Mendenhall"
"2008","Brigham Young (UT)","10","3","0","0.76923","445","285","160","Bronco Mendenhall"
"2009","Brigham Young (UT)","11","2","0","0.84615","461","280","181","Bronco Mendenhall"
"2010","Brigham Young (UT)","7","6","0","0.53846","340","281","59","Bronco Mendenhall"
"2011","Brigham Young (UT)","10","3","0","0.76923","391","265","126","Bronco Mendenhall"
"2012","Brigham Young (UT)","8","5","0","0.61538","373","182","191","Bronco Mendenhall"
"2013","Brigham Young (UT)","8","5","0","0.61538","392","287","105","Bronco Mendenhall"
"2014","Brigham Young (UT)","8","5","0","0.61538","482","358","124","Bronco Mendenhall"
"1897","Buffalo (NY)","8","0","0","1","162","12","150","C.W. Dibble"
"1903","Buffalo (NY)","4","4","0","0.5","51","129","-78","Ray Turnbull"
"1915","Buffalo (NY)","4","4","0","0.5","53","110","-57","Frank Mount Pleasant"
"1916","Buffalo (NY)","3","5","2","0.4","24","88","-64","Art Powell"
"1917","Buffalo (NY)","4","4","0","0.5","125","59","66","Art Powell"
"1918","Buffalo (NY)","6","1","0","0.85714","234","40","194","Art Powell"
"1919","Buffalo (NY)","0","5","1","0.08333","12","114","-102","Art Powell"
"1920","Buffalo (NY)","1","4","0","0.2","17","60","-43","Art Powell"
"1921","Buffalo (NY)","2","3","2","0.42857","74","105","-31","Art Powell"
"1922","Buffalo (NY)","1","5","0","0.16667","38","86","-48","Dim Batterson"
"1923","Buffalo (NY)","2","5","1","0.3125","66","115","-49","James Bond"
"1924","Buffalo (NY)","1","7","0","0.125","27","139","-112","Russ Carrick"
"1925","Buffalo (NY)","3","4","1","0.4375","18","122","-104","Russ Carrick"
"1926","Buffalo (NY)","0","8","0","0","26","237","-211","Russ Carrick"
"1927","Buffalo (NY)","0","6","1","0.07143","7","212","-205","Russ Carrick"
"1928","Buffalo (NY)","1","6","0","0.14286","18","178","-160","Russ Carrick"
"1929","Buffalo (NY)","5","2","0","0.71429","92","74","18","Jay ""Biffy"" Lee"
"1930","Buffalo (NY)","3","5","0","0.375","79","210","-131","Jay ""Biffy"" Lee"
"1931","Buffalo (NY)","2","6","0","0.25","64","171","-107","Bill Pritchard"
"1934","Buffalo (NY)","2","4","1","0.35714","35","106","-71","George Van Bibber"
"1935","Buffalo (NY)","2","6","0","0.25","26","213","-187","George Van Bibber"
"1936","Buffalo (NY)","5","3","0","0.625","121","127","-6","Jim Peelle"
"1937","Buffalo (NY)","4","4","0","0.5","88","94","-6","Jim Peelle"
"1938","Buffalo (NY)","2","6","0","0.25","81","158","-77","Jim Peelle"
"1939","Buffalo (NY)","0","7","0","0","7","126","-119","Jim Peelle"
"1940","Buffalo (NY)","3","5","0","0.375","47","116","-69","Jim Peelle"
"1941","Buffalo (NY)","3","4","1","0.4375","55","75","-20","Jim Peelle"
"1942","Buffalo (NY)","6","2","0","0.75","215","52","163","Jim Peelle"
"1946","Buffalo (NY)","7","2","0","0.77778","224","91","133","Jim Peelle"
"1947","Buffalo (NY)","8","1","0","0.88889","258","79","179","Jim Peelle"
"1948","Buffalo (NY)","6","1","1","0.8125","235","105","130","Frank Clair"
"1949","Buffalo (NY)","6","3","0","0.66667","183","93","90","Frank Clair"
"1932","Buffalo (NY)","1","5","1","0.21429","19","208","-189","James B. ""Jimmy"" Wilson"
"1933","Buffalo (NY)","2","3","2","0.42857","38","95","-57","James B. ""Jimmy"" Wilson"
"1950","Buffalo (NY)","5","3","0","0.625","191","129","62","James B. ""Jimmy"" Wilson"
"1951","Buffalo (NY)","4","4","0","0.5","144","189","-45","James B. ""Jimmy"" Wilson"
"1952","Buffalo (NY)","1","7","0","0.125","59","201","-142","Fritz Febel"
"1953","Buffalo (NY)","1","5","1","0.21429","44","181","-137","Fritz Febel"
"1954","Buffalo (NY)","2","7","0","0.22222","72","247","-175","Fritz Febel"
"1955","Buffalo (NY)","4","4","1","0.5","186","118","68","Dick Offenhammer"
"1956","Buffalo (NY)","5","3","0","0.625","227","122","105","Dick Offenhammer"
"1957","Buffalo (NY)","5","4","0","0.55556","108","101","7","Dick Offenhammer"
"1958","Buffalo (NY)","8","1","0","0.88889","236","101","135","Dick Offenhammer"
"1959","Buffalo (NY)","8","1","0","0.88889","279","93","186","Dick Offenhammer"
"1960","Buffalo (NY)","4","6","0","0.4","213","238","-25","Dick Offenhammer"
"1961","Buffalo (NY)","4","5","0","0.44444","136","163","-27","Dick Offenhammer"
"1962","Buffalo (NY)","6","3","0","0.66667","159","148","11","Dick Offenhammer"
"1963","Buffalo (NY)","5","3","1","0.61111","120","85","35","Dick Offenhammer"
"1964","Buffalo (NY)","4","4","1","0.5","177","97","80","Dick Offenhammer"
"1965","Buffalo (NY)","5","3","2","0.6","145","78","67","Dick Offenhammer"
"1966","Buffalo (NY)","5","5","0","0.5","220","172","48","Richard ""Doc"" Urich"
"1967","Buffalo (NY)","6","4","0","0.6","241","191","50","Richard ""Doc"" Urich"
"1968","Buffalo (NY)","7","3","0","0.7","185","183","2","Richard ""Doc"" Urich"
"1969","Buffalo (NY)","6","3","0","0.66667","174","89","85","Bob Deming"
"1970","Buffalo (NY)","2","9","0","0.18182","133","299","-166","Bob Deming"
"1977","Buffalo (NY)","0","3","1","0.125","36","87","-51","Bill Dando"
"1978","Buffalo (NY)","3","6","0","0.33333","164","211","-47","Bill Dando"
"1979","Buffalo (NY)","4","5","0","0.44444","117","177","-60","Bill Dando"
"1980","Buffalo (NY)","6","5","0","0.54545","138","241","-103","Bill Dando"
"1981","Buffalo (NY)","5","5","0","0.5","187","168","19","Bill Dando"
"1982","Buffalo (NY)","5","5","0","0.5","291","180","111","Bill Dando"
"1983","Buffalo (NY)","8","2","0","0.8","232","150","82","Bill Dando"
"1984","Buffalo (NY)","6","4","0","0.6","192","140","52","Bill Dando"
"1985","Buffalo (NY)","4","6","0","0.4","188","206","-18","Bill Dando"
"1986","Buffalo (NY)","9","2","0","0.81818","264","182","82","Bill Dando"
"1987","Buffalo (NY)","3","7","0","0.3","151","204","-53","Bill Dando"
"1988","Buffalo (NY)","2","8","0","0.2","148","237","-89","Bill Dando"
"1989","Buffalo (NY)","4","6","0","0.4","198","217","-19","Bill Dando"
"1990","Buffalo (NY)","2","8","0","0.2","188","330","-142","Sam Sanders"
"1991","Buffalo (NY)","3","7","0","0.3","231","304","-73","Sam Sanders"
"1992","Buffalo (NY)","4","6","0","0.4","319","395","-76","Jim Ward"
"1993","Buffalo (NY)","2","9","0","0.18182","190","359","-169","Jim Ward"
"1994","Buffalo (NY)","3","8","0","0.27273","156","331","-175","Jim Ward"
"1995","Buffalo (NY)","3","8","0","0.27273","198","259","-61","Craig Cirbus"
"1996","Buffalo (NY)","8","3","0","0.72727","271","241","30","Craig Cirbus"
"1997","Buffalo (NY)","2","9","0","0.18182","229","421","-192","Craig Cirbus"
"1998","Buffalo (NY)","4","7","0","0.36364","315","340","-25","Craig Cirbus"
"1999","Buffalo (NY)","0","11","0","0","130","426","-296","Craig Cirbus"
"2000","Buffalo (NY)","2","9","0","0.18182","177","452","-275","Craig Cirbus"
"2001","Buffalo (NY)","3","8","0","0.27273","205","286","-81","Jim Hofher"
"2002","Buffalo (NY)","1","11","0","0.08333","214","416","-202","Jim Hofher"
"2003","Buffalo (NY)","1","11","0","0.08333","177","445","-268","Jim Hofher"
"2004","Buffalo (NY)","2","9","0","0.18182","197","351","-154","Jim Hofher"
"2005","Buffalo (NY)","1","10","0","0.09091","110","327","-217","Jim Hofher"
"2006","Buffalo (NY)","2","10","0","0.16667","220","431","-211","Turner Gill"
"2007","Buffalo (NY)","5","7","0","0.41667","291","331","-40","Turner Gill"
"2008","Buffalo (NY)","8","6","0","0.57143","424","395","29","Turner Gill"
"2009","Buffalo (NY)","5","7","0","0.41667","289","285","4","Turner Gill"
"2010","Buffalo (NY)","2","10","0","0.16667","170","334","-164","Jeff Quinn"
"2011","Buffalo (NY)","3","9","0","0.25","266","353","-87","Jeff Quinn"
"2012","Buffalo (NY)","4","8","0","0.33333","255","342","-87","Jeff Quinn"
"2013","Buffalo (NY)","8","5","0","0.61538","394","317","77","Jeff Quinn"
"2014","Buffalo (NY)","3","4","0","0.42857","231","245","-14","Jeff Quinn"
"2014","Buffalo (NY)","2","2","0","0.5","124","102","22","Alex Wood"
"1885","California","6","2","1","0.72222","88","35","53","Oscar S. Howard"
"1886","California","4","0","0","1","66","12","54","Oscar S. Howard"
"1887","California","67","35","3","0.65238","2660","935","1725","No Coach"
"1892","California","2","1","1","0.625","44","34","10","Thomas Lee McClung"
"1893","California","4","1","1","0.75","88","50","38","Walt W. ""Pudge"" Heffelfinger"
"1894","California","0","2","2","0.25","12","48","-36","Charles O. Gill"
"1895","California","3","1","1","0.7","46","10","36","Frank S. Butterworth"
"1896","California","6","2","2","0.7","150","56","94","Frank S. Butterworth"
"1897","California","0","3","2","0.2","8","58","-50","Charles P. Nott"
"1898","California","8","0","2","0.9","221","5","216","Garrett Cochran"
"1899","California","7","1","1","0.83333","142","2","140","Garrett Cochran"
"1900","California","4","2","1","0.64286","53","7","46","Addison W. Kelly"
"1901","California","9","0","1","0.95","106","15","91","Frank W. Simpson"
"1902","California","8","0","0","1","168","12","156","James R. Whipple"
"1903","California","6","1","2","0.77778","128","12","116","James R. Whipple"
"1904","California","6","1","1","0.8125","75","24","51","James Hopper"
"1905","California","4","1","2","0.71429","75","12","63","J.W. Knibbs"
"1915","California","10","5","0","0.66667","282","196","86","James G. Schaeffer"
"1916","California","6","4","1","0.59091","192","103","89","Andrew L. ""Andy"" Smith"
"1917","California","5","5","1","0.5","149","104","45","Andrew L. ""Andy"" Smith"
"1918","California","7","2","0","0.77778","187","62","125","Andrew L. ""Andy"" Smith"
"1919","California","6","2","1","0.72222","147","64","83","Andrew L. ""Andy"" Smith"
"1920","California","9","0","0","1","510","14","496","Andrew L. ""Andy"" Smith"
"1921","California","9","0","1","0.95","312","33","279","Andrew L. ""Andy"" Smith"
"1922","California","9","0","0","1","398","34","364","Andrew L. ""Andy"" Smith"
"1923","California","9","0","1","0.95","182","7","175","Andrew L. ""Andy"" Smith"
"1924","California","8","0","2","0.9","162","51","111","Andrew L. ""Andy"" Smith"
"1925","California","6","3","0","0.66667","192","49","143","Andrew L. ""Andy"" Smith"
"1926","California","3","6","0","0.33333","105","167","-62","Clarence M. Price"
"1927","California","7","3","0","0.7","184","64","120","Clarence M. Price"
"1928","California","6","2","2","0.7","141","36","105","Clarence M. Price"
"1929","California","7","1","1","0.83333","155","78","77","Clarence M. Price"
"1930","California","4","5","0","0.44444","87","170","-83","Clarence M. Price"
"1931","California","8","2","0","0.8","106","41","65","William A. ""Bill"" Ingram"
"1932","California","7","3","2","0.66667","169","89","80","William A. ""Bill"" Ingram"
"1933","California","6","3","2","0.63636","161","39","122","William A. ""Bill"" Ingram"
"1934","California","6","6","0","0.5","176","110","66","William A. ""Bill"" Ingram"
"1935","California","9","1","0","0.9","163","22","141","Leonard B. ""Stub"" Allison"
"1936","California","6","5","0","0.54545","147","74","73","Leonard B. ""Stub"" Allison"
"1937","California","10","0","1","0.95455","214","33","181","Leonard B. ""Stub"" Allison"
"1938","California","10","1","0","0.90909","219","44","175","Leonard B. ""Stub"" Allison"
"1939","California","3","7","0","0.3","93","134","-41","Leonard B. ""Stub"" Allison"
"1940","California","4","6","0","0.4","84","128","-44","Leonard B. ""Stub"" Allison"
"1941","California","4","5","0","0.44444","107","71","36","Leonard B. ""Stub"" Allison"
"1942","California","5","5","0","0.5","98","107","-9","Leonard B. ""Stub"" Allison"
"1943","California","4","6","0","0.4","99","143","-44","Leonard B. ""Stub"" Allison"
"1944","California","3","6","1","0.35","78","149","-71","Leonard B. ""Stub"" Allison"
"1945","California","4","5","1","0.45","93","107","-14","Lawrence T. ""Buck"" Shaw"
"1946","California","2","7","0","0.22222","112","169","-57","Frank H. Wickhorst"
"1947","California","9","1","0","0.9","275","111","164","Lynn O. ""Pappy"" Waldorf"
"1948","California","10","1","0","0.90909","291","100","191","Lynn O. ""Pappy"" Waldorf"
"1949","California","10","1","0","0.90909","319","131","188","Lynn O. ""Pappy"" Waldorf"
"1950","California","9","1","1","0.86364","224","90","134","Lynn O. ""Pappy"" Waldorf"
"1951","California","8","2","0","0.8","307","166","141","Lynn O. ""Pappy"" Waldorf"
"1952","California","7","3","0","0.7","247","127","120","Lynn O. ""Pappy"" Waldorf"
"1953","California","4","4","2","0.5","220","170","50","Lynn O. ""Pappy"" Waldorf"
"1954","California","5","5","0","0.5","249","177","72","Lynn O. ""Pappy"" Waldorf"
"1955","California","2","7","1","0.25","107","216","-109","Lynn O. ""Pappy"" Waldorf"
"1956","California","3","7","0","0.3","135","181","-46","Lynn O. ""Pappy"" Waldorf"
"1957","California","1","9","0","0.1","109","176","-67","Peter R. Elliott"
"1958","California","7","4","0","0.63636","207","200","7","Peter R. Elliott"
"1959","California","2","8","0","0.2","115","223","-108","Peter R. Elliott"
"1960","California","2","7","1","0.25","93","195","-102","Marvin ""Marv"" Levy"
"1961","California","1","8","1","0.15","118","268","-150","Marvin ""Marv"" Levy"
"1962","California","1","9","0","0.1","143","247","-104","Marvin ""Marv"" Levy"
"1963","California","4","5","1","0.45","195","213","-18","Marvin ""Marv"" Levy"
"1964","California","3","7","0","0.3","152","187","-35","Ray Willsey"
"1965","California","5","5","0","0.5","125","194","-69","Ray Willsey"
"1966","California","3","7","0","0.3","131","197","-66","Ray Willsey"
"1967","California","5","5","0","0.5","155","195","-40","Ray Willsey"
"1968","California","7","3","1","0.68182","243","114","129","Ray Willsey"
"1969","California","5","5","0","0.5","180","182","-2","Ray Willsey"
"1970","California","6","5","0","0.54545","272","249","23","Ray Willsey"
"1971","California","6","5","0","0.54545","186","262","-76","Ray Willsey"
"1972","California","3","8","0","0.27273","228","314","-86","Mike White"
"1973","California","4","7","0","0.36364","245","380","-135","Mike White"
"1974","California","7","3","1","0.68182","276","213","63","Mike White"
"1975","California","8","3","0","0.72727","330","233","97","Mike White"
"1976","California","5","6","0","0.45455","230","226","4","Mike White"
"1977","California","8","3","0","0.72727","300","211","89","Mike White"
"1978","California","6","5","0","0.54545","236","289","-53","Roger Theder"
"1979","California","7","5","0","0.58333","257","194","63","Roger Theder"
"1980","California","3","8","0","0.27273","194","328","-134","Roger Theder"
"1981","California","2","9","0","0.18182","197","287","-90","Roger Theder"
"1982","California","7","4","0","0.63636","220","233","-13","Joe Kapp"
"1983","California","5","5","1","0.5","242","227","15","Joe Kapp"
"1984","California","2","9","0","0.18182","150","264","-114","Joe Kapp"
"1985","California","4","7","0","0.36364","233","265","-32","Joe Kapp"
"1986","California","2","9","0","0.18182","145","325","-180","Joe Kapp"
"1987","California","3","6","2","0.36364","239","267","-28","Bruce Snyder"
"1988","California","5","5","1","0.5","243","244","-1","Bruce Snyder"
"1989","California","4","7","0","0.36364","200","288","-88","Bruce Snyder"
"1990","California","7","4","1","0.625","325","341","-16","Bruce Snyder"
"1991","California","10","2","0","0.83333","443","239","204","Bruce Snyder"
"1992","California","4","7","0","0.36364","284","284","0","Keith Gilbertson"
"1993","California","9","4","0","0.69231","411","303","108","Keith Gilbertson"
"1994","California","4","7","0","0.36364","212","248","-36","Keith Gilbertson"
"1995","California","3","8","0","0.27273","243","286","-43","Keith Gilbertson"
"1996","California","6","6","0","0.5","382","407","-25","Steve Mariucci"
"1997","California","3","8","0","0.27273","295","339","-44","Tom Holmoe"
"1998","California","5","6","0","0.45455","183","251","-68","Tom Holmoe"
"1999","California","0","11","0","0","180","254","-74","Tom Holmoe"
"2000","California","3","8","0","0.27273","246","295","-49","Tom Holmoe"
"2001","California","1","10","0","0.09091","201","431","-230","Tom Holmoe"
"2002","California","7","5","0","0.58333","427","318","109","Jeff Tedford"
"2003","California","8","6","0","0.57143","457","341","116","Jeff Tedford"
"2004","California","10","2","0","0.83333","441","192","249","Jeff Tedford"
"2005","California","8","4","0","0.66667","395","254","141","Jeff Tedford"
"2006","California","10","3","0","0.76923","427","251","176","Jeff Tedford"
"2007","California","7","6","0","0.53846","381","348","33","Jeff Tedford"
"2008","California","9","4","0","0.69231","424","259","165","Jeff Tedford"
"2009","California","8","5","0","0.61538","378","331","47","Jeff Tedford"
"2010","California","5","7","0","0.41667","310","271","39","Jeff Tedford"
"2011","California","7","6","0","0.53846","368","314","54","Jeff Tedford"
"2012","California","3","9","0","0.25","276","397","-121","Jeff Tedford"
"2013","California","1","11","0","0.08333","276","551","-275","Sonny Dykes"
"2014","California","5","7","0","0.41667","459","477","-18","Sonny Dykes"
"1979","Central Florida","6","2","0","0.75","104","96","8","Don Jonas"
"1980","Central Florida","4","4","1","0.5","155","175","-20","Don Jonas"
"1981","Central Florida","4","6","0","0.4","142","130","12","Don Jonas"
"1982","Central Florida","0","10","0","0","109","356","-247","Sam Weir"
"1983","Central Florida","5","6","0","0.45455","283","306","-23","Louis Henry ""Lou"" Saban"
"1984","Central Florida","1","6","0","0.14286","154","270","-116","Louis Henry ""Lou"" Saban"
"1984","Central Florida","1","3","0","0.25","55","128","-73","Jerry Anderson"
"1985","Central Florida","4","7","0","0.36364","266","386","-120","Gene McDowell"
"1986","Central Florida","6","5","0","0.54545","310","227","83","Gene McDowell"
"1987","Central Florida","9","4","0","0.69231","401","210","191","Gene McDowell"
"1988","Central Florida","6","5","0","0.54545","267","288","-21","Gene McDowell"
"1989","Central Florida","7","3","0","0.7","256","168","88","Gene McDowell"
"1990","Central Florida","10","4","0","0.71429","444","280","164","Gene McDowell"
"1991","Central Florida","6","5","0","0.54545","278","230","48","Gene McDowell"
"1992","Central Florida","7","4","0","0.63636","416","249","167","Gene McDowell"
"1993","Central Florida","9","3","0","0.75","413","277","136","Gene McDowell"
"1994","Central Florida","7","4","0","0.63636","399","263","136","Gene McDowell"
"1995","Central Florida","6","5","0","0.54545","283","280","3","Gene McDowell"
"1996","Central Florida","5","6","0","0.45455","277","261","16","Gene McDowell"
"1997","Central Florida","5","6","0","0.45455","374","303","71","Gene McDowell"
"2003","Central Florida","0","2","0","0","28","77","-49","Alan Gooch"
"1998","Central Florida","9","2","0","0.81818","393","209","184","Mike Kruczek"
"1999","Central Florida","4","7","0","0.36364","277","318","-41","Mike Kruczek"
"2000","Central Florida","7","4","0","0.63636","333","221","112","Mike Kruczek"
"2001","Central Florida","6","5","0","0.54545","333","204","129","Mike Kruczek"
"2002","Central Florida","7","5","0","0.58333","391","315","76","Mike Kruczek"
"2003","Central Florida","3","7","0","0.3","196","296","-100","Mike Kruczek"
"2004","Central Florida","0","11","0","0","175","362","-187","George O'Leary"
"2005","Central Florida","8","5","0","0.61538","373","373","0","George O'Leary"
"2006","Central Florida","4","8","0","0.33333","232","345","-113","George O'Leary"
"2007","Central Florida","10","4","0","0.71429","502","372","130","George O'Leary"
"2008","Central Florida","4","8","0","0.33333","199","289","-90","George O'Leary"
"2009","Central Florida","8","5","0","0.61538","340","293","47","George O'Leary"
"2010","Central Florida","11","3","0","0.78571","449","240","209","George O'Leary"
"2011","Central Florida","5","7","0","0.41667","325","220","105","George O'Leary"
"2012","Central Florida","10","4","0","0.71429","496","309","187","George O'Leary"
"2013","Central Florida","12","1","0","0.92308","450","277","173","George O'Leary"
"2014","Central Florida","9","4","0","0.69231","365","249","116","George O'Leary"
"1896","Cincinnati (OH)","4","3","1","0.5625","88","68","20","William A. ""Billy"" Reynolds"
"1897","Cincinnati (OH)","9","1","1","0.86364","136","22","114","Thomas F. ""Tom"" Fennell"
"1898","Cincinnati (OH)","6","1","2","0.77778","141","28","113","Frank W. Cavanaugh"
"1899","Cincinnati (OH)","5","2","0","0.71429","81","60","21","Daniel A. ""Dan"" Reed"
"1900","Cincinnati (OH)","3","5","1","0.38889","51","166","-115","Daniel A. ""Dan"" Reed"
"1901","Cincinnati (OH)","1","4","1","0.25","10","63","-53","Henry Pratt"
"1902","Cincinnati (OH)","4","2","2","0.625","58","45","13","Anthony W. Chez"
"1903","Cincinnati (OH)","1","8","0","0.11111","39","141","-102","Anthony W. Chez"
"1904","Cincinnati (OH)","7","1","0","0.875","182","10","172","Amos P. Foster"
"1905","Cincinnati (OH)","5","3","0","0.625","92","91","1","Amos P. Foster"
"1906","Cincinnati (OH)","0","7","2","0.11111","5","162","-157","William Foley"
"1907","Cincinnati (OH)","0","2","0","0","5","39","-34","Coach Clancey"
"1908","Cincinnati (OH)","1","4","1","0.25","59","104","-45","Ralph Inott"
"1909","Cincinnati (OH)","4","3","1","0.5625","69","74","-5","Robert Burch"
"1910","Cincinnati (OH)","6","3","0","0.66667","122","59","63","Robert Burch"
"1911","Cincinnati (OH)","6","2","1","0.72222","79","34","45","Robert Burch"
"1912","Cincinnati (OH)","3","4","1","0.4375","251","145","106","Lowell Dana"
"1913","Cincinnati (OH)","5","3","1","0.61111","177","61","116","Lowell Dana"
"1914","Cincinnati (OH)","6","3","0","0.66667","164","44","120","George E. Little"
"1915","Cincinnati (OH)","4","5","0","0.44444","110","158","-48","George E. Little"
"1916","Cincinnati (OH)","0","8","1","0.05556","10","199","-189","Ion J. Cortright"
"1917","Cincinnati (OH)","0","6","0","0","0","189","-189","Frank Marty"
"1918","Cincinnati (OH)","3","0","2","0.8","45","13","32","Boyd B. Chambers"
"1919","Cincinnati (OH)","3","4","1","0.4375","73","102","-29","Boyd B. Chambers"
"1920","Cincinnati (OH)","4","5","0","0.44444","125","96","29","Boyd B. Chambers"
"1921","Cincinnati (OH)","3","6","0","0.33333","181","114","67","Boyd B. Chambers"
"1922","Cincinnati (OH)","1","7","1","0.16667","35","175","-140","George W. McLaren"
"1923","Cincinnati (OH)","6","3","0","0.66667","157","71","86","George W. McLaren"
"1924","Cincinnati (OH)","2","6","1","0.27778","54","164","-110","George W. McLaren"
"1925","Cincinnati (OH)","4","5","0","0.44444","65","122","-57","George W. McLaren"
"1926","Cincinnati (OH)","3","5","1","0.38889","96","152","-56","George W. McLaren"
"1927","Cincinnati (OH)","2","5","2","0.33333","81","105","-24","George Babcock"
"1928","Cincinnati (OH)","1","8","0","0.11111","32","241","-209","George Babcock"
"1929","Cincinnati (OH)","4","4","1","0.5","75","133","-58","George Babcock"
"1930","Cincinnati (OH)","5","4","0","0.55556","91","138","-47","George Babcock"
"1931","Cincinnati (OH)","5","4","0","0.55556","187","115","72","Dana M. King"
"1932","Cincinnati (OH)","7","2","0","0.77778","151","69","82","Dana M. King"
"1933","Cincinnati (OH)","7","2","0","0.77778","112","22","90","Dana M. King"
"1934","Cincinnati (OH)","6","2","1","0.72222","163","71","92","Dana M. King"
"1935","Cincinnati (OH)","7","2","0","0.77778","241","49","192","Russell T. ""Russ"" Cohen"
"1936","Cincinnati (OH)","1","5","3","0.27778","57","124","-67","Russell T. ""Russ"" Cohen"
"1937","Cincinnati (OH)","0","5","0","0","6","108","-102","Russell T. ""Russ"" Cohen"
"1937","Cincinnati (OH)","0","5","0","0","12","106","-94","Wade ""Red"" Woodworth"
"1938","Cincinnati (OH)","4","5","0","0.44444","81","128","-47","Joseph A. ""Joe"" Meyer"
"1939","Cincinnati (OH)","4","3","2","0.55556","87","65","22","Joseph A. ""Joe"" Meyer"
"1940","Cincinnati (OH)","5","3","1","0.61111","132","48","84","Joseph A. ""Joe"" Meyer"
"1941","Cincinnati (OH)","6","3","0","0.66667","194","45","149","Joseph A. ""Joe"" Meyer"
"1942","Cincinnati (OH)","8","2","0","0.8","197","95","102","Joseph A. ""Joe"" Meyer"
"1945","Cincinnati (OH)","4","4","0","0.5","132","88","44","Ray Nolting"
"1946","Cincinnati (OH)","9","2","0","0.81818","221","93","128","Ray Nolting"
"1947","Cincinnati (OH)","7","3","0","0.7","182","168","14","Ray Nolting"
"1948","Cincinnati (OH)","3","6","1","0.35","106","193","-87","Ray Nolting"
"1949","Cincinnati (OH)","7","4","0","0.63636","237","181","56","Sid Gillman"
"1950","Cincinnati (OH)","8","4","0","0.66667","258","169","89","Sid Gillman"
"1951","Cincinnati (OH)","10","1","0","0.90909","345","112","233","Sid Gillman"
"1952","Cincinnati (OH)","8","1","1","0.85","275","72","203","Sid Gillman"
"1953","Cincinnati (OH)","9","1","0","0.9","354","58","296","Sid Gillman"
"1954","Cincinnati (OH)","8","2","0","0.8","249","107","142","Sid Gillman"
"1955","Cincinnati (OH)","1","6","2","0.22222","97","199","-102","George ""Blackie"" Blackburn"
"1956","Cincinnati (OH)","4","5","0","0.44444","156","140","16","George ""Blackie"" Blackburn"
"1957","Cincinnati (OH)","5","4","1","0.55","130","101","29","George ""Blackie"" Blackburn"
"1958","Cincinnati (OH)","6","2","2","0.7","139","104","35","George ""Blackie"" Blackburn"
"1959","Cincinnati (OH)","5","4","1","0.55","193","148","45","George ""Blackie"" Blackburn"
"1960","Cincinnati (OH)","4","6","0","0.4","113","150","-37","George ""Blackie"" Blackburn"
"1961","Cincinnati (OH)","3","7","0","0.3","97","142","-45","Charles ""Chuck"" Studley"
"1962","Cincinnati (OH)","2","8","0","0.2","142","202","-60","Charles ""Chuck"" Studley"
"1963","Cincinnati (OH)","6","4","0","0.6","238","138","100","Charles ""Chuck"" Studley"
"1964","Cincinnati (OH)","8","2","0","0.8","211","99","112","Charles ""Chuck"" Studley"
"1965","Cincinnati (OH)","5","5","0","0.5","163","172","-9","Charles ""Chuck"" Studley"
"1966","Cincinnati (OH)","3","7","0","0.3","141","201","-60","Charles ""Chuck"" Studley"
"1967","Cincinnati (OH)","3","6","0","0.33333","111","189","-78","Homer Rice"
"1968","Cincinnati (OH)","5","4","1","0.55","300","327","-27","Homer Rice"
"1969","Cincinnati (OH)","4","6","0","0.4","192","329","-137","Ray Callahan"
"1970","Cincinnati (OH)","7","4","0","0.63636","229","108","121","Ray Callahan"
"1971","Cincinnati (OH)","7","4","0","0.63636","225","188","37","Ray Callahan"
"1972","Cincinnati (OH)","2","9","0","0.18182","138","323","-185","Ray Callahan"
"1973","Cincinnati (OH)","4","7","0","0.36364","210","109","101","Tony Mason"
"1974","Cincinnati (OH)","7","4","0","0.63636","227","175","52","Tony Mason"
"1975","Cincinnati (OH)","6","5","0","0.54545","209","182","27","Tony Mason"
"1976","Cincinnati (OH)","9","2","0","0.81818","204","114","90","Tony Mason"
"1977","Cincinnati (OH)","5","4","2","0.54545","250","121","129","Ralph Staub"
"1978","Cincinnati (OH)","5","6","0","0.45455","279","224","55","Ralph Staub"
"1979","Cincinnati (OH)","2","9","0","0.18182","156","281","-125","Ralph Staub"
"1980","Cincinnati (OH)","2","9","0","0.18182","122","271","-149","Ralph Staub"
"1981","Cincinnati (OH)","6","5","0","0.54545","171","187","-16","Mike Gottfried"
"1982","Cincinnati (OH)","6","5","0","0.54545","276","206","70","Mike Gottfried"
"1983","Cincinnati (OH)","4","6","1","0.40909","208","234","-26","Watson Brown"
"1984","Cincinnati (OH)","2","9","0","0.18182","198","424","-226","Dave Currey"
"1985","Cincinnati (OH)","5","6","0","0.45455","199","261","-62","Dave Currey"
"1986","Cincinnati (OH)","5","6","0","0.45455","267","345","-78","Dave Currey"
"1987","Cincinnati (OH)","4","7","0","0.36364","234","314","-80","Dave Currey"
"1988","Cincinnati (OH)","3","8","0","0.27273","201","379","-178","Dave Currey"
"1989","Cincinnati (OH)","1","9","1","0.13636","111","379","-268","Timothy ""Tim"" Murphy"
"1990","Cincinnati (OH)","1","10","0","0.09091","172","460","-288","Timothy ""Tim"" Murphy"
"1991","Cincinnati (OH)","4","7","0","0.36364","201","323","-122","Timothy ""Tim"" Murphy"
"1992","Cincinnati (OH)","3","8","0","0.27273","199","276","-77","Timothy ""Tim"" Murphy"
"1993","Cincinnati (OH)","8","3","0","0.72727","302","197","105","Timothy ""Tim"" Murphy"
"1994","Cincinnati (OH)","2","8","1","0.22727","159","301","-142","Rick Minter"
"1995","Cincinnati (OH)","6","5","0","0.54545","252","197","55","Rick Minter"
"1996","Cincinnati (OH)","6","5","0","0.54545","228","212","16","Rick Minter"
"1997","Cincinnati (OH)","8","4","0","0.66667","321","252","69","Rick Minter"
"1998","Cincinnati (OH)","2","9","0","0.18182","259","456","-197","Rick Minter"
"1999","Cincinnati (OH)","3","8","0","0.27273","275","289","-14","Rick Minter"
"2000","Cincinnati (OH)","7","5","0","0.58333","289","285","4","Rick Minter"
"2001","Cincinnati (OH)","7","5","0","0.58333","336","290","46","Rick Minter"
"2002","Cincinnati (OH)","7","7","0","0.5","409","329","80","Rick Minter"
"2003","Cincinnati (OH)","5","7","0","0.41667","303","319","-16","Rick Minter"
"2004","Cincinnati (OH)","7","5","0","0.58333","344","320","24","Mark Dantonio"
"2005","Cincinnati (OH)","4","7","0","0.36364","192","345","-153","Mark Dantonio"
"2006","Cincinnati (OH)","7","5","0","0.58333","247","231","16","Mark Dantonio"
"2007","Cincinnati (OH)","10","3","0","0.76923","472","244","228","Brian Kelly"
"2008","Cincinnati (OH)","11","3","0","0.78571","362","282","80","Brian Kelly"
"2009","Cincinnati (OH)","12","0","0","1","478","249","229","Brian Kelly"
"2009","Cincinnati (OH)","0","1","0","0","24","51","-27","Jeff Quinn"
"2010","Cincinnati (OH)","4","8","0","0.33333","325","336","-11","Butch Jones"
"2011","Cincinnati (OH)","10","3","0","0.76923","433","264","169","Butch Jones"
"2012","Cincinnati (OH)","9","3","0","0.75","372","206","166","Butch Jones"
"2012","Cincinnati (OH)","1","0","0","1","48","34","14","Steve Stripling"
"2013","Cincinnati (OH)","9","4","0","0.69231","417","273","144","Tommy Tuberville"
"2014","Cincinnati (OH)","9","4","0","0.69231","442","354","88","Tommy Tuberville"
"1896","Clemson (SC)","2","1","0","0.66667","36","18","18","Walter M. Riggs"
"1899","Clemson (SC)","4","2","0","0.66667","95","50","45","Walter M. Riggs"
"1897","Clemson (SC)","2","2","0","0.5","30","58","-28","William M. Williams"
"1898","Clemson (SC)","3","1","0","0.75","110","20","90","John A. Penton"
"1900","Clemson (SC)","6","0","0","1","222","10","212","John W. Heisman"
"1901","Clemson (SC)","3","1","1","0.7","190","38","152","John W. Heisman"
"1902","Clemson (SC)","6","1","0","0.85714","152","22","130","John W. Heisman"
"1903","Clemson (SC)","4","1","1","0.75","167","22","145","John W. Heisman"
"1904","Clemson (SC)","3","3","1","0.5","50","45","5","Shack Shealy"
"1905","Clemson (SC)","3","2","1","0.58333","81","63","18","Edward B. ""Eddie"" Cochems"
"1907","Clemson (SC)","4","4","0","0.5","67","45","22","Frank J. Shaughnessy"
"1908","Clemson (SC)","1","6","0","0.14286","26","104","-78","John N. Stone"
"1910","Clemson (SC)","4","3","1","0.5625","106","54","52","Frank M. Dobson"
"1911","Clemson (SC)","3","5","0","0.375","70","109","-39","Frank M. Dobson"
"1912","Clemson (SC)","4","4","0","0.5","177","126","51","Frank M. Dobson"
"1916","Clemson (SC)","3","6","0","0.33333","81","147","-66","Wayne Hart"
"1917","Clemson (SC)","6","2","0","0.75","183","64","119","Edward A. Donahue"
"1918","Clemson (SC)","5","2","0","0.71429","198","101","97","Edward A. Donahue"
"1919","Clemson (SC)","6","2","2","0.7","152","55","97","Edward A. Donahue"
"1920","Clemson (SC)","4","6","1","0.40909","98","146","-48","Edward A. Donahue"
"1921","Clemson (SC)","1","6","2","0.22222","48","187","-139","Edward J. ""Doc"" Stewart"
"1922","Clemson (SC)","5","4","0","0.55556","170","109","61","Edward J. ""Doc"" Stewart"
"1923","Clemson (SC)","5","2","1","0.6875","91","65","26","Bud Saunders"
"1924","Clemson (SC)","2","6","0","0.25","80","96","-16","Bud Saunders"
"1925","Clemson (SC)","1","7","0","0.125","27","160","-133","Bud Saunders"
"1926","Clemson (SC)","2","2","0","0.5","14","64","-50","Bud Saunders"
"1906","Clemson (SC)","4","0","3","0.78571","38","4","34","Charles Robert ""Bob"" Williams"
"1909","Clemson (SC)","6","3","0","0.66667","93","43","50","Charles Robert ""Bob"" Williams"
"1913","Clemson (SC)","4","4","0","0.5","112","98","14","Charles Robert ""Bob"" Williams"
"1914","Clemson (SC)","6","3","1","0.65","197","123","74","Charles Robert ""Bob"" Williams"
"1915","Clemson (SC)","2","4","2","0.375","113","48","65","Charles Robert ""Bob"" Williams"
"1926","Clemson (SC)","0","5","0","0","6","105","-99","Charles Robert ""Bob"" Williams"
"1927","Clemson (SC)","5","3","1","0.61111","74","84","-10","Josh C. Cody"
"1928","Clemson (SC)","8","3","0","0.72727","192","77","115","Josh C. Cody"
"1929","Clemson (SC)","8","3","0","0.72727","236","110","126","Josh C. Cody"
"1930","Clemson (SC)","8","2","0","0.8","239","82","157","Josh C. Cody"
"1931","Clemson (SC)","1","6","2","0.22222","19","164","-145","Jess C. Neely"
"1932","Clemson (SC)","3","5","1","0.38889","89","111","-22","Jess C. Neely"
"1933","Clemson (SC)","3","6","2","0.36364","50","98","-48","Jess C. Neely"
"1934","Clemson (SC)","5","4","0","0.55556","89","85","4","Jess C. Neely"
"1935","Clemson (SC)","6","3","0","0.66667","147","99","48","Jess C. Neely"
"1936","Clemson (SC)","5","5","0","0.5","98","95","3","Jess C. Neely"
"1937","Clemson (SC)","4","4","1","0.5","128","64","64","Jess C. Neely"
"1938","Clemson (SC)","7","1","1","0.83333","145","56","89","Jess C. Neely"
"1939","Clemson (SC)","9","1","0","0.9","165","45","120","Jess C. Neely"
"1940","Clemson (SC)","6","2","1","0.72222","182","73","109","Frank Howard"
"1941","Clemson (SC)","7","2","0","0.77778","233","90","143","Frank Howard"
"1942","Clemson (SC)","3","6","1","0.35","100","138","-38","Frank Howard"
"1943","Clemson (SC)","2","6","0","0.25","94","185","-91","Frank Howard"
"1944","Clemson (SC)","4","5","0","0.44444","165","179","-14","Frank Howard"
"1945","Clemson (SC)","6","3","1","0.65","211","73","138","Frank Howard"
"1946","Clemson (SC)","4","5","0","0.44444","147","174","-27","Frank Howard"
"1947","Clemson (SC)","4","5","0","0.44444","206","146","60","Frank Howard"
"1948","Clemson (SC)","11","0","0","1","274","76","198","Frank Howard"
"1949","Clemson (SC)","4","4","2","0.5","232","216","16","Frank Howard"
"1950","Clemson (SC)","9","0","1","0.95","344","76","268","Frank Howard"
"1951","Clemson (SC)","7","3","0","0.7","196","97","99","Frank Howard"
"1952","Clemson (SC)","2","6","1","0.27778","112","157","-45","Frank Howard"
"1953","Clemson (SC)","3","5","1","0.38889","139","172","-33","Frank Howard"
"1954","Clemson (SC)","5","5","0","0.5","193","121","72","Frank Howard"
"1955","Clemson (SC)","7","3","0","0.7","206","144","62","Frank Howard"
"1956","Clemson (SC)","7","2","2","0.72727","167","101","66","Frank Howard"
"1957","Clemson (SC)","7","3","0","0.7","216","78","138","Frank Howard"
"1958","Clemson (SC)","8","3","0","0.72727","169","138","31","Frank Howard"
"1959","Clemson (SC)","9","2","0","0.81818","285","103","182","Frank Howard"
"1960","Clemson (SC)","6","4","0","0.6","197","124","73","Frank Howard"
"1961","Clemson (SC)","5","5","0","0.5","199","126","73","Frank Howard"
"1962","Clemson (SC)","6","4","0","0.6","168","130","38","Frank Howard"
"1963","Clemson (SC)","5","4","1","0.55","181","140","41","Frank Howard"
"1964","Clemson (SC)","3","7","0","0.3","105","135","-30","Frank Howard"
"1965","Clemson (SC)","5","5","0","0.5","117","137","-20","Frank Howard"
"1966","Clemson (SC)","6","4","0","0.6","174","177","-3","Frank Howard"
"1967","Clemson (SC)","6","4","0","0.6","166","128","38","Frank Howard"
"1968","Clemson (SC)","4","5","1","0.45","184","179","5","Frank Howard"
"1969","Clemson (SC)","4","6","0","0.4","178","250","-72","Frank Howard"
"1970","Clemson (SC)","3","8","0","0.27273","164","313","-149","Hootie Ingram"
"1971","Clemson (SC)","5","6","0","0.45455","155","202","-47","Hootie Ingram"
"1972","Clemson (SC)","4","7","0","0.36364","143","245","-102","Hootie Ingram"
"1973","Clemson (SC)","5","6","0","0.45455","231","263","-32","Jimmy ""Red"" Parker"
"1974","Clemson (SC)","7","4","0","0.63636","246","250","-4","Jimmy ""Red"" Parker"
"1975","Clemson (SC)","2","9","0","0.18182","177","381","-204","Jimmy ""Red"" Parker"
"1976","Clemson (SC)","3","6","2","0.36364","172","237","-65","Jimmy ""Red"" Parker"
"1977","Clemson (SC)","8","3","1","0.70833","228","163","65","Charley Pell"
"1978","Clemson (SC)","10","1","0","0.90909","351","116","235","Charley Pell"
"1978","Clemson (SC)","1","0","0","1","17","15","2","Danny Ford"
"1979","Clemson (SC)","8","4","0","0.66667","205","116","89","Danny Ford"
"1980","Clemson (SC)","6","5","0","0.54545","217","222","-5","Danny Ford"
"1981","Clemson (SC)","12","0","0","1","338","105","233","Danny Ford"
"1982","Clemson (SC)","9","1","1","0.86364","289","147","142","Danny Ford"
"1983","Clemson (SC)","9","1","1","0.86364","338","200","138","Danny Ford"
"1984","Clemson (SC)","7","4","0","0.63636","346","215","131","Danny Ford"
"1985","Clemson (SC)","6","6","0","0.5","244","222","22","Danny Ford"
"1986","Clemson (SC)","8","2","2","0.75","296","187","109","Danny Ford"
"1987","Clemson (SC)","10","2","0","0.83333","333","176","157","Danny Ford"
"1988","Clemson (SC)","10","2","0","0.83333","342","157","185","Danny Ford"
"1989","Clemson (SC)","10","2","0","0.83333","368","138","230","Danny Ford"
"1990","Clemson (SC)","10","2","0","0.83333","333","109","224","Ken Hatfield"
"1991","Clemson (SC)","9","2","1","0.79167","317","185","132","Ken Hatfield"
"1992","Clemson (SC)","5","6","0","0.45455","261","213","48","Ken Hatfield"
"1993","Clemson (SC)","8","3","0","0.72727","184","179","5","Ken Hatfield"
"1993","Clemson (SC)","5","7","0","0.41667","264","389","-125","Tommy West"
"1994","Clemson (SC)","5","6","0","0.45455","164","188","-24","Tommy West"
"1995","Clemson (SC)","8","4","0","0.66667","303","219","84","Tommy West"
"1996","Clemson (SC)","7","5","0","0.58333","245","241","4","Tommy West"
"1997","Clemson (SC)","7","5","0","0.58333","292","219","73","Tommy West"
"1998","Clemson (SC)","3","8","0","0.27273","218","272","-54","Tommy West"
"1999","Clemson (SC)","6","6","0","0.5","322","253","69","Tommy Bowden"
"2000","Clemson (SC)","9","3","0","0.75","416","253","163","Tommy Bowden"
"2001","Clemson (SC)","7","5","0","0.58333","369","339","30","Tommy Bowden"
"2002","Clemson (SC)","7","6","0","0.53846","330","349","-19","Tommy Bowden"
"2003","Clemson (SC)","9","4","0","0.69231","365","250","115","Tommy Bowden"
"2004","Clemson (SC)","6","5","0","0.54545","236","229","7","Tommy Bowden"
"2005","Clemson (SC)","8","4","0","0.66667","316","211","105","Tommy Bowden"
"2006","Clemson (SC)","8","5","0","0.61538","425","210","215","Tommy Bowden"
"2007","Clemson (SC)","9","4","0","0.69231","430","243","187","Tommy Bowden"
"2008","Clemson (SC)","3","3","0","0.5","160","92","68","Tommy Bowden"
"2008","Clemson (SC)","4","3","0","0.57143","167","133","34","Dabo Swinney"
"2009","Clemson (SC)","9","5","0","0.64286","436","286","150","Dabo Swinney"
"2010","Clemson (SC)","6","7","0","0.46154","312","244","68","Dabo Swinney"
"2011","Clemson (SC)","10","4","0","0.71429","470","410","60","Dabo Swinney"
"2012","Clemson (SC)","11","2","0","0.84615","533","323","210","Dabo Swinney"
"2013","Clemson (SC)","11","2","0","0.84615","522","288","234","Dabo Swinney"
"2014","Clemson (SC)","10","3","0","0.76923","401","217","184","Dabo Swinney"
"1894","Colorado","8","1","0","0.88889","286","48","238","Harry Heller"
"1900","Colorado","6","4","0","0.6","150","78","72","Theron W. Mortimer"
"1903","Colorado","8","2","0","0.8","197","54","143","Dave Cropp"
"1904","Colorado","6","2","1","0.72222","187","58","129","Dave Cropp"
"1905","Colorado","8","1","0","0.88889","359","28","331","William S. ""Willis"" Keinholz"
"1906","Colorado","2","3","4","0.44444","28","32","-4","Frank R. Castleman"
"1907","Colorado","5","3","0","0.625","127","64","63","Frank R. Castleman"
"1895","Colorado","4","1","0","0.8","122","32","90","Fred G. Folsom"
"1896","Colorado","5","0","0","1","171","6","165","Fred G. Folsom"
"1897","Colorado","7","1","0","0.875","188","10","178","Fred G. Folsom"
"1898","Colorado","4","4","0","0.5","150","73","77","Fred G. Folsom"
"1899","Colorado","7","2","0","0.77778","210","34","176","Fred G. Folsom"
"1901","Colorado","5","2","1","0.6875","56","32","24","Fred G. Folsom"
"1902","Colorado","5","1","0","0.83333","87","22","65","Fred G. Folsom"
"1908","Colorado","5","2","0","0.71429","96","35","61","Fred G. Folsom"
"1909","Colorado","6","0","0","1","141","0","141","Fred G. Folsom"
"1910","Colorado","6","0","0","1","119","3","116","Fred G. Folsom"
"1911","Colorado","6","0","0","1","88","5","83","Fred G. Folsom"
"1912","Colorado","6","3","0","0.66667","147","81","66","Fred G. Folsom"
"1913","Colorado","5","1","1","0.78571","82","33","49","Fred G. Folsom"
"1914","Colorado","5","1","0","0.83333","111","22","89","Fred G. Folsom"
"1915","Colorado","1","6","0","0.14286","45","168","-123","Fred G. Folsom"
"1916","Colorado","1","5","1","0.21429","40","162","-122","Melbourne ""Bob"" Evans"
"1917","Colorado","6","2","0","0.75","114","56","58","Melbourne ""Bob"" Evans"
"1918","Colorado","2","3","0","0.4","43","42","1","Enoch Josiah ""Joe"" Mills"
"1919","Colorado","2","3","1","0.41667","87","96","-9","Enoch Josiah ""Joe"" Mills"
"1920","Colorado","4","1","2","0.71429","99","28","71","Myron E. Witham"
"1921","Colorado","4","1","1","0.75","65","63","2","Myron E. Witham"
"1922","Colorado","4","4","0","0.5","49","73","-24","Myron E. Witham"
"1923","Colorado","9","0","0","1","280","27","253","Myron E. Witham"
"1924","Colorado","8","1","1","0.85","237","13","224","Myron E. Witham"
"1925","Colorado","6","3","0","0.66667","156","45","111","Myron E. Witham"
"1926","Colorado","3","5","1","0.38889","77","103","-26","Myron E. Witham"
"1927","Colorado","4","5","0","0.44444","136","195","-59","Myron E. Witham"
"1928","Colorado","5","1","0","0.83333","110","57","53","Myron E. Witham"
"1929","Colorado","5","1","1","0.78571","78","69","9","Myron E. Witham"
"1930","Colorado","6","1","1","0.8125","120","68","52","Myron E. Witham"
"1931","Colorado","5","3","0","0.625","111","94","17","Myron E. Witham"
"1932","Colorado","2","4","0","0.33333","63","46","17","William H. ""Navy Bill"" Saunders"
"1933","Colorado","7","2","0","0.77778","183","51","132","William H. ""Navy Bill"" Saunders"
"1934","Colorado","6","1","2","0.77778","167","40","127","William H. ""Navy Bill"" Saunders"
"1935","Colorado","5","4","0","0.55556","140","47","93","Bernard F. ""Bunny"" Oakes"
"1936","Colorado","4","3","0","0.57143","99","43","56","Bernard F. ""Bunny"" Oakes"
"1937","Colorado","8","1","0","0.88889","262","54","208","Bernard F. ""Bunny"" Oakes"
"1938","Colorado","3","4","1","0.4375","78","78","0","Bernard F. ""Bunny"" Oakes"
"1939","Colorado","5","3","0","0.625","106","110","-4","Bernard F. ""Bunny"" Oakes"
"1940","Colorado","5","3","1","0.61111","182","106","76","Frank C. Potts"
"1944","Colorado","6","2","0","0.75","201","72","129","Frank C. Potts"
"1945","Colorado","5","3","0","0.625","111","58","53","Frank C. Potts"
"1941","Colorado","3","4","1","0.4375","97","161","-64","James J. ""Jim"" Yeager"
"1942","Colorado","7","2","0","0.77778","251","73","178","James J. ""Jim"" Yeager"
"1943","Colorado","5","2","0","0.71429","134","47","87","James J. ""Jim"" Yeager"
"1946","Colorado","5","4","1","0.55","91","147","-56","James J. ""Jim"" Yeager"
"1947","Colorado","4","5","0","0.44444","90","162","-72","James J. ""Jim"" Yeager"
"1948","Colorado","3","6","0","0.33333","168","164","4","Dallas ""Dal"" Ward"
"1949","Colorado","3","7","0","0.3","129","184","-55","Dallas ""Dal"" Ward"
"1950","Colorado","5","4","1","0.55","227","172","55","Dallas ""Dal"" Ward"
"1951","Colorado","7","3","0","0.7","289","229","60","Dallas ""Dal"" Ward"
"1952","Colorado","6","2","2","0.7","246","158","88","Dallas ""Dal"" Ward"
"1953","Colorado","6","4","0","0.6","201","194","7","Dallas ""Dal"" Ward"
"1954","Colorado","7","2","1","0.75","283","91","192","Dallas ""Dal"" Ward"
"1955","Colorado","6","4","0","0.6","203","149","54","Dallas ""Dal"" Ward"
"1956","Colorado","8","2","1","0.77273","294","143","151","Dallas ""Dal"" Ward"
"1957","Colorado","6","3","1","0.65","250","137","113","Dallas ""Dal"" Ward"
"1958","Colorado","6","4","0","0.6","207","122","85","Dallas ""Dal"" Ward"
"1959","Colorado","5","5","0","0.5","144","177","-33","Everett ""Sonny"" Grandelius"
"1960","Colorado","7","3","0","0.7","140","133","7","Everett ""Sonny"" Grandelius"
"1961","Colorado","9","2","0","0.81818","184","104","80","Everett ""Sonny"" Grandelius"
"1962","Colorado","2","8","0","0.2","122","346","-224","William Eugene ""Bud"" Davis"
"1963","Colorado","2","8","0","0.2","100","245","-145","Eddie Crowder"
"1964","Colorado","2","8","0","0.2","101","156","-55","Eddie Crowder"
"1965","Colorado","6","2","2","0.7","163","106","57","Eddie Crowder"
"1966","Colorado","7","3","0","0.7","191","132","59","Eddie Crowder"
"1967","Colorado","9","2","0","0.81818","245","113","132","Eddie Crowder"
"1968","Colorado","4","6","0","0.4","220","244","-24","Eddie Crowder"
"1969","Colorado","8","3","0","0.72727","276","227","49","Eddie Crowder"
"1970","Colorado","6","5","0","0.54545","309","206","103","Eddie Crowder"
"1971","Colorado","10","2","0","0.83333","370","220","150","Eddie Crowder"
"1972","Colorado","8","4","0","0.66667","313","206","107","Eddie Crowder"
"1973","Colorado","5","6","0","0.45455","240","250","-10","Eddie Crowder"
"1974","Colorado","5","6","0","0.45455","226","307","-81","Bill Mallory"
"1975","Colorado","9","3","0","0.75","331","251","80","Bill Mallory"
"1976","Colorado","8","4","0","0.66667","305","225","80","Bill Mallory"
"1977","Colorado","7","3","1","0.68182","266","174","92","Bill Mallory"
"1978","Colorado","6","5","0","0.54545","230","206","24","Bill Mallory"
"1979","Colorado","3","8","0","0.27273","168","274","-106","Chuck Fairbanks"
"1980","Colorado","1","10","0","0.09091","160","451","-291","Chuck Fairbanks"
"1981","Colorado","3","8","0","0.27273","141","322","-181","Chuck Fairbanks"
"1982","Colorado","2","8","1","0.22727","160","301","-141","Bill McCartney"
"1983","Colorado","4","7","0","0.36364","252","342","-90","Bill McCartney"
"1984","Colorado","1","10","0","0.09091","172","364","-192","Bill McCartney"
"1985","Colorado","7","5","0","0.58333","228","174","54","Bill McCartney"
"1986","Colorado","6","6","0","0.5","242","193","49","Bill McCartney"
"1987","Colorado","7","4","0","0.63636","268","180","88","Bill McCartney"
"1988","Colorado","8","4","0","0.66667","322","196","126","Bill McCartney"
"1989","Colorado","11","1","0","0.91667","458","171","287","Bill McCartney"
"1990","Colorado","11","1","1","0.88462","399","229","170","Bill McCartney"
"1991","Colorado","8","3","1","0.70833","329","180","149","Bill McCartney"
"1992","Colorado","9","2","1","0.79167","340","224","116","Bill McCartney"
"1993","Colorado","8","3","1","0.70833","368","250","118","Bill McCartney"
"1994","Colorado","11","1","0","0.91667","439","235","204","Bill McCartney"
"1995","Colorado","10","2","0","0.83333","444","240","204","Rick Neuheisel"
"1996","Colorado","10","2","0","0.83333","352","220","132","Rick Neuheisel"
"1997","Colorado","5","6","0","0.45455","300","295","5","Rick Neuheisel"
"1998","Colorado","8","4","0","0.66667","302","253","49","Rick Neuheisel"
"1999","Colorado","7","5","0","0.58333","405","311","94","Gary Barnett"
"2000","Colorado","3","8","0","0.27273","252","284","-32","Gary Barnett"
"2001","Colorado","10","3","0","0.76923","412","318","94","Gary Barnett"
"2002","Colorado","9","5","0","0.64286","398","325","73","Gary Barnett"
"2003","Colorado","5","7","0","0.41667","319","398","-79","Gary Barnett"
"2004","Colorado","8","5","0","0.61538","304","332","-28","Gary Barnett"
"2005","Colorado","7","5","0","0.58333","295","288","7","Gary Barnett"
"2005","Colorado","0","1","0","0","10","19","-9","Mike Hankwitz"
"2006","Colorado","2","10","0","0.16667","196","267","-71","Dan Hawkins"
"2007","Colorado","6","7","0","0.46154","355","383","-28","Dan Hawkins"
"2008","Colorado","5","7","0","0.41667","242","351","-109","Dan Hawkins"
"2009","Colorado","3","9","0","0.25","267","346","-79","Dan Hawkins"
"2010","Colorado","3","6","0","0.33333","195","274","-79","Dan Hawkins"
"2010","Colorado","2","1","0","0.66667","95","95","0","Brian Cabral"
"2011","Colorado","3","10","0","0.23077","257","475","-218","Jon Embree"
"2012","Colorado","1","11","0","0.08333","214","552","-338","Jon Embree"
"2013","Colorado","4","8","0","0.33333","305","459","-154","Mike MacIntyre"
"2014","Colorado","2","10","0","0.16667","342","468","-126","Mike MacIntyre"
"1899","Colorado St.","1","2","1","0.375","22","117","-95","W.J. Forbes"
"1900","Colorado St.","1","4","0","0.2","16","110","-94","George E. Toomey"
"1901","Colorado St.","1","0","0","1","1","0","1","George E. Toomey"
"1901","Colorado St.","1","2","0","0.33333","56","32","24","Clarence J. Griffith"
"1902","Colorado St.","1","3","2","0.33333","47","62","-15","Clarence J. Griffith"
"1903","Colorado St.","5","1","0","0.83333","67","24","43","Matt Rothwell"
"1904","Colorado St.","0","4","1","0.1","6","125","-119","John H. McIntosh"
"1905","Colorado St.","3","4","0","0.42857","67","95","-28","John H. McIntosh"
"1906","Colorado St.","1","2","1","0.375","4","21","-17","Claude J. Rothgeb"
"1907","Colorado St.","0","4","0","0","17","77","-60","Claude J. Rothgeb"
"1908","Colorado St.","1","3","0","0.25","30","58","-28","Claude J. Rothgeb"
"1909","Colorado St.","1","2","0","0.33333","32","91","-59","Claude J. Rothgeb"
"1910","Colorado St.","0","5","0","0","6","110","-104","George Cassidy"
"1911","Colorado St.","1","6","0","0.14286","75","216","-141","Harry W. Hughes"
"1912","Colorado St.","3","2","0","0.6","68","40","28","Harry W. Hughes"
"1913","Colorado St.","3","2","0","0.6","115","43","72","Harry W. Hughes"
"1914","Colorado St.","3","5","0","0.375","127","109","18","Harry W. Hughes"
"1915","Colorado St.","7","0","0","1","243","31","212","Harry W. Hughes"
"1916","Colorado St.","6","0","1","0.92857","172","45","127","Harry W. Hughes"
"1917","Colorado St.","1","7","1","0.16667","71","155","-84","Harry W. Hughes"
"1918","Colorado St.","1","2","0","0.33333","20","30","-10","Harry W. Hughes"
"1919","Colorado St.","7","1","0","0.875","218","57","161","Harry W. Hughes"
"1920","Colorado St.","6","1","1","0.8125","152","14","138","Harry W. Hughes"
"1921","Colorado St.","2","3","1","0.41667","76","108","-32","Harry W. Hughes"
"1922","Colorado St.","5","2","1","0.6875","179","38","141","Harry W. Hughes"
"1923","Colorado St.","5","2","1","0.6875","121","35","86","Harry W. Hughes"
"1924","Colorado St.","4","2","0","0.66667","81","63","18","Harry W. Hughes"
"1925","Colorado St.","9","1","0","0.9","228","79","149","Harry W. Hughes"
"1926","Colorado St.","6","2","1","0.72222","149","44","105","Harry W. Hughes"
"1927","Colorado St.","7","1","0","0.875","176","26","150","Harry W. Hughes"
"1928","Colorado St.","6","2","0","0.75","151","70","81","Harry W. Hughes"
"1929","Colorado St.","5","4","0","0.55556","118","87","31","Harry W. Hughes"
"1930","Colorado St.","3","5","1","0.38889","67","104","-37","Harry W. Hughes"
"1931","Colorado St.","5","4","0","0.55556","137","138","-1","Harry W. Hughes"
"1932","Colorado St.","4","3","1","0.5625","100","45","55","Harry W. Hughes"
"1933","Colorado St.","5","1","1","0.78571","78","26","52","Harry W. Hughes"
"1934","Colorado St.","6","2","1","0.72222","173","67","106","Harry W. Hughes"
"1935","Colorado St.","3","4","1","0.4375","58","75","-17","Harry W. Hughes"
"1936","Colorado St.","4","4","1","0.5","67","74","-7","Harry W. Hughes"
"1937","Colorado St.","1","7","0","0.125","6","182","-176","Harry W. Hughes"
"1938","Colorado St.","1","5","2","0.25","37","103","-66","Harry W. Hughes"
"1939","Colorado St.","2","7","0","0.22222","89","128","-39","Harry W. Hughes"
"1940","Colorado St.","3","4","2","0.44444","85","131","-46","Harry W. Hughes"
"1941","Colorado St.","4","2","1","0.64286","109","77","32","Harry W. Hughes"
"1946","Colorado St.","0","4","0","0","18","76","-58","Harry W. Hughes"
"1942","Colorado St.","4","3","0","0.57143","97","99","-2","Julius F. ""Wag"" Wagner"
"1945","Colorado St.","2","5","1","0.3125","89","179","-90","Julius F. ""Wag"" Wagner"
"1946","Colorado St.","2","3","0","0.4","32","107","-75","Julius F. ""Wag"" Wagner"
"1947","Colorado St.","5","4","1","0.55","159","182","-23","Robert L. ""Bob"" Davis"
"1948","Colorado St.","8","3","0","0.72727","244","138","106","Robert L. ""Bob"" Davis"
"1949","Colorado St.","9","1","0","0.9","206","86","120","Robert L. ""Bob"" Davis"
"1950","Colorado St.","6","3","0","0.66667","215","141","74","Robert L. ""Bob"" Davis"
"1951","Colorado St.","5","4","1","0.55","242","158","84","Robert L. ""Bob"" Davis"
"1952","Colorado St.","6","4","0","0.6","177","137","40","Robert L. ""Bob"" Davis"
"1953","Colorado St.","4","5","0","0.44444","157","149","8","Robert L. ""Bob"" Davis"
"1954","Colorado St.","3","7","0","0.3","93","248","-155","Robert L. ""Bob"" Davis"
"1955","Colorado St.","8","2","0","0.8","175","108","67","Robert L. ""Bob"" Davis"
"1956","Colorado St.","2","7","1","0.25","156","314","-158","Don Mullison"
"1957","Colorado St.","3","7","0","0.3","109","224","-115","Don Mullison"
"1958","Colorado St.","6","4","0","0.6","178","110","68","Don Mullison"
"1959","Colorado St.","6","4","0","0.6","123","147","-24","Don Mullison"
"1960","Colorado St.","2","8","0","0.2","92","240","-148","Don Mullison"
"1961","Colorado St.","0","10","0","0","74","249","-175","Don Mullison"
"1962","Colorado St.","0","10","0","0","66","269","-203","Mike Lude"
"1963","Colorado St.","3","7","0","0.3","118","299","-181","Mike Lude"
"1964","Colorado St.","5","6","0","0.45455","111","199","-88","Mike Lude"
"1965","Colorado St.","4","6","0","0.4","264","264","0","Mike Lude"
"1966","Colorado St.","7","3","0","0.7","275","178","97","Mike Lude"
"1967","Colorado St.","4","5","1","0.45","229","149","80","Mike Lude"
"1968","Colorado St.","2","8","0","0.2","133","262","-129","Mike Lude"
"1969","Colorado St.","4","6","0","0.4","218","288","-70","Mike Lude"
"1970","Colorado St.","4","7","0","0.36364","206","246","-40","Jerry Wampfler"
"1971","Colorado St.","3","8","0","0.27273","177","276","-99","Jerry Wampfler"
"1972","Colorado St.","1","10","0","0.09091","128","413","-285","Jerry Wampfler"
"1973","Colorado St.","5","6","0","0.45455","250","333","-83","Sark Arslanian"
"1974","Colorado St.","4","6","1","0.40909","295","266","29","Sark Arslanian"
"1975","Colorado St.","6","5","0","0.54545","172","234","-62","Sark Arslanian"
"1976","Colorado St.","6","5","0","0.54545","205","186","19","Sark Arslanian"
"1977","Colorado St.","9","2","1","0.79167","301","206","95","Sark Arslanian"
"1978","Colorado St.","5","6","0","0.45455","238","247","-9","Sark Arslanian"
"1979","Colorado St.","4","7","1","0.375","177","241","-64","Sark Arslanian"
"1980","Colorado St.","6","4","1","0.59091","232","330","-98","Sark Arslanian"
"1981","Colorado St.","0","6","0","0","71","210","-139","Sark Arslanian"
"1981","Colorado St.","0","6","0","0","93","292","-199","Chester Caddas"
"1982","Colorado St.","4","7","0","0.36364","220","267","-47","Leon Fuller"
"1983","Colorado St.","5","7","0","0.41667","222","350","-128","Leon Fuller"
"1984","Colorado St.","3","8","0","0.27273","230","360","-130","Leon Fuller"
"1985","Colorado St.","5","7","0","0.41667","251","330","-79","Leon Fuller"
"1986","Colorado St.","6","5","0","0.54545","266","237","29","Leon Fuller"
"1987","Colorado St.","1","11","0","0.08333","245","370","-125","Leon Fuller"
"1988","Colorado St.","1","10","0","0.09091","192","348","-156","Leon Fuller"
"1989","Colorado St.","5","5","1","0.5","350","303","47","Earle Bruce"
"1990","Colorado St.","9","4","0","0.69231","372","302","70","Earle Bruce"
"1991","Colorado St.","3","8","0","0.27273","265","375","-110","Earle Bruce"
"1992","Colorado St.","5","7","0","0.41667","281","334","-53","Earle Bruce"
"1993","Colorado St.","5","6","0","0.45455","230","268","-38","Sonny Lubick"
"1994","Colorado St.","10","2","0","0.83333","400","269","131","Sonny Lubick"
"1995","Colorado St.","8","4","0","0.66667","339","254","85","Sonny Lubick"
"1996","Colorado St.","7","5","0","0.58333","380","336","44","Sonny Lubick"
"1997","Colorado St.","11","2","0","0.84615","477","203","274","Sonny Lubick"
"1998","Colorado St.","8","4","0","0.66667","345","263","82","Sonny Lubick"
"1999","Colorado St.","8","4","0","0.66667","345","269","76","Sonny Lubick"
"2000","Colorado St.","10","2","0","0.83333","363","225","138","Sonny Lubick"
"2001","Colorado St.","7","5","0","0.58333","298","274","24","Sonny Lubick"
"2002","Colorado St.","10","4","0","0.71429","418","332","86","Sonny Lubick"
"2003","Colorado St.","7","6","0","0.53846","381","318","63","Sonny Lubick"
"2004","Colorado St.","4","7","0","0.36364","261","325","-64","Sonny Lubick"
"2005","Colorado St.","6","6","0","0.5","321","369","-48","Sonny Lubick"
"2006","Colorado St.","4","8","0","0.33333","202","263","-61","Sonny Lubick"
"2007","Colorado St.","3","9","0","0.25","304","369","-65","Sonny Lubick"
"2008","Colorado St.","7","6","0","0.53846","327","393","-66","Steve Fairchild"
"2009","Colorado St.","3","9","0","0.25","260","358","-98","Steve Fairchild"
"2010","Colorado St.","3","9","0","0.25","198","416","-218","Steve Fairchild"
"2011","Colorado St.","3","9","0","0.25","257","375","-118","Steve Fairchild"
"2012","Colorado St.","4","8","0","0.33333","254","363","-109","Jim McElwain"
"2013","Colorado St.","8","6","0","0.57143","507","417","90","Jim McElwain"
"2014","Colorado St.","10","2","0","0.83333","431","281","150","Jim McElwain"
"2014","Colorado St.","0","1","0","0","10","45","-35","Dave Baldwin"
"1898","Connecticut","0","3","0","0","0","89","-89","E.S. Mansfield"
"1899","Connecticut","6","2","0","0.75","107","62","45","T.D. Knowles"
"1900","Connecticut","4","3","1","0.5625","103","45","58","T.D. Knowles"
"1901","Connecticut","8","2","0","0.8","143","67","76","T.D. Knowles"
"1902","Connecticut","4","3","0","0.57143","84","66","18","E.O. Smith"
"1903","Connecticut","4","5","0","0.44444","92","90","2","E.O. Smith"
"1904","Connecticut","5","3","1","0.61111","83","85","-2","E.O. Smith"
"1905","Connecticut","3","2","0","0.6","37","59","-22","E.O. Smith"
"1906","Connecticut","2","4","0","0.33333","50","75","-25","George Lamson"
"1907","Connecticut","2","5","0","0.28571","71","158","-87","George Lamson"
"1908","Connecticut","4","3","1","0.5625","150","49","101","W.F. Madden"
"1909","Connecticut","3","5","0","0.375","104","190","-86","S.F.G. McLean"
"1910","Connecticut","1","5","1","0.21429","12","117","-105","M.F. Claffey"
"1911","Connecticut","1","7","0","0.125","16","199","-183","Leo Hafford"
"1912","Connecticut","5","5","0","0.5","74","124","-50","A.J. Sharadin"
"1913","Connecticut","6","3","0","0.66667","200","122","78","P.T. Brady"
"1914","Connecticut","3","0","0","1","48","9","39","Dave Warner"
"1915","Connecticut","1","7","0","0.125","40","107","-67","John Donahue"
"1916","Connecticut","1","7","0","0.125","36","110","-74","John Donahue"
"1919","Connecticut","2","6","0","0.25","28","174","-146","Roy Guyer"
"1920","Connecticut","1","6","1","0.1875","69","126","-57","Ross Swartz"
"1921","Connecticut","3","2","3","0.5625","115","75","40","J. Wilder Tasker"
"1922","Connecticut","2","6","1","0.27778","77","108","-31","J. Wilder Tasker"
"1923","Connecticut","3","4","1","0.4375","45","46","-1","Summer Dole"
"1924","Connecticut","6","0","2","0.875","90","13","77","Summer Dole"
"1925","Connecticut","3","5","1","0.38889","39","76","-37","Summer Dole"
"1926","Connecticut","7","1","0","0.875","190","33","157","Summer Dole"
"1927","Connecticut","5","4","0","0.55556","153","100","53","Summer Dole"
"1928","Connecticut","4","1","3","0.6875","96","51","45","Summer Dole"
"1929","Connecticut","4","4","0","0.5","92","47","45","Summer Dole"
"1930","Connecticut","1","6","1","0.1875","19","130","-111","Summer Dole"
"1931","Connecticut","2","3","3","0.4375","27","84","-57","Summer Dole"
"1932","Connecticut","0","6","2","0.125","27","187","-160","Summer Dole"
"1933","Connecticut","1","6","1","0.1875","39","176","-137","Summer Dole"
"1934","Connecticut","1","7","0","0.125","19","108","-89","J.O. Christian"
"1935","Connecticut","2","4","1","0.35714","39","70","-31","J.O. Christian"
"1936","Connecticut","7","2","0","0.77778","203","48","155","J.O. Christian"
"1937","Connecticut","6","2","1","0.72222","187","64","123","J.O. Christian"
"1938","Connecticut","4","3","0","0.57143","90","56","34","J.O. Christian"
"1939","Connecticut","5","3","0","0.625","99","97","2","J.O. Christian"
"1940","Connecticut","4","4","0","0.5","67","89","-22","J.O. Christian"
"1941","Connecticut","2","6","0","0.25","58","82","-24","J.O. Christian"
"1942","Connecticut","6","2","0","0.75","141","81","60","J.O. Christian"
"1944","Connecticut","7","1","0","0.875","152","13","139","J.O. Christian"
"1945","Connecticut","7","1","0","0.875","265","43","222","J.O. Christian"
"1946","Connecticut","4","3","1","0.5625","120","69","51","J.O. Christian"
"1947","Connecticut","4","4","0","0.5","102","85","17","J.O. Christian"
"1948","Connecticut","3","5","0","0.375","172","147","25","J.O. Christian"
"1949","Connecticut","4","4","1","0.5","220","141","79","J.O. Christian"
"1950","Connecticut","3","5","0","0.375","82","134","-52","Arthur L. Valpey"
"1951","Connecticut","4","4","0","0.5","106","102","4","Arthur L. Valpey"
"1952","Connecticut","5","3","0","0.625","178","135","43","D. Robert Ingalls"
"1953","Connecticut","3","4","1","0.4375","118","147","-29","D. Robert Ingalls"
"1954","Connecticut","1","8","0","0.11111","92","276","-184","D. Robert Ingalls"
"1955","Connecticut","4","4","0","0.5","68","105","-37","D. Robert Ingalls"
"1956","Connecticut","6","2","1","0.72222","240","100","140","D. Robert Ingalls"
"1957","Connecticut","5","4","1","0.55","143","121","22","D. Robert Ingalls"
"1958","Connecticut","7","3","0","0.7","281","134","147","D. Robert Ingalls"
"1959","Connecticut","6","3","0","0.66667","197","111","86","D. Robert Ingalls"
"1960","Connecticut","5","4","0","0.55556","179","123","56","D. Robert Ingalls"
"1961","Connecticut","2","7","0","0.22222","108","167","-59","D. Robert Ingalls"
"1962","Connecticut","3","6","0","0.33333","97","139","-42","D. Robert Ingalls"
"1963","Connecticut","2","6","0","0.25","91","113","-22","D. Robert Ingalls"
"1964","Connecticut","4","4","1","0.5","99","123","-24","Richard ""Rick"" Forzano"
"1965","Connecticut","3","6","0","0.33333","100","116","-16","Richard ""Rick"" Forzano"
"1966","Connecticut","2","6","1","0.27778","92","156","-64","John Toner"
"1967","Connecticut","5","4","0","0.55556","137","151","-14","John Toner"
"1968","Connecticut","4","6","0","0.4","216","191","25","John Toner"
"1969","Connecticut","5","4","0","0.55556","193","187","6","John Toner"
"1970","Connecticut","4","4","2","0.5","240","193","47","John Toner"
"1971","Connecticut","5","3","1","0.61111","107","145","-38","Robert ""Bob"" Casciola"
"1972","Connecticut","4","5","0","0.44444","143","187","-44","Robert ""Bob"" Casciola"
"1973","Connecticut","8","2","1","0.77273","208","141","67","Larry Naviaux"
"1974","Connecticut","4","6","0","0.4","153","168","-15","Larry Naviaux"
"1975","Connecticut","4","7","0","0.36364","178","244","-66","Larry Naviaux"
"1976","Connecticut","2","9","0","0.18182","182","246","-64","Larry Naviaux"
"1977","Connecticut","1","10","0","0.09091","84","290","-206","Walt Nadzak"
"1978","Connecticut","4","7","0","0.36364","181","202","-21","Walt Nadzak"
"1979","Connecticut","3","6","2","0.36364","144","173","-29","Walt Nadzak"
"1980","Connecticut","7","3","0","0.7","259","191","68","Walt Nadzak"
"1981","Connecticut","4","7","0","0.36364","291","255","36","Walt Nadzak"
"1982","Connecticut","5","6","0","0.45455","164","193","-29","Walt Nadzak"
"1983","Connecticut","5","6","0","0.45455","187","209","-22","Tom Jackson"
"1984","Connecticut","3","8","0","0.27273","163","186","-23","Tom Jackson"
"1985","Connecticut","4","5","0","0.44444","175","181","-6","Tom Jackson"
"1986","Connecticut","8","3","0","0.72727","249","229","20","Tom Jackson"
"1987","Connecticut","7","4","0","0.63636","291","235","56","Tom Jackson"
"1988","Connecticut","7","4","0","0.63636","298","180","118","Tom Jackson"
"1989","Connecticut","8","3","0","0.72727","297","252","45","Tom Jackson"
"1990","Connecticut","6","5","0","0.54545","308","281","27","Tom Jackson"
"1991","Connecticut","3","8","0","0.27273","241","340","-99","Tom Jackson"
"1992","Connecticut","5","6","0","0.45455","254","239","15","Tom Jackson"
"1993","Connecticut","6","5","0","0.54545","261","217","44","Tom Jackson"
"1994","Connecticut","4","7","0","0.36364","240","264","-24","Skip Holtz"
"1995","Connecticut","8","3","0","0.72727","279","200","79","Skip Holtz"
"1996","Connecticut","4","6","0","0.4","244","191","53","Skip Holtz"
"1997","Connecticut","7","4","0","0.63636","398","246","152","Skip Holtz"
"1998","Connecticut","10","3","0","0.76923","461","413","48","Skip Holtz"
"1999","Connecticut","4","7","0","0.36364","255","383","-128","Randy Edsall"
"2000","Connecticut","3","8","0","0.27273","220","368","-148","Randy Edsall"
"2001","Connecticut","2","9","0","0.18182","192","370","-178","Randy Edsall"
"2002","Connecticut","6","6","0","0.5","373","270","103","Randy Edsall"
"2003","Connecticut","9","3","0","0.75","408","300","108","Randy Edsall"
"2004","Connecticut","8","4","0","0.66667","363","260","103","Randy Edsall"
"2005","Connecticut","5","6","0","0.45455","272","211","61","Randy Edsall"
"2006","Connecticut","4","8","0","0.33333","257","324","-67","Randy Edsall"
"2007","Connecticut","9","4","0","0.69231","344","247","97","Randy Edsall"
"2008","Connecticut","8","5","0","0.61538","324","257","67","Randy Edsall"
"2009","Connecticut","8","5","0","0.61538","405","307","98","Randy Edsall"
"2010","Connecticut","8","5","0","0.61538","343","286","57","Randy Edsall"
"2011","Connecticut","5","7","0","0.41667","291","292","-1","Paul Pasqualoni"
"2012","Connecticut","5","7","0","0.41667","213","238","-25","Paul Pasqualoni"
"2013","Connecticut","0","4","0","0","72","130","-58","Paul Pasqualoni"
"2013","Connecticut","3","5","0","0.375","175","233","-58","T.J. Weist"
"2014","Connecticut","2","10","0","0.16667","186","358","-172","Bob Diaco"
"1888","Duke (NC)","2","1","0","0.66667","41","49","-8","Dr. John F. Crowell"
"1889","Duke (NC)","1","0","1","0.75","8","4","4","Dr. John F. Crowell"
"1893","Duke (NC)","83","95","9","0.46791","2272","2942","-670","No Coach"
"1920","Duke (NC)","4","0","1","0.9","53","20","33","Floyd J. Egan"
"1921","Duke (NC)","6","1","2","0.77778","147","32","115","James A. Baldwin"
"1922","Duke (NC)","7","2","1","0.75","156","57","99","Herman Steiner"
"1923","Duke (NC)","5","4","0","0.55556","211","104","107","S.M. Alexander"
"1924","Duke (NC)","4","5","0","0.44444","129","99","30","Howard H. Jones"
"1925","Duke (NC)","4","5","0","0.44444","58","142","-84","James P. ""Pat"" Herron"
"1926","Duke (NC)","3","6","0","0.33333","124","106","18","James ""Jimmy"" DeHart"
"1927","Duke (NC)","4","5","0","0.44444","215","117","98","James ""Jimmy"" DeHart"
"1928","Duke (NC)","5","5","0","0.5","155","116","39","James ""Jimmy"" DeHart"
"1929","Duke (NC)","4","6","0","0.4","153","260","-107","James ""Jimmy"" DeHart"
"1930","Duke (NC)","8","1","2","0.81818","147","48","99","James ""Jimmy"" DeHart"
"1931","Duke (NC)","5","3","2","0.6","74","46","28","Wallace W. Wade"
"1932","Duke (NC)","7","3","0","0.7","153","40","113","Wallace W. Wade"
"1933","Duke (NC)","9","1","0","0.9","181","42","139","Wallace W. Wade"
"1934","Duke (NC)","7","2","0","0.77778","185","40","145","Wallace W. Wade"
"1935","Duke (NC)","8","2","0","0.8","214","45","169","Wallace W. Wade"
"1936","Duke (NC)","9","1","0","0.9","208","28","180","Wallace W. Wade"
"1937","Duke (NC)","7","2","1","0.75","228","56","172","Wallace W. Wade"
"1938","Duke (NC)","9","1","0","0.9","117","7","110","Wallace W. Wade"
"1939","Duke (NC)","8","1","0","0.88889","183","42","141","Wallace W. Wade"
"1940","Duke (NC)","7","2","0","0.77778","203","52","151","Wallace W. Wade"
"1941","Duke (NC)","9","1","0","0.9","327","61","266","Wallace W. Wade"
"1946","Duke (NC)","4","5","0","0.44444","134","86","48","Wallace W. Wade"
"1947","Duke (NC)","4","3","2","0.55556","79","90","-11","Wallace W. Wade"
"1948","Duke (NC)","4","3","2","0.55556","144","92","52","Wallace W. Wade"
"1949","Duke (NC)","6","3","0","0.66667","260","117","143","Wallace W. Wade"
"1950","Duke (NC)","7","3","0","0.7","202","108","94","Wallace W. Wade"
"1942","Duke (NC)","5","4","1","0.55","211","98","113","Edmund M. ""Eddie"" Cameron"
"1943","Duke (NC)","8","1","0","0.88889","335","34","301","Edmund M. ""Eddie"" Cameron"
"1944","Duke (NC)","6","4","0","0.6","230","118","112","Edmund M. ""Eddie"" Cameron"
"1945","Duke (NC)","6","2","0","0.75","229","114","115","Edmund M. ""Eddie"" Cameron"
"1951","Duke (NC)","5","4","1","0.55","201","157","44","William D. ""Bill"" Murray"
"1952","Duke (NC)","8","2","0","0.8","227","72","155","William D. ""Bill"" Murray"
"1953","Duke (NC)","7","2","1","0.75","217","81","136","William D. ""Bill"" Murray"
"1954","Duke (NC)","8","2","1","0.77273","270","161","109","William D. ""Bill"" Murray"
"1955","Duke (NC)","7","2","1","0.75","196","95","101","William D. ""Bill"" Murray"
"1956","Duke (NC)","5","4","1","0.55","184","100","84","William D. ""Bill"" Murray"
"1957","Duke (NC)","6","3","2","0.63636","182","135","47","William D. ""Bill"" Murray"
"1958","Duke (NC)","5","5","0","0.5","128","131","-3","William D. ""Bill"" Murray"
"1959","Duke (NC)","4","6","0","0.4","104","159","-55","William D. ""Bill"" Murray"
"1960","Duke (NC)","8","3","0","0.72727","173","114","59","William D. ""Bill"" Murray"
"1961","Duke (NC)","7","3","0","0.7","183","106","77","William D. ""Bill"" Murray"
"1962","Duke (NC)","8","2","0","0.8","199","105","94","William D. ""Bill"" Murray"
"1963","Duke (NC)","5","4","1","0.55","230","198","32","William D. ""Bill"" Murray"
"1964","Duke (NC)","4","5","1","0.45","148","135","13","William D. ""Bill"" Murray"
"1965","Duke (NC)","6","4","0","0.6","216","157","59","William D. ""Bill"" Murray"
"1966","Duke (NC)","5","5","0","0.5","164","237","-73","Tom Harp"
"1967","Duke (NC)","4","6","0","0.4","143","153","-10","Tom Harp"
"1968","Duke (NC)","4","6","0","0.4","214","287","-73","Tom Harp"
"1969","Duke (NC)","3","6","1","0.35","161","224","-63","Tom Harp"
"1970","Duke (NC)","6","5","0","0.54545","229","252","-23","Tom Harp"
"1971","Duke (NC)","6","5","0","0.54545","170","149","21","Mike McGee"
"1972","Duke (NC)","5","6","0","0.45455","132","156","-24","Mike McGee"
"1973","Duke (NC)","2","8","1","0.22727","132","204","-72","Mike McGee"
"1974","Duke (NC)","6","5","0","0.54545","201","208","-7","Mike McGee"
"1975","Duke (NC)","4","5","2","0.45455","197","212","-15","Mike McGee"
"1976","Duke (NC)","5","5","1","0.5","234","245","-11","Mike McGee"
"1977","Duke (NC)","5","6","0","0.45455","231","221","10","Mike McGee"
"1978","Duke (NC)","4","7","0","0.36364","108","247","-139","Mike McGee"
"1979","Duke (NC)","2","8","1","0.22727","152","264","-112","Shirley ""Red"" Wilson"
"1980","Duke (NC)","2","9","0","0.18182","214","296","-82","Shirley ""Red"" Wilson"
"1981","Duke (NC)","6","5","0","0.54545","210","230","-20","Shirley ""Red"" Wilson"
"1982","Duke (NC)","6","5","0","0.54545","307","290","17","Shirley ""Red"" Wilson"
"1983","Duke (NC)","3","8","0","0.27273","246","350","-104","Steve Sloan"
"1984","Duke (NC)","2","9","0","0.18182","128","301","-173","Steve Sloan"
"1985","Duke (NC)","4","7","0","0.36364","193","252","-59","Steve Sloan"
"1986","Duke (NC)","4","7","0","0.36364","200","284","-84","Steve Sloan"
"1987","Duke (NC)","5","6","0","0.45455","301","243","58","Steve Spurrier"
"1988","Duke (NC)","7","3","1","0.68182","324","324","0","Steve Spurrier"
"1989","Duke (NC)","8","4","0","0.66667","377","335","42","Steve Spurrier"
"1990","Duke (NC)","4","7","0","0.36364","240","295","-55","Barry Wilson"
"1991","Duke (NC)","4","6","1","0.40909","231","280","-49","Barry Wilson"
"1992","Duke (NC)","2","9","0","0.18182","265","343","-78","Barry Wilson"
"1993","Duke (NC)","3","8","0","0.27273","214","349","-135","Barry Wilson"
"1994","Duke (NC)","8","4","0","0.66667","380","281","99","Fred Goldsmith"
"1995","Duke (NC)","3","8","0","0.27273","282","386","-104","Fred Goldsmith"
"1996","Duke (NC)","0","11","0","0","162","379","-217","Fred Goldsmith"
"1997","Duke (NC)","2","9","0","0.18182","223","341","-118","Fred Goldsmith"
"1998","Duke (NC)","4","7","0","0.36364","229","319","-90","Fred Goldsmith"
"1999","Duke (NC)","3","8","0","0.27273","217","363","-146","Carl Franks"
"2000","Duke (NC)","0","11","0","0","155","430","-275","Carl Franks"
"2001","Duke (NC)","0","11","0","0","212","491","-279","Carl Franks"
"2002","Duke (NC)","2","10","0","0.16667","227","353","-126","Carl Franks"
"2003","Duke (NC)","2","5","0","0.28571","106","213","-107","Carl Franks"
"2003","Duke (NC)","2","3","0","0.4","105","130","-25","Ted Roof"
"2004","Duke (NC)","2","9","0","0.18182","183","322","-139","Ted Roof"
"2005","Duke (NC)","1","10","0","0.09091","177","408","-231","Ted Roof"
"2006","Duke (NC)","0","12","0","0","179","406","-227","Ted Roof"
"2007","Duke (NC)","1","11","0","0.08333","215","398","-183","Ted Roof"
"2008","Duke (NC)","4","8","0","0.33333","241","281","-40","David Cutcliffe"
"2009","Duke (NC)","5","7","0","0.41667","302","340","-38","David Cutcliffe"
"2010","Duke (NC)","3","9","0","0.25","303","425","-122","David Cutcliffe"
"2011","Duke (NC)","3","9","0","0.25","270","374","-104","David Cutcliffe"
"2012","Duke (NC)","6","7","0","0.46154","410","468","-58","David Cutcliffe"
"2013","Duke (NC)","10","4","0","0.71429","459","373","86","David Cutcliffe"
"2014","Duke (NC)","9","4","0","0.69231","421","283","138","David Cutcliffe"
"1912","Eastern Michigan","4","2","1","0.64286","83","45","38","Leroy Brown"
"1913","Eastern Michigan","2","3","1","0.41667","50","72","-22","Leroy Brown"
"1914","Eastern Michigan","3","2","1","0.58333","72","46","26","Dr. Thomas Ransom"
"1915","Eastern Michigan","4","2","1","0.64286","154","25","129","Elmer C. Mitchell"
"1916","Eastern Michigan","1","2","1","0.375","18","33","-15","Elmer C. Mitchell"
"1918","Eastern Michigan","1","2","0","0.33333","26","31","-5","Lynn Bell"
"1921","Eastern Michigan","3","3","0","0.5","82","50","32","Joseph McCulloch"
"1922","Eastern Michigan","3","2","2","0.57143","31","28","3","Joseph McCulloch"
"1923","Eastern Michigan","2","5","1","0.3125","55","104","-49","James M. ""Bingo? Brown"
"1924","Eastern Michigan","2","5","1","0.3125","45","69","-24","James M. ""Bingo? Brown"
"1917","Eastern Michigan","3","4","0","0.42857","111","82","29","Elton J. Rynearson"
"1919","Eastern Michigan","4","2","1","0.64286","73","44","29","Elton J. Rynearson"
"1920","Eastern Michigan","6","2","0","0.75","155","88","67","Elton J. Rynearson"
"1925","Eastern Michigan","8","0","0","1","106","6","100","Elton J. Rynearson"
"1926","Eastern Michigan","6","1","0","0.85714","113","12","101","Elton J. Rynearson"
"1927","Eastern Michigan","8","0","0","1","186","13","173","Elton J. Rynearson"
"1928","Eastern Michigan","7","1","0","0.875","233","43","190","Elton J. Rynearson"
"1929","Eastern Michigan","5","1","2","0.75","156","45","111","Elton J. Rynearson"
"1930","Eastern Michigan","6","1","0","0.85714","145","14","131","Elton J. Rynearson"
"1931","Eastern Michigan","3","2","1","0.58333","98","54","44","Elton J. Rynearson"
"1932","Eastern Michigan","5","2","0","0.71429","145","31","114","Elton J. Rynearson"
"1933","Eastern Michigan","6","2","0","0.75","115","71","44","Elton J. Rynearson"
"1934","Eastern Michigan","5","2","0","0.71429","109","79","30","Elton J. Rynearson"
"1935","Eastern Michigan","4","2","2","0.625","43","41","2","Elton J. Rynearson"
"1936","Eastern Michigan","6","2","0","0.75","76","53","23","Elton J. Rynearson"
"1937","Eastern Michigan","5","2","1","0.6875","156","59","97","Elton J. Rynearson"
"1938","Eastern Michigan","6","1","1","0.8125","166","36","130","Elton J. Rynearson"
"1939","Eastern Michigan","3","3","1","0.5","68","64","4","Elton J. Rynearson"
"1940","Eastern Michigan","1","5","1","0.21429","34","125","-91","Elton J. Rynearson"
"1941","Eastern Michigan","0","5","2","0.14286","12","65","-53","Elton J. Rynearson"
"1942","Eastern Michigan","3","3","1","0.5","64","81","-17","Elton J. Rynearson"
"1943","Eastern Michigan","2","0","0","1","28","0","28","Elton J. Rynearson"
"1945","Eastern Michigan","5","0","1","0.91667","46","13","33","Elton J. Rynearson"
"1946","Eastern Michigan","3","4","1","0.4375","65","80","-15","Elton J. Rynearson"
"1947","Eastern Michigan","1","6","0","0.14286","29","106","-77","Elton J. Rynearson"
"1948","Eastern Michigan","3","5","0","0.375","66","114","-48","Elton J. Rynearson"
"1949","Eastern Michigan","0","8","0","0","61","180","-119","Harry Ockerman"
"1950","Eastern Michigan","3","6","0","0.33333","123","191","-68","Harry Ockerman"
"1951","Eastern Michigan","4","5","0","0.44444","186","183","3","Harry Ockerman"
"1952","Eastern Michigan","5","3","1","0.61111","154","146","8","Fred Trosko"
"1953","Eastern Michigan","7","1","1","0.83333","212","105","107","Fred Trosko"
"1954","Eastern Michigan","8","1","0","0.88889","210","67","143","Fred Trosko"
"1955","Eastern Michigan","7","2","0","0.77778","138","70","68","Fred Trosko"
"1956","Eastern Michigan","4","4","0","0.5","158","84","74","Fred Trosko"
"1957","Eastern Michigan","6","3","0","0.66667","237","127","110","Fred Trosko"
"1958","Eastern Michigan","4","5","0","0.44444","108","88","20","Fred Trosko"
"1959","Eastern Michigan","1","7","0","0.125","50","217","-167","Fred Trosko"
"1960","Eastern Michigan","0","8","1","0.05556","38","230","-192","Fred Trosko"
"1961","Eastern Michigan","0","8","1","0.05556","49","171","-122","Fred Trosko"
"1962","Eastern Michigan","2","5","0","0.28571","75","90","-15","Fred Trosko"
"1963","Eastern Michigan","2","6","0","0.25","96","201","-105","Fred Trosko"
"1964","Eastern Michigan","4","3","0","0.57143","110","73","37","Fred Trosko"
"1965","Eastern Michigan","3","4","1","0.4375","125","129","-4","Jerry Raymond"
"1966","Eastern Michigan","5","3","1","0.61111","100","87","13","Jerry Raymond"
"1967","Eastern Michigan","6","3","0","0.66667","173","77","96","Dan Boisture"
"1968","Eastern Michigan","8","2","0","0.8","248","91","157","Dan Boisture"
"1969","Eastern Michigan","5","4","0","0.55556","255","106","149","Dan Boisture"
"1970","Eastern Michigan","7","2","1","0.75","237","109","128","Dan Boisture"
"1971","Eastern Michigan","7","1","2","0.8","228","85","143","Dan Boisture"
"1972","Eastern Michigan","6","4","0","0.6","202","162","40","Dan Boisture"
"1973","Eastern Michigan","6","4","0","0.6","265","190","75","Dan Boisture"
"1974","Eastern Michigan","4","6","1","0.40909","143","178","-35","George Mans"
"1975","Eastern Michigan","4","6","0","0.4","198","171","27","George Mans"
"1976","Eastern Michigan","2","9","0","0.18182","132","355","-223","Ed Chlebek"
"1977","Eastern Michigan","8","3","0","0.72727","239","195","44","Ed Chlebek"
"1978","Eastern Michigan","3","7","0","0.3","122","238","-116","Mike Stock"
"1979","Eastern Michigan","2","8","1","0.22727","113","236","-123","Mike Stock"
"1980","Eastern Michigan","1","9","0","0.1","81","322","-241","Mike Stock"
"1981","Eastern Michigan","0","11","0","0","88","338","-250","Mike Stock"
"1982","Eastern Michigan","0","3","0","0","19","98","-79","Mike Stock"
"1982","Eastern Michigan","1","6","1","0.1875","66","107","-41","Bob LaPointe"
"1983","Eastern Michigan","1","10","0","0.09091","134","276","-142","Jim Harkema"
"1984","Eastern Michigan","2","7","2","0.27273","151","221","-70","Jim Harkema"
"1985","Eastern Michigan","4","7","0","0.36364","188","252","-64","Jim Harkema"
"1986","Eastern Michigan","6","5","0","0.54545","222","228","-6","Jim Harkema"
"1987","Eastern Michigan","10","2","0","0.83333","343","237","106","Jim Harkema"
"1988","Eastern Michigan","6","3","1","0.65","173","200","-27","Jim Harkema"
"1989","Eastern Michigan","7","3","1","0.68182","252","196","56","Jim Harkema"
"1990","Eastern Michigan","2","9","0","0.18182","179","301","-122","Jim Harkema"
"1991","Eastern Michigan","3","7","1","0.31818","144","232","-88","Jim Harkema"
"1992","Eastern Michigan","0","4","0","0","47","127","-80","Jim Harkema"
"1992","Eastern Michigan","1","6","0","0.14286","70","209","-139","Jan Quarless"
"1993","Eastern Michigan","4","7","0","0.36364","163","220","-57","Ron Cooper"
"1994","Eastern Michigan","5","6","0","0.45455","247","285","-38","Ron Cooper"
"1995","Eastern Michigan","6","5","0","0.54545","363","335","28","Rick Rasnick"
"1996","Eastern Michigan","3","8","0","0.27273","210","284","-74","Rick Rasnick"
"1997","Eastern Michigan","4","7","0","0.36364","329","352","-23","Rick Rasnick"
"1998","Eastern Michigan","3","8","0","0.27273","216","309","-93","Rick Rasnick"
"1999","Eastern Michigan","4","6","0","0.4","216","308","-92","Rick Rasnick"
"1999","Eastern Michigan","0","1","0","0","23","30","-7","Tony Lombardi"
"2000","Eastern Michigan","3","8","0","0.27273","209","350","-141","Jeff Woodruff"
"2001","Eastern Michigan","2","9","0","0.18182","197","356","-159","Jeff Woodruff"
"2002","Eastern Michigan","3","9","0","0.25","286","566","-280","Jeff Woodruff"
"2003","Eastern Michigan","1","8","0","0.11111","124","306","-182","Jeff Woodruff"
"2003","Eastern Michigan","2","1","0","0.66667","81","65","16","Alton ""Al"" Lavan"
"2004","Eastern Michigan","4","7","0","0.36364","328","458","-130","Jeff Genyk"
"2005","Eastern Michigan","4","7","0","0.36364","240","295","-55","Jeff Genyk"
"2006","Eastern Michigan","1","11","0","0.08333","167","322","-155","Jeff Genyk"
"2007","Eastern Michigan","4","8","0","0.33333","290","374","-84","Jeff Genyk"
"2008","Eastern Michigan","3","9","0","0.25","309","427","-118","Jeff Genyk"
"2009","Eastern Michigan","0","12","0","0","197","459","-262","Ron English"
"2010","Eastern Michigan","2","10","0","0.16667","228","527","-299","Ron English"
"2011","Eastern Michigan","6","6","0","0.5","255","292","-37","Ron English"
"2012","Eastern Michigan","2","10","0","0.16667","256","451","-195","Ron English"
"2013","Eastern Michigan","1","8","0","0.11111","174","410","-236","Ron English"
"2013","Eastern Michigan","1","2","0","0.33333","52","132","-80","Stan Parrish"
"2014","Eastern Michigan","2","10","0","0.16667","182","491","-309","Chris Creighton"
"1906","Florida","5","3","0","0.625","84","60","24","Jack Forsythe"
"1907","Florida","4","1","1","0.75","53","10","43","Jack Forsythe"
"1908","Florida","5","2","1","0.6875","90","40","50","Jack Forsythe"
"1909","Florida","6","1","1","0.8125","98","34","64","G.E. Pyle"
"1910","Florida","6","1","0","0.85714","186","15","171","G.E. Pyle"
"1911","Florida","5","0","1","0.91667","84","14","70","G.E. Pyle"
"1912","Florida","5","2","1","0.6875","203","54","149","G.E. Pyle"
"1913","Florida","4","3","0","0.57143","228","94","134","G.E. Pyle"
"1914","Florida","5","2","0","0.71429","152","46","106","Charles J. McCoy"
"1915","Florida","4","3","0","0.57143","99","65","34","Charles J. McCoy"
"1916","Florida","0","5","0","0","3","95","-92","Charles J. McCoy"
"1917","Florida","2","4","0","0.33333","47","247","-200","Alfred Leo ""Al"" Buser"
"1918","Florida","0","1","0","0","2","14","-12","Alfred Leo ""Al"" Buser"
"1919","Florida","5","3","0","0.625","174","46","128","Alfred Leo ""Al"" Buser"
"1920","Florida","6","3","0","0.66667","113","91","22","William G. Kline"
"1921","Florida","6","3","2","0.63636","134","61","73","William G. Kline"
"1922","Florida","7","2","0","0.77778","239","51","188","William G. Kline"
"1923","Florida","6","1","2","0.77778","179","60","119","J.A. VanFleet"
"1924","Florida","6","2","2","0.7","211","44","167","J.A. VanFleet"
"1925","Florida","8","2","0","0.8","222","80","142","Harold Leon ""Tom"" Sebring"
"1926","Florida","2","6","2","0.3","94","137","-43","Harold Leon ""Tom"" Sebring"
"1927","Florida","7","3","0","0.7","164","96","68","Harold Leon ""Tom"" Sebring"
"1928","Florida","8","1","0","0.88889","336","44","292","Charles W. Bachman"
"1929","Florida","8","2","0","0.8","187","73","114","Charles W. Bachman"
"1930","Florida","6","3","1","0.65","199","60","139","Charles W. Bachman"
"1931","Florida","2","6","2","0.3","73","168","-95","Charles W. Bachman"
"1932","Florida","3","6","0","0.33333","108","136","-28","Charles W. Bachman"
"1933","Florida","5","3","1","0.61111","114","53","61","Dennis Keith ""Dutch"" Stanley"
"1934","Florida","6","3","1","0.65","113","110","3","Dennis Keith ""Dutch"" Stanley"
"1935","Florida","3","7","0","0.3","113","154","-41","Dennis Keith ""Dutch"" Stanley"
"1936","Florida","4","6","0","0.4","99","125","-26","Josh C. Cody"
"1937","Florida","4","7","0","0.36364","86","89","-3","Josh C. Cody"
"1938","Florida","4","6","1","0.40909","112","149","-37","Josh C. Cody"
"1939","Florida","5","5","1","0.5","78","66","12","Josh C. Cody"
"1940","Florida","5","5","0","0.5","136","139","-3","Thomas J. ""Tom? Lieb"
"1941","Florida","4","6","0","0.4","149","97","52","Thomas J. ""Tom? Lieb"
"1942","Florida","3","7","0","0.3","106","185","-79","Thomas J. ""Tom? Lieb"
"1944","Florida","4","3","0","0.57143","108","136","-28","Thomas J. ""Tom? Lieb"
"1945","Florida","4","5","1","0.45","155","100","55","Thomas J. ""Tom? Lieb"
"1946","Florida","0","9","0","0","104","264","-160","Raymond ""Bear"" Wolf"
"1947","Florida","4","5","1","0.45","125","156","-31","Raymond ""Bear"" Wolf"
"1948","Florida","5","5","0","0.5","213","206","7","Raymond ""Bear"" Wolf"
"1949","Florida","4","5","1","0.45","180","218","-38","Raymond ""Bear"" Wolf"
"1950","Florida","5","5","0","0.5","157","181","-24","George R. ""Bob"" Woodruff"
"1951","Florida","5","5","0","0.5","174","131","43","George R. ""Bob"" Woodruff"
"1952","Florida","8","3","0","0.72727","304","122","182","George R. ""Bob"" Woodruff"
"1953","Florida","3","5","2","0.4","200","113","87","George R. ""Bob"" Woodruff"
"1954","Florida","5","5","0","0.5","115","128","-13","George R. ""Bob"" Woodruff"
"1955","Florida","4","6","0","0.4","111","126","-15","George R. ""Bob"" Woodruff"
"1956","Florida","6","3","1","0.65","158","98","60","George R. ""Bob"" Woodruff"
"1957","Florida","6","2","1","0.72222","133","70","63","George R. ""Bob"" Woodruff"
"1958","Florida","6","4","1","0.59091","174","100","74","George R. ""Bob"" Woodruff"
"1959","Florida","5","4","1","0.55","169","107","62","George R. ""Bob"" Woodruff"
"1960","Florida","9","2","0","0.81818","157","86","71","Ray Graves"
"1961","Florida","4","5","1","0.45","97","146","-49","Ray Graves"
"1962","Florida","7","4","0","0.63636","221","139","82","Ray Graves"
"1963","Florida","6","3","1","0.65","130","120","10","Ray Graves"
"1964","Florida","7","3","0","0.7","181","98","83","Ray Graves"
"1965","Florida","7","4","0","0.63636","239","149","90","Ray Graves"
"1966","Florida","9","2","0","0.81818","265","147","118","Ray Graves"
"1967","Florida","6","4","0","0.6","201","161","40","Ray Graves"
"1968","Florida","6","3","1","0.65","151","175","-24","Ray Graves"
"1969","Florida","9","1","1","0.86364","343","200","143","Ray Graves"
"1970","Florida","7","4","0","0.63636","224","256","-32","Doug Dickey"
"1971","Florida","4","7","0","0.36364","174","298","-124","Doug Dickey"
"1972","Florida","5","5","1","0.5","218","144","74","Doug Dickey"
"1973","Florida","7","5","0","0.58333","187","187","0","Doug Dickey"
"1974","Florida","8","4","0","0.66667","261","197","64","Doug Dickey"
"1975","Florida","9","3","0","0.75","302","117","185","Doug Dickey"
"1976","Florida","8","4","0","0.66667","328","292","36","Doug Dickey"
"1977","Florida","6","4","1","0.59091","251","235","16","Doug Dickey"
"1978","Florida","4","7","0","0.36364","249","223","26","Doug Dickey"
"1979","Florida","0","10","1","0.04545","106","265","-159","Charley Pell"
"1980","Florida","8","4","0","0.66667","256","186","70","Charley Pell"
"1981","Florida","7","5","0","0.58333","284","166","118","Charley Pell"
"1982","Florida","8","4","0","0.66667","296","228","68","Charley Pell"
"1983","Florida","9","2","1","0.79167","304","156","148","Charley Pell"
"1984","Florida","1","1","1","0.5","104","74","30","Charley Pell"
"1984","Florida","8","0","0","1","237","96","141","Galen Hall"
"1985","Florida","9","1","1","0.86364","286","162","124","Galen Hall"
"1986","Florida","6","5","0","0.54545","223","173","50","Galen Hall"
"1987","Florida","6","6","0","0.5","299","178","121","Galen Hall"
"1988","Florida","7","5","0","0.58333","268","185","83","Galen Hall"
"1989","Florida","4","1","0","0.8","128","57","71","Galen Hall"
"1989","Florida","3","4","0","0.42857","140","145","-5","Gary Darnell"
"1990","Florida","9","2","0","0.81818","387","171","216","Steve Spurrier"
"1991","Florida","10","2","0","0.83333","389","191","198","Steve Spurrier"
"1992","Florida","9","4","0","0.69231","315","284","31","Steve Spurrier"
"1993","Florida","11","2","0","0.84615","513","244","269","Steve Spurrier"
"1994","Florida","10","2","1","0.80769","538","228","310","Steve Spurrier"
"1995","Florida","12","1","0","0.92308","558","263","295","Steve Spurrier"
"1996","Florida","12","1","0","0.92308","611","221","390","Steve Spurrier"
"1997","Florida","10","2","0","0.83333","430","205","225","Steve Spurrier"
"1998","Florida","10","2","0","0.83333","380","165","215","Steve Spurrier"
"1999","Florida","9","4","0","0.69231","403","272","131","Steve Spurrier"
"2000","Florida","10","3","0","0.76923","468","273","195","Steve Spurrier"
"2001","Florida","10","2","0","0.83333","538","178","360","Steve Spurrier"
"2002","Florida","8","5","0","0.61538","336","279","57","Ron Zook"
"2003","Florida","8","5","0","0.61538","390","271","119","Ron Zook"
"2004","Florida","7","4","0","0.63636","372","226","146","Ron Zook"
"2004","Florida","0","1","0","0","10","27","-17","Charlie Strong"
"2005","Florida","9","3","0","0.75","343","226","117","Urban Meyer"
"2006","Florida","13","1","0","0.92857","416","189","227","Urban Meyer"
"2007","Florida","9","4","0","0.69231","552","331","221","Urban Meyer"
"2008","Florida","13","1","0","0.92857","611","181","430","Urban Meyer"
"2009","Florida","13","1","0","0.92857","502","174","328","Urban Meyer"
"2010","Florida","8","5","0","0.61538","388","277","111","Urban Meyer"
"2011","Florida","7","6","0","0.53846","331","264","67","Will Muschamp"
"2012","Florida","11","2","0","0.84615","344","188","156","Will Muschamp"
"2013","Florida","4","8","0","0.33333","226","253","-27","Will Muschamp"
"2014","Florida","6","5","0","0.54545","335","233","102","Will Muschamp"
"2014","Florida","1","0","0","1","28","20","8","D.J. Durkin"
"2001","Florida Atlantic","4","6","0","0.4","177","245","-68","Howard Schnellenberger"
"2002","Florida Atlantic","2","9","0","0.18182","176","339","-163","Howard Schnellenberger"
"2003","Florida Atlantic","11","3","0","0.78571","404","306","98","Howard Schnellenberger"
"2004","Florida Atlantic","9","3","0","0.75","299","207","92","Howard Schnellenberger"
"2005","Florida Atlantic","2","9","0","0.18182","148","339","-191","Howard Schnellenberger"
"2006","Florida Atlantic","5","7","0","0.41667","181","299","-118","Howard Schnellenberger"
"2007","Florida Atlantic","8","5","0","0.61538","405","432","-27","Howard Schnellenberger"
"2008","Florida Atlantic","7","6","0","0.53846","326","373","-47","Howard Schnellenberger"
"2009","Florida Atlantic","5","7","0","0.41667","329","405","-76","Howard Schnellenberger"
"2010","Florida Atlantic","4","8","0","0.33333","202","351","-149","Howard Schnellenberger"
"2011","Florida Atlantic","1","11","0","0.08333","155","416","-261","Howard Schnellenberger"
"2013","Florida Atlantic","4","0","0","1","151","40","111","Brian Wright"
"2012","Florida Atlantic","3","9","0","0.25","246","370","-124","Carl Pelini"
"2013","Florida Atlantic","2","6","0","0.25","166","227","-61","Carl Pelini"
"2014","Florida Atlantic","3","9","0","0.25","288","413","-125","Charlie Partridge"
"2002","Florida International","5","6","0","0.45455","241","228","13","Don Strock"
"2003","Florida International","2","10","0","0.16667","270","341","-71","Don Strock"
"2004","Florida International","3","7","0","0.3","261","325","-64","Don Strock"
"2005","Florida International","5","6","0","0.45455","257","323","-66","Don Strock"
"2006","Florida International","0","12","0","0","115","313","-198","Don Strock"
"2007","Florida International","1","11","0","0.08333","181","469","-288","Mario Cristobal"
"2008","Florida International","5","7","0","0.41667","296","340","-44","Mario Cristobal"
"2009","Florida International","3","9","0","0.25","275","424","-149","Mario Cristobal"
"2010","Florida International","7","6","0","0.53846","374","355","19","Mario Cristobal"
"2011","Florida International","8","5","0","0.61538","325","253","72","Mario Cristobal"
"2012","Florida International","3","9","0","0.25","300","380","-80","Mario Cristobal"
"2013","Florida International","1","11","0","0.08333","117","444","-327","Ron Turner"
"2014","Florida International","4","8","0","0.33333","276","298","-22","Ron Turner"
"1947","Florida St.","0","5","0","0","18","90","-72","Ed Williamson"
"1948","Florida St.","7","1","0","0.875","152","64","88","Donald A. ""Don"" Veller"
"1949","Florida St.","9","1","0","0.9","291","59","232","Donald A. ""Don"" Veller"
"1950","Florida St.","8","0","0","1","219","54","165","Donald A. ""Don"" Veller"
"1951","Florida St.","6","2","0","0.75","194","72","122","Donald A. ""Don"" Veller"
"1952","Florida St.","1","8","1","0.15","101","261","-160","Donald A. ""Don"" Veller"
"1953","Florida St.","5","5","0","0.5","183","146","37","Thomas N. ""Tom"" Nugent"
"1954","Florida St.","8","4","0","0.66667","277","190","87","Thomas N. ""Tom"" Nugent"
"1955","Florida St.","5","5","0","0.5","147","186","-39","Thomas N. ""Tom"" Nugent"
"1956","Florida St.","5","4","1","0.55","178","116","62","Thomas N. ""Tom"" Nugent"
"1957","Florida St.","4","6","0","0.4","136","165","-29","Thomas N. ""Tom"" Nugent"
"1958","Florida St.","7","4","0","0.63636","218","124","94","Thomas N. ""Tom"" Nugent"
"1959","Florida St.","4","6","0","0.4","149","132","17","Perry L. Moss"
"1960","Florida St.","3","6","1","0.35","111","136","-25","Bill Peterson"
"1961","Florida St.","4","5","1","0.45","93","128","-35","Bill Peterson"
"1962","Florida St.","4","3","3","0.55","170","69","101","Bill Peterson"
"1963","Florida St.","4","5","1","0.45","167","93","74","Bill Peterson"
"1964","Florida St.","9","1","1","0.86364","263","85","178","Bill Peterson"
"1965","Florida St.","4","5","1","0.45","121","119","2","Bill Peterson"
"1966","Florida St.","6","5","0","0.54545","274","215","59","Bill Peterson"
"1967","Florida St.","7","2","2","0.72727","250","187","63","Bill Peterson"
"1968","Florida St.","8","3","0","0.72727","308","211","97","Bill Peterson"
"1969","Florida St.","6","3","1","0.65","220","182","38","Bill Peterson"
"1970","Florida St.","7","4","0","0.63636","254","195","59","Bill Peterson"
"1971","Florida St.","8","4","0","0.66667","309","174","135","Larry Jones"
"1972","Florida St.","7","4","0","0.63636","287","224","63","Larry Jones"
"1973","Florida St.","0","11","0","0","98","331","-233","Larry Jones"
"1974","Florida St.","1","10","0","0.09091","130","289","-159","Darrell ""Dan"" Mudra"
"1975","Florida St.","3","8","0","0.27273","187","213","-26","Darrell ""Dan"" Mudra"
"1976","Florida St.","5","6","0","0.45455","205","258","-53","Bobby Bowden"
"1977","Florida St.","10","2","0","0.83333","314","170","144","Bobby Bowden"
"1978","Florida St.","8","3","0","0.72727","312","208","104","Bobby Bowden"
"1979","Florida St.","11","1","0","0.91667","326","160","166","Bobby Bowden"
"1980","Florida St.","10","2","0","0.83333","369","103","266","Bobby Bowden"
"1981","Florida St.","6","5","0","0.54545","240","286","-46","Bobby Bowden"
"1982","Florida St.","9","3","0","0.75","419","254","165","Bobby Bowden"
"1983","Florida St.","8","4","0","0.66667","381","312","69","Bobby Bowden"
"1984","Florida St.","7","3","2","0.66667","406","254","152","Bobby Bowden"
"1985","Florida St.","9","3","0","0.75","402","258","144","Bobby Bowden"
"1986","Florida St.","7","4","1","0.625","393","218","175","Bobby Bowden"
"1987","Florida St.","11","1","0","0.91667","481","163","318","Bobby Bowden"
"1988","Florida St.","11","1","0","0.91667","455","172","283","Bobby Bowden"
"1989","Florida St.","10","2","0","0.83333","424","199","225","Bobby Bowden"
"1990","Florida St.","10","2","0","0.83333","459","206","253","Bobby Bowden"
"1991","Florida St.","11","2","0","0.84615","449","188","261","Bobby Bowden"
"1992","Florida St.","11","1","0","0.91667","446","186","260","Bobby Bowden"
"1993","Florida St.","12","1","0","0.92308","536","129","407","Bobby Bowden"
"1994","Florida St.","10","1","1","0.875","428","200","228","Bobby Bowden"
"1995","Florida St.","10","2","0","0.83333","563","246","317","Bobby Bowden"
"1996","Florida St.","11","1","0","0.91667","446","174","272","Bobby Bowden"
"1997","Florida St.","11","1","0","0.91667","468","181","287","Bobby Bowden"
"1998","Florida St.","11","2","0","0.84615","401","161","240","Bobby Bowden"
"1999","Florida St.","12","0","0","1","458","203","255","Bobby Bowden"
"2000","Florida St.","11","2","0","0.84615","511","136","375","Bobby Bowden"
"2001","Florida St.","8","4","0","0.66667","403","304","99","Bobby Bowden"
"2002","Florida St.","9","5","0","0.64286","428","301","127","Bobby Bowden"
"2003","Florida St.","10","3","0","0.76923","419","217","202","Bobby Bowden"
"2004","Florida St.","9","3","0","0.75","302","169","133","Bobby Bowden"
"2005","Florida St.","8","5","0","0.61538","376","286","90","Bobby Bowden"
"2006","Florida St.","2","6","0","0.25","345","258","87","Bobby Bowden"
"2007","Florida St.","0","6","0","0","303","298","5","Bobby Bowden"
"2008","Florida St.","9","4","0","0.69231","434","262","172","Bobby Bowden"
"2009","Florida St.","7","6","0","0.53846","391","390","1","Bobby Bowden"
"2010","Florida St.","10","4","0","0.71429","439","275","164","Jimbo Fisher"
"2011","Florida St.","9","4","0","0.69231","398","196","202","Jimbo Fisher"
"2012","Florida St.","12","2","0","0.85714","550","206","344","Jimbo Fisher"
"2013","Florida St.","14","0","0","1","723","170","553","Jimbo Fisher"
"2014","Florida St.","13","1","0","0.92857","472","358","114","Jimbo Fisher"
"1921","Fresno St. (CA)","3","5","0","0.375","95","121","-26","Arthur Jones"
"1922","Fresno St. (CA)","7","1","2","0.8","126","29","97","Arthur Jones"
"1923","Fresno St. (CA)","7","2","0","0.77778","211","108","103","Arthur Jones"
"1924","Fresno St. (CA)","7","2","0","0.77778","132","44","88","Arthur Jones"
"1925","Fresno St. (CA)","2","6","1","0.27778","122","192","-70","Arthur Jones"
"1926","Fresno St. (CA)","5","3","1","0.61111","147","107","40","Arthur Jones"
"1927","Fresno St. (CA)","3","3","2","0.5","45","79","-34","Arthur Jones"
"1928","Fresno St. (CA)","2","5","1","0.3125","56","188","-132","Arthur Jones"
"1929","Fresno St. (CA)","1","7","0","0.125","40","250","-210","Stanley E. ""Stan"" Borleske"
"1930","Fresno St. (CA)","8","0","0","1","154","66","88","Stanley E. ""Stan"" Borleske"
"1931","Fresno St. (CA)","4","6","0","0.4","98","123","-25","Stanley E. ""Stan"" Borleske"
"1932","Fresno St. (CA)","3","5","2","0.4","56","91","-35","Stanley E. ""Stan"" Borleske"
"1933","Fresno St. (CA)","5","4","0","0.55556","98","71","27","Leo A. Harris"
"1934","Fresno St. (CA)","7","2","1","0.75","225","77","148","Leo A. Harris"
"1935","Fresno St. (CA)","6","3","0","0.66667","199","84","115","Leo A. Harris"
"1936","Fresno St. (CA)","5","3","1","0.61111","152","91","61","Jimmy Bradshaw"
"1937","Fresno St. (CA)","8","1","1","0.85","223","75","148","Jimmy Bradshaw"
"1938","Fresno St. (CA)","7","3","0","0.7","224","99","125","Jimmy Bradshaw"
"1939","Fresno St. (CA)","10","1","0","0.90909","244","98","146","Jimmy Bradshaw"
"1940","Fresno St. (CA)","9","2","1","0.79167","132","52","80","Jimmy Bradshaw"
"1941","Fresno St. (CA)","4","3","2","0.55556","118","90","28","Jimmy Bradshaw"
"1942","Fresno St. (CA)","9","1","0","0.9","362","45","317","Jimmy Bradshaw"
"1946","Fresno St. (CA)","8","4","0","0.66667","177","129","48","Jimmy Bradshaw"
"1944","Fresno St. (CA)","0","6","0","0","18","95","-77","Earl Wight"
"1945","Fresno St. (CA)","4","6","2","0.41667","113","92","21","Alvin Pierson"
"1949","Fresno St. (CA)","3","8","0","0.27273","156","344","-188","Alvin Pierson"
"1947","Fresno St. (CA)","3","6","2","0.36364","133","236","-103","Ken Gleason"
"1948","Fresno St. (CA)","3","6","1","0.35","108","267","-159","Ken Gleason"
"1950","Fresno St. (CA)","2","6","1","0.27778","131","231","-100","Duke Jacobs"
"1951","Fresno St. (CA)","5","5","0","0.5","199","189","10","Duke Jacobs"
"1952","Fresno St. (CA)","8","2","0","0.8","331","233","98","Clark Van Galder"
"1953","Fresno St. (CA)","4","4","2","0.5","255","198","57","Clark Van Galder"
"1954","Fresno St. (CA)","7","3","0","0.7","214","165","49","Clark Van Galder"
"1955","Fresno St. (CA)","9","1","0","0.9","273","110","163","Clark Van Galder"
"1956","Fresno St. (CA)","8","2","0","0.8","249","124","125","Clark Van Galder"
"1957","Fresno St. (CA)","5","5","0","0.5","164","183","-19","Clark Van Galder"
"1958","Fresno St. (CA)","5","5","0","0.5","147","206","-59","Clark Van Galder"
"1959","Fresno St. (CA)","7","3","0","0.7","226","146","80","Cecil Coleman"
"1960","Fresno St. (CA)","9","1","0","0.9","298","98","200","Cecil Coleman"
"1961","Fresno St. (CA)","10","0","0","1","292","125","167","Cecil Coleman"
"1962","Fresno St. (CA)","7","3","0","0.7","318","116","202","Cecil Coleman"
"1963","Fresno St. (CA)","4","6","0","0.4","208","242","-34","Cecil Coleman"
"1964","Fresno St. (CA)","4","6","0","0.4","212","204","8","Phil Krueger"
"1965","Fresno St. (CA)","6","4","0","0.6","191","116","75","Phil Krueger"
"1966","Fresno St. (CA)","7","3","0","0.7","158","214","-56","Darryl D. Rogers"
"1967","Fresno St. (CA)","3","8","0","0.27273","240","267","-27","Darryl D. Rogers"
"1968","Fresno St. (CA)","7","4","0","0.63636","269","226","43","Darryl D. Rogers"
"1969","Fresno St. (CA)","6","4","0","0.6","237","227","10","Darryl D. Rogers"
"1970","Fresno St. (CA)","8","4","0","0.66667","289","273","16","Darryl D. Rogers"
"1971","Fresno St. (CA)","6","5","0","0.54545","215","165","50","Darryl D. Rogers"
"1972","Fresno St. (CA)","6","4","1","0.59091","237","158","79","Darryl D. Rogers"
"1973","Fresno St. (CA)","2","9","0","0.18182","148","286","-138","J.R. Boone"
"1974","Fresno St. (CA)","5","7","0","0.41667","250","206","44","J.R. Boone"
"1975","Fresno St. (CA)","3","8","0","0.27273","219","274","-55","J.R. Boone"
"1976","Fresno St. (CA)","6","5","0","0.54545","237","165","72","Jim Sweeney"
"1977","Fresno St. (CA)","9","2","0","0.81818","354","163","191","Jim Sweeney"
"1980","Fresno St. (CA)","5","6","0","0.45455","192","245","-53","Jim Sweeney"
"1981","Fresno St. (CA)","5","6","0","0.45455","264","299","-35","Jim Sweeney"
"1982","Fresno St. (CA)","11","1","0","0.91667","381","228","153","Jim Sweeney"
"1983","Fresno St. (CA)","6","5","0","0.54545","242","214","28","Jim Sweeney"
"1984","Fresno St. (CA)","6","6","0","0.5","293","253","40","Jim Sweeney"
"1985","Fresno St. (CA)","11","0","1","0.95833","481","209","272","Jim Sweeney"
"1986","Fresno St. (CA)","9","2","0","0.81818","302","150","152","Jim Sweeney"
"1987","Fresno St. (CA)","6","5","0","0.54545","260","179","81","Jim Sweeney"
"1988","Fresno St. (CA)","10","2","0","0.83333","393","169","224","Jim Sweeney"
"1989","Fresno St. (CA)","11","1","0","0.91667","441","220","221","Jim Sweeney"
"1990","Fresno St. (CA)","8","2","1","0.77273","346","230","116","Jim Sweeney"
"1991","Fresno St. (CA)","10","2","0","0.83333","507","235","272","Jim Sweeney"
"1992","Fresno St. (CA)","9","4","0","0.69231","510","364","146","Jim Sweeney"
"1993","Fresno St. (CA)","8","4","0","0.66667","467","350","117","Jim Sweeney"
"1994","Fresno St. (CA)","5","7","1","0.42308","376","426","-50","Jim Sweeney"
"1995","Fresno St. (CA)","5","7","0","0.41667","371","387","-16","Jim Sweeney"
"1996","Fresno St. (CA)","4","7","0","0.36364","267","344","-77","Jim Sweeney"
"1978","Fresno St. (CA)","3","8","0","0.27273","247","329","-82","Bob Padilla"
"1979","Fresno St. (CA)","4","7","0","0.36364","245","302","-57","Bob Padilla"
"1997","Fresno St. (CA)","6","6","0","0.5","318","288","30","Pat Hill"
"1998","Fresno St. (CA)","5","6","0","0.45455","265","225","40","Pat Hill"
"1999","Fresno St. (CA)","8","5","0","0.61538","413","282","131","Pat Hill"
"2000","Fresno St. (CA)","7","5","0","0.58333","317","251","66","Pat Hill"
"2001","Fresno St. (CA)","11","3","0","0.78571","560","344","216","Pat Hill"
"2002","Fresno St. (CA)","9","5","0","0.64286","378","379","-1","Pat Hill"
"2003","Fresno St. (CA)","9","5","0","0.64286","322","317","5","Pat Hill"
"2004","Fresno St. (CA)","9","3","0","0.75","482","253","229","Pat Hill"
"2005","Fresno St. (CA)","8","5","0","0.61538","491","292","199","Pat Hill"
"2006","Fresno St. (CA)","4","8","0","0.33333","276","339","-63","Pat Hill"
"2007","Fresno St. (CA)","9","4","0","0.69231","427","351","76","Pat Hill"
"2008","Fresno St. (CA)","7","6","0","0.53846","385","404","-19","Pat Hill"
"2009","Fresno St. (CA)","8","5","0","0.61538","440","369","71","Pat Hill"
"2010","Fresno St. (CA)","8","5","0","0.61538","377","390","-13","Pat Hill"
"2011","Fresno St. (CA)","4","9","0","0.30769","371","457","-86","Pat Hill"
"2012","Fresno St. (CA)","9","4","0","0.69231","493","310","183","Tim DeRuyter"
"2013","Fresno St. (CA)","11","2","0","0.84615","564","394","170","Tim DeRuyter"
"2014","Fresno St. (CA)","6","8","0","0.42857","371","454","-83","Tim DeRuyter"
"1891","Georgia","1","1","0","0.5","50","10","40","Dr. Charles Herty"
"1893","Georgia","2","2","1","0.5","52","71","-19","Ernest Brown"
"1894","Georgia","5","1","0","0.83333","156","20","136","Robert ""Bobby"" Winston"
"1896","Georgia","4","0","0","1","86","22","64","Glenn Scobey ""Pop"" Warner"
"1897","Georgia","2","1","0","0.66667","56","17","39","Charles McCarthy"
"1898","Georgia","4","2","0","0.66667","70","70","0","Charles McCarthy"
"1899","Georgia","2","3","1","0.41667","44","22","22","Gordon Saussy"
"1900","Georgia","2","4","0","0.33333","28","159","-131","E.E. Jones"
"1901","Georgia","1","5","2","0.25","21","171","-150","William A. ""Billy"" Reynolds"
"1902","Georgia","4","2","1","0.64286","55","52","3","William A. ""Billy"" Reynolds"
"1903","Georgia","3","4","0","0.42857","65","98","-33","M.M. Dickinson"
"1905","Georgia","1","5","0","0.16667","26","188","-162","M.M. Dickinson"
"1904","Georgia","1","5","0","0.16667","69","68","1","Charles A. Barnard"
"1906","Georgia","2","4","1","0.35714","59","50","9","George S. Whitney"
"1907","Georgia","4","3","1","0.5625","103","47","56","George S. Whitney"
"1908","Georgia","5","2","1","0.6875","71","45","26","Branch Bocock"
"1909","Georgia","2","4","2","0.375","19","48","-29","J. Coulter"
"1910","Georgia","6","2","1","0.72222","281","52","229","William A. ""Bill"" Cunningham"
"1911","Georgia","7","1","1","0.83333","147","25","122","William A. ""Bill"" Cunningham"
"1912","Georgia","6","1","1","0.8125","151","80","71","William A. ""Bill"" Cunningham"
"1913","Georgia","6","2","0","0.75","243","55","188","William A. ""Bill"" Cunningham"
"1914","Georgia","3","5","1","0.38889","120","126","-6","William A. ""Bill"" Cunningham"
"1915","Georgia","5","2","2","0.66667","245","27","218","William A. ""Bill"" Cunningham"
"1916","Georgia","6","3","0","0.66667","121","58","63","William A. ""Bill"" Cunningham"
"1919","Georgia","4","2","3","0.61111","85","27","58","William A. ""Bill"" Cunningham"
"1920","Georgia","8","0","1","0.94444","250","17","233","Herman J. Stegeman"
"1921","Georgia","7","2","1","0.75","161","31","130","Herman J. Stegeman"
"1922","Georgia","5","4","1","0.55","178","77","101","Herman J. Stegeman"
"1923","Georgia","5","3","1","0.61111","74","120","-46","George C. ""Kid"" Woodruff"
"1924","Georgia","7","3","0","0.7","129","61","68","George C. ""Kid"" Woodruff"
"1925","Georgia","4","5","0","0.44444","133","91","42","George C. ""Kid"" Woodruff"
"1926","Georgia","5","4","0","0.55556","135","115","20","George C. ""Kid"" Woodruff"
"1927","Georgia","9","1","0","0.9","248","38","210","George C. ""Kid"" Woodruff"
"1928","Georgia","4","5","0","0.44444","122","113","9","Harry J. Mehre"
"1929","Georgia","6","4","0","0.6","155","97","58","Harry J. Mehre"
"1930","Georgia","7","2","1","0.75","185","71","114","Harry J. Mehre"
"1931","Georgia","8","2","0","0.8","201","118","83","Harry J. Mehre"
"1932","Georgia","2","5","2","0.33333","122","116","6","Harry J. Mehre"
"1933","Georgia","8","2","0","0.8","148","86","62","Harry J. Mehre"
"1934","Georgia","7","3","0","0.7","141","56","85","Harry J. Mehre"
"1935","Georgia","6","4","0","0.6","169","88","81","Harry J. Mehre"
"1936","Georgia","5","4","1","0.55","115","159","-44","Harry J. Mehre"
"1937","Georgia","6","3","2","0.63636","151","64","87","Harry J. Mehre"
"1938","Georgia","5","4","1","0.55","145","143","2","Joel Hunt"
"1939","Georgia","5","6","0","0.45455","113","98","15","Wallace Butts"
"1940","Georgia","5","4","1","0.55","209","134","75","Wallace Butts"
"1941","Georgia","9","1","1","0.86364","319","85","234","Wallace Butts"
"1942","Georgia","11","1","0","0.91667","376","76","300","Wallace Butts"
"1943","Georgia","6","4","0","0.6","264","153","111","Wallace Butts"
"1944","Georgia","7","3","0","0.7","273","130","143","Wallace Butts"
"1945","Georgia","9","2","0","0.81818","314","100","214","Wallace Butts"
"1946","Georgia","11","0","0","1","392","110","282","Wallace Butts"
"1947","Georgia","7","4","1","0.625","212","135","77","Wallace Butts"
"1948","Georgia","9","2","0","0.81818","306","141","165","Wallace Butts"
"1949","Georgia","4","6","1","0.40909","177","134","43","Wallace Butts"
"1950","Georgia","6","3","3","0.625","178","105","73","Wallace Butts"
"1951","Georgia","5","5","0","0.5","176","184","-8","Wallace Butts"
"1952","Georgia","7","4","0","0.63636","226","208","18","Wallace Butts"
"1953","Georgia","3","8","0","0.27273","155","250","-95","Wallace Butts"
"1954","Georgia","6","3","1","0.65","89","89","0","Wallace Butts"
"1955","Georgia","4","6","0","0.4","173","170","3","Wallace Butts"
"1956","Georgia","3","6","1","0.35","66","162","-96","Wallace Butts"
"1957","Georgia","3","7","0","0.3","93","150","-57","Wallace Butts"
"1958","Georgia","4","6","0","0.4","196","114","82","Wallace Butts"
"1959","Georgia","10","1","0","0.90909","228","89","139","Wallace Butts"
"1960","Georgia","6","4","0","0.6","174","118","56","Wallace Butts"
"1961","Georgia","3","7","0","0.3","84","177","-93","Johnny Griffith"
"1962","Georgia","3","4","3","0.45","109","174","-65","Johnny Griffith"
"1963","Georgia","4","5","1","0.45","133","151","-18","Johnny Griffith"
"1964","Georgia","7","3","1","0.68182","130","98","32","Vince Dooley"
"1965","Georgia","6","4","0","0.6","186","158","28","Vince Dooley"
"1966","Georgia","10","1","0","0.90909","235","98","137","Vince Dooley"
"1967","Georgia","7","4","0","0.63636","257","119","138","Vince Dooley"
"1968","Georgia","8","1","2","0.81818","284","114","170","Vince Dooley"
"1969","Georgia","5","5","1","0.5","218","146","72","Vince Dooley"
"1970","Georgia","5","5","0","0.5","242","153","89","Vince Dooley"
"1971","Georgia","11","1","0","0.91667","360","115","245","Vince Dooley"
"1972","Georgia","7","4","0","0.63636","174","163","11","Vince Dooley"
"1973","Georgia","7","4","1","0.625","224","166","58","Vince Dooley"
"1974","Georgia","6","6","0","0.5","327","285","42","Vince Dooley"
"1975","Georgia","9","3","0","0.75","299","197","102","Vince Dooley"
"1976","Georgia","10","2","0","0.83333","327","145","182","Vince Dooley"
"1977","Georgia","5","6","0","0.45455","157","191","-34","Vince Dooley"
"1978","Georgia","9","2","1","0.79167","290","187","103","Vince Dooley"
"1979","Georgia","6","5","0","0.54545","206","189","17","Vince Dooley"
"1980","Georgia","12","0","0","1","333","137","196","Vince Dooley"
"1981","Georgia","10","2","0","0.83333","372","122","250","Vince Dooley"
"1982","Georgia","11","1","0","0.91667","338","160","178","Vince Dooley"
"1983","Georgia","10","1","1","0.875","274","158","116","Vince Dooley"
"1984","Georgia","7","4","1","0.625","263","230","33","Vince Dooley"
"1985","Georgia","7","3","2","0.66667","297","171","126","Vince Dooley"
"1986","Georgia","8","4","0","0.66667","309","233","76","Vince Dooley"
"1987","Georgia","9","3","0","0.75","311","204","107","Vince Dooley"
"1988","Georgia","9","3","0","0.75","358","212","146","Vince Dooley"
"1989","Georgia","6","6","0","0.5","251","198","53","Ray Goff"
"1990","Georgia","4","7","0","0.36364","185","293","-108","Ray Goff"
"1991","Georgia","9","3","0","0.75","336","219","117","Ray Goff"
"1992","Georgia","10","2","0","0.83333","373","155","218","Ray Goff"
"1993","Georgia","5","6","0","0.45455","328","289","39","Ray Goff"
"1994","Georgia","6","4","1","0.59091","351","283","68","Ray Goff"
"1995","Georgia","6","6","0","0.5","260","281","-21","Ray Goff"
"1996","Georgia","5","6","0","0.45455","230","257","-27","Jim Donnan"
"1997","Georgia","10","2","0","0.83333","380","195","185","Jim Donnan"
"1998","Georgia","9","3","0","0.75","292","222","70","Jim Donnan"
"1999","Georgia","8","4","0","0.66667","336","310","26","Jim Donnan"
"2000","Georgia","8","4","0","0.66667","331","212","119","Jim Donnan"
"2001","Georgia","8","4","0","0.66667","331","228","103","Mark Richt"
"2002","Georgia","13","1","0","0.92857","450","212","238","Mark Richt"
"2003","Georgia","11","3","0","0.78571","371","203","168","Mark Richt"
"2004","Georgia","10","2","0","0.83333","335","198","137","Mark Richt"
"2005","Georgia","10","3","0","0.76923","384","213","171","Mark Richt"
"2006","Georgia","9","4","0","0.69231","327","229","98","Mark Richt"
"2007","Georgia","11","2","0","0.84615","424","262","162","Mark Richt"
"2008","Georgia","10","3","0","0.76923","409","319","90","Mark Richt"
"2009","Georgia","8","5","0","0.61538","376","337","39","Mark Richt"
"2010","Georgia","6","7","0","0.46154","417","287","130","Mark Richt"
"2011","Georgia","10","4","0","0.71429","448","288","160","Mark Richt"
"2012","Georgia","12","2","0","0.85714","529","275","254","Mark Richt"
"2013","Georgia","8","5","0","0.61538","477","377","100","Mark Richt"
"2014","Georgia","10","3","0","0.76923","537","269","268","Mark Richt"
"1924","Georgia Southern","1","3","0","0.25","6","80","-74","E.G. Cromartie"
"1925","Georgia Southern","1","3","0","0.25","12","59","-47","E.G. Cromartie"
"1926","Georgia Southern","5","3","1","0.61111","58","78","-20","E.G. Cromartie"
"1927","Georgia Southern","6","1","1","0.8125","90","42","48","H.A. Woodle"
"1928","Georgia Southern","5","5","0","0.5","61","60","1","H.A. Woodle"
"1929","Georgia Southern","3","3","2","0.5","102","44","58","B.L. ""Crook"" Smith"
"1930","Georgia Southern","3","4","1","0.4375","46","110","-64","B.L. ""Crook"" Smith"
"1931","Georgia Southern","3","6","0","0.33333","142","92","50","B.L. ""Crook"" Smith"
"1932","Georgia Southern","6","2","0","0.75","137","57","80","B.L. ""Crook"" Smith"
"1933","Georgia Southern","5","4","0","0.55556","167","75","92","B.L. ""Crook"" Smith"
"1934","Georgia Southern","4","6","0","0.4","114","129","-15","B.L. ""Crook"" Smith"
"1935","Georgia Southern","3","3","2","0.5","98","89","9","B.L. ""Crook"" Smith"
"1936","Georgia Southern","2","9","0","0.18182","45","230","-185","B.L. ""Crook"" Smith"
"1937","Georgia Southern","2","9","0","0.18182","58","272","-214","B.L. ""Crook"" Smith"
"1938","Georgia Southern","3","5","1","0.38889","35","100","-65","B.L. ""Crook"" Smith"
"1939","Georgia Southern","5","5","0","0.5","93","124","-31","B.L. ""Crook"" Smith"
"1940","Georgia Southern","3","5","0","0.375","91","184","-93","B.L. ""Crook"" Smith"
"1941","Georgia Southern","2","8","0","0.2","37","229","-192","B.L. ""Crook"" Smith"
"1982","Georgia Southern","7","3","1","0.68182","290","190","100","Erk Russell"
"1983","Georgia Southern","6","5","0","0.54545","262","197","65","Erk Russell"
"1984","Georgia Southern","8","3","0","0.72727","342","215","127","Erk Russell"
"1985","Georgia Southern","13","2","0","0.86667","460","293","167","Erk Russell"
"1986","Georgia Southern","13","2","0","0.86667","619","382","237","Erk Russell"
"1987","Georgia Southern","9","4","0","0.69231","283","220","63","Erk Russell"
"1988","Georgia Southern","12","3","0","0.8","469","214","255","Erk Russell"
"1989","Georgia Southern","15","0","0","1","584","221","363","Erk Russell"
"1990","Georgia Southern","12","3","0","0.8","436","272","164","Tim Stowers"
"1991","Georgia Southern","7","4","0","0.63636","257","160","97","Tim Stowers"
"1992","Georgia Southern","7","4","0","0.63636","177","151","26","Tim Stowers"
"1993","Georgia Southern","10","3","0","0.76923","357","200","157","Tim Stowers"
"1994","Georgia Southern","6","5","0","0.54545","330","270","60","Tim Stowers"
"1995","Georgia Southern","9","4","0","0.69231","294","237","57","Tim Stowers"
"1996","Georgia Southern","4","7","0","0.36364","255","295","-40","Frank Ellwood"
"1997","Georgia Southern","10","3","0","0.76923","423","229","194","Paul Johnson"
"1998","Georgia Southern","14","1","0","0.93333","654","363","291","Paul Johnson"
"1999","Georgia Southern","13","2","0","0.86667","747","262","485","Paul Johnson"
"2000","Georgia Southern","13","2","0","0.86667","506","274","232","Paul Johnson"
"2001","Georgia Southern","12","2","0","0.85714","525","215","310","Paul Johnson"
"2002","Georgia Southern","11","3","0","0.78571","493","190","303","Mike Sewak"
"2003","Georgia Southern","7","4","0","0.63636","311","232","79","Mike Sewak"
"2004","Georgia Southern","9","3","0","0.75","564","221","343","Mike Sewak"
"2005","Georgia Southern","8","4","0","0.66667","456","277","179","Mike Sewak"
"2006","Georgia Southern","3","8","0","0.27273","235","260","-25","Brian VanGorder"
"2007","Georgia Southern","7","4","0","0.63636","402","348","54","Chris Hatcher"
"2008","Georgia Southern","6","5","0","0.54545","350","326","24","Chris Hatcher"
"2009","Georgia Southern","5","6","0","0.45455","205","303","-98","Chris Hatcher"
"2010","Georgia Southern","10","5","0","0.66667","413","277","136","Jeff Monken"
"2011","Georgia Southern","11","3","0","0.78571","492","330","162","Jeff Monken"
"2012","Georgia Southern","10","4","0","0.71429","483","308","175","Jeff Monken"
"2013","Georgia Southern","7","4","0","0.63636","368","255","113","Jeff Monken"
"2014","Georgia Southern","9","3","0","0.75","469","281","188","Willie Fritz"
"2010","Georgia St.","6","5","0","0.54545","302","286","16","Bill Curry"
"2011","Georgia St.","3","8","0","0.27273","249","343","-94","Bill Curry"
"2012","Georgia St.","1","10","0","0.09091","191","424","-233","Bill Curry"
"2013","Georgia St.","0","12","0","0","225","440","-215","Trent Miles"
"2014","Georgia St.","1","11","0","0.08333","272","520","-248","Trent Miles"
"1892","Georgia Tech","0","3","0","0","16","58","-42","Ernest E. West"
"1893","Georgia Tech","2","1","1","0.625","38","18","20","Frank O. Spain & Lt. Leonard Wood"
"1894","Georgia Tech","0","3","0","0","0","136","-136","Frank O. Spain & Lt. Leonard Wood"
"1898","Georgia Tech","0","3","0","0","6","67","-61","R.B. ""Cow"" Nalley"
"1899","Georgia Tech","0","5","0","0","5","184","-179","Mr. Collier"
"1901","Georgia Tech","4","0","1","0.9","97","5","92","Dr. Cyrus W. Strickler"
"1902","Georgia Tech","0","6","2","0.125","23","122","-99","Dr. John McKee"
"1904","Georgia Tech","8","1","1","0.85","287","34","253","John W. Heisman"
"1905","Georgia Tech","7","0","1","0.9375","233","33","200","John W. Heisman"
"1906","Georgia Tech","6","3","1","0.65","140","69","71","John W. Heisman"
"1907","Georgia Tech","4","4","0","0.5","148","100","48","John W. Heisman"
"1908","Georgia Tech","6","3","0","0.66667","147","74","73","John W. Heisman"
"1909","Georgia Tech","7","2","0","0.77778","217","44","173","John W. Heisman"
"1910","Georgia Tech","5","3","0","0.625","197","50","147","John W. Heisman"
"1911","Georgia Tech","6","2","1","0.72222","150","21","129","John W. Heisman"
"1912","Georgia Tech","5","3","1","0.61111","100","86","14","John W. Heisman"
"1913","Georgia Tech","7","2","0","0.77778","250","43","207","John W. Heisman"
"1914","Georgia Tech","6","2","0","0.75","206","40","166","John W. Heisman"
"1915","Georgia Tech","7","0","1","0.9375","233","24","209","John W. Heisman"
"1916","Georgia Tech","8","0","1","0.94444","421","20","401","John W. Heisman"
"1917","Georgia Tech","9","0","0","1","491","17","474","John W. Heisman"
"1918","Georgia Tech","6","1","0","0.85714","466","32","434","John W. Heisman"
"1919","Georgia Tech","7","3","0","0.7","256","33","223","John W. Heisman"
"1920","Georgia Tech","8","1","0","0.88889","312","16","296","William A. ""Bill"" Alexander"
"1921","Georgia Tech","8","1","0","0.88889","360","56","304","William A. ""Bill"" Alexander"
"1922","Georgia Tech","7","2","0","0.77778","157","59","98","William A. ""Bill"" Alexander"
"1923","Georgia Tech","3","2","4","0.55556","75","82","-7","William A. ""Bill"" Alexander"
"1924","Georgia Tech","5","3","1","0.61111","82","78","4","William A. ""Bill"" Alexander"
"1925","Georgia Tech","6","2","1","0.72222","102","48","54","William A. ""Bill"" Alexander"
"1926","Georgia Tech","4","5","0","0.44444","87","87","0","William A. ""Bill"" Alexander"
"1927","Georgia Tech","8","1","1","0.85","125","39","86","William A. ""Bill"" Alexander"
"1928","Georgia Tech","10","0","0","1","221","47","174","William A. ""Bill"" Alexander"
"1929","Georgia Tech","3","6","0","0.33333","105","138","-33","William A. ""Bill"" Alexander"
"1930","Georgia Tech","2","6","1","0.27778","79","185","-106","William A. ""Bill"" Alexander"
"1931","Georgia Tech","2","7","1","0.25","98","207","-109","William A. ""Bill"" Alexander"
"1932","Georgia Tech","4","5","1","0.45","114","105","9","William A. ""Bill"" Alexander"
"1933","Georgia Tech","5","5","0","0.5","117","63","54","William A. ""Bill"" Alexander"
"1934","Georgia Tech","1","9","0","0.1","56","187","-131","William A. ""Bill"" Alexander"
"1935","Georgia Tech","5","5","0","0.5","163","142","21","William A. ""Bill"" Alexander"
"1936","Georgia Tech","5","5","1","0.5","251","103","148","William A. ""Bill"" Alexander"
"1937","Georgia Tech","6","3","1","0.65","177","54","123","William A. ""Bill"" Alexander"
"1938","Georgia Tech","3","4","3","0.45","72","84","-12","William A. ""Bill"" Alexander"
"1939","Georgia Tech","8","2","0","0.8","150","56","94","William A. ""Bill"" Alexander"
"1940","Georgia Tech","3","7","0","0.3","139","160","-21","William A. ""Bill"" Alexander"
"1941","Georgia Tech","3","6","0","0.33333","82","130","-48","William A. ""Bill"" Alexander"
"1942","Georgia Tech","9","2","0","0.81818","219","87","132","William A. ""Bill"" Alexander"
"1943","Georgia Tech","8","3","0","0.72727","300","142","158","William A. ""Bill"" Alexander"
"1944","Georgia Tech","8","3","0","0.72727","253","101","152","William A. ""Bill"" Alexander"
"1945","Georgia Tech","4","6","0","0.4","157","165","-8","Robert L. ""Bobby"" Dodd"
"1946","Georgia Tech","9","2","0","0.81818","284","127","157","Robert L. ""Bobby"" Dodd"
"1947","Georgia Tech","10","1","0","0.90909","240","49","191","Robert L. ""Bobby"" Dodd"
"1948","Georgia Tech","7","3","0","0.7","226","69","157","Robert L. ""Bobby"" Dodd"
"1949","Georgia Tech","7","3","0","0.7","197","129","68","Robert L. ""Bobby"" Dodd"
"1950","Georgia Tech","5","6","0","0.45455","182","193","-11","Robert L. ""Bobby"" Dodd"
"1951","Georgia Tech","11","0","1","0.95833","295","90","205","Robert L. ""Bobby"" Dodd"
"1952","Georgia Tech","12","0","0","1","325","59","266","Robert L. ""Bobby"" Dodd"
"1953","Georgia Tech","9","2","1","0.79167","288","111","177","Robert L. ""Bobby"" Dodd"
"1954","Georgia Tech","8","3","0","0.72727","189","97","92","Robert L. ""Bobby"" Dodd"
"1955","Georgia Tech","9","1","1","0.86364","189","46","143","Robert L. ""Bobby"" Dodd"
"1956","Georgia Tech","10","1","0","0.90909","248","47","201","Robert L. ""Bobby"" Dodd"
"1957","Georgia Tech","4","4","2","0.5","75","71","4","Robert L. ""Bobby"" Dodd"
"1958","Georgia Tech","5","4","1","0.55","93","91","2","Robert L. ""Bobby"" Dodd"
"1959","Georgia Tech","6","5","0","0.54545","136","121","15","Robert L. ""Bobby"" Dodd"
"1960","Georgia Tech","5","5","0","0.5","118","97","21","Robert L. ""Bobby"" Dodd"
"1961","Georgia Tech","7","4","0","0.63636","177","80","97","Robert L. ""Bobby"" Dodd"
"1962","Georgia Tech","7","3","1","0.68182","211","97","114","Robert L. ""Bobby"" Dodd"
"1963","Georgia Tech","7","3","0","0.7","173","89","84","Robert L. ""Bobby"" Dodd"
"1964","Georgia Tech","7","3","0","0.7","121","79","42","Robert L. ""Bobby"" Dodd"
"1965","Georgia Tech","7","3","1","0.68182","253","171","82","Robert L. ""Bobby"" Dodd"
"1966","Georgia Tech","9","2","0","0.81818","260","108","152","Robert L. ""Bobby"" Dodd"
"1967","Georgia Tech","4","6","0","0.4","129","205","-76","Bud Carson"
"1968","Georgia Tech","4","6","0","0.4","158","263","-105","Bud Carson"
"1969","Georgia Tech","4","6","0","0.4","144","183","-39","Bud Carson"
"1970","Georgia Tech","9","3","0","0.75","233","165","68","Bud Carson"
"1971","Georgia Tech","6","6","0","0.5","207","207","0","Bud Carson"
"1972","Georgia Tech","7","4","1","0.625","284","226","58","Bill Fulcher"
"1973","Georgia Tech","5","6","0","0.45455","192","211","-19","Bill Fulcher"
"1974","Georgia Tech","6","5","0","0.54545","238","212","26","Pepper Rodgers"
"1975","Georgia Tech","7","4","0","0.63636","270","200","70","Pepper Rodgers"
"1976","Georgia Tech","4","6","1","0.40909","221","267","-46","Pepper Rodgers"
"1977","Georgia Tech","6","5","0","0.54545","224","221","3","Pepper Rodgers"
"1978","Georgia Tech","7","5","0","0.58333","270","253","17","Pepper Rodgers"
"1979","Georgia Tech","4","6","1","0.40909","152","190","-38","Pepper Rodgers"
"1980","Georgia Tech","1","9","1","0.13636","113","260","-147","Bill Curry"
"1981","Georgia Tech","1","10","0","0.09091","124","309","-185","Bill Curry"
"1982","Georgia Tech","6","5","0","0.54545","239","286","-47","Bill Curry"
"1983","Georgia Tech","3","8","0","0.27273","222","313","-91","Bill Curry"
"1984","Georgia Tech","6","4","1","0.59091","296","201","95","Bill Curry"
"1985","Georgia Tech","9","2","1","0.79167","252","132","120","Bill Curry"
"1986","Georgia Tech","5","5","1","0.5","282","211","71","Bill Curry"
"1987","Georgia Tech","2","9","0","0.18182","199","275","-76","Bobby Ross"
"1988","Georgia Tech","3","8","0","0.27273","200","194","6","Bobby Ross"
"1989","Georgia Tech","7","4","0","0.63636","265","213","52","Bobby Ross"
"1990","Georgia Tech","11","0","1","0.95833","379","186","193","Bobby Ross"
"1991","Georgia Tech","8","5","0","0.61538","283","214","69","Bobby Ross"
"1992","Georgia Tech","5","6","0","0.45455","237","286","-49","Bill Lewis"
"1993","Georgia Tech","5","6","0","0.45455","260","286","-26","Bill Lewis"
"1994","Georgia Tech","1","7","0","0.125","152","231","-79","Bill Lewis"
"1994","Georgia Tech","0","3","0","0","33","88","-55","George O'Leary"
"1995","Georgia Tech","6","5","0","0.54545","260","243","17","George O'Leary"
"1996","Georgia Tech","5","6","0","0.45455","220","236","-16","George O'Leary"
"1997","Georgia Tech","7","5","0","0.58333","314","296","18","George O'Leary"
"1998","Georgia Tech","10","2","0","0.83333","426","295","131","George O'Leary"
"1999","Georgia Tech","8","4","0","0.66667","461","361","100","George O'Leary"
"2000","Georgia Tech","9","3","0","0.75","386","237","149","George O'Leary"
"2001","Georgia Tech","7","5","0","0.58333","381","267","114","George O'Leary"
"2001","Georgia Tech","1","0","0","1","24","14","10","Mac McWorter"
"2002","Georgia Tech","7","6","0","0.53846","280","267","13","Chan Gailey"
"2003","Georgia Tech","7","6","0","0.53846","274","266","8","Chan Gailey"
"2004","Georgia Tech","7","5","0","0.58333","264","227","37","Chan Gailey"
"2005","Georgia Tech","7","5","0","0.58333","222","241","-19","Chan Gailey"
"2006","Georgia Tech","9","5","0","0.64286","349","257","92","Chan Gailey"
"2007","Georgia Tech","7","5","0","0.58333","313","231","82","Chan Gailey"
"2007","Georgia Tech","0","1","0","0","28","40","-12","Jon Tenuta"
"2008","Georgia Tech","9","4","0","0.69231","317","264","53","Paul Johnson"
"2009","Georgia Tech","10","3","0","0.76923","473","347","126","Paul Johnson"
"2010","Georgia Tech","6","7","0","0.46154","338","328","10","Paul Johnson"
"2011","Georgia Tech","8","5","0","0.61538","446","339","107","Paul Johnson"
"2012","Georgia Tech","7","7","0","0.5","470","396","74","Paul Johnson"
"2013","Georgia Tech","7","6","0","0.53846","456","297","159","Paul Johnson"
"2014","Georgia Tech","11","3","0","0.78571","530","360","170","Paul Johnson"
"1909","Hawaii","2","2","0","0.5","16","39","-23","Austin Jones"
"1910","Hawaii","4","2","0","0.66667","79","16","63","Austin Jones"
"1911","Hawaii","2","2","0","0.5","32","49","-17","Austin Jones"
"1915","Hawaii","5","1","1","0.78571","121","36","85","John Peden"
"1916","Hawaii","3","2","1","0.58333","79","41","38","William Hamilton Britton"
"1917","Hawaii","4","0","1","0.9","88","6","82","Dave Crawford"
"1918","Hawaii","3","1","0","0.75","62","47","15","Dave Crawford"
"1919","Hawaii","4","0","1","0.9","138","21","117","Dave Crawford"
"1920","Hawaii","6","2","0","0.75","158","31","127","Raymond Elliot"
"1921","Hawaii","3","3","2","0.5","67","114","-47","Otto ""Proc"" Klum"
"1922","Hawaii","5","1","1","0.78571","216","25","191","Otto ""Proc"" Klum"
"1923","Hawaii","5","1","2","0.75","172","52","120","Otto ""Proc"" Klum"
"1924","Hawaii","8","0","0","1","185","12","173","Otto ""Proc"" Klum"
"1925","Hawaii","10","0","0","1","421","17","404","Otto ""Proc"" Klum"
"1926","Hawaii","5","4","0","0.55556","311","62","249","Otto ""Proc"" Klum"
"1927","Hawaii","5","2","0","0.71429","109","61","48","Otto ""Proc"" Klum"
"1928","Hawaii","2","5","0","0.28571","121","109","12","Otto ""Proc"" Klum"
"1929","Hawaii","4","3","0","0.57143","88","66","22","Otto ""Proc"" Klum"
"1930","Hawaii","5","2","0","0.71429","145","85","60","Otto ""Proc"" Klum"
"1931","Hawaii","3","2","1","0.58333","76","66","10","Otto ""Proc"" Klum"
"1932","Hawaii","2","1","1","0.625","32","28","4","Otto ""Proc"" Klum"
"1933","Hawaii","4","3","0","0.57143","73","86","-13","Otto ""Proc"" Klum"
"1934","Hawaii","6","0","0","1","142","21","121","Otto ""Proc"" Klum"
"1935","Hawaii","5","3","0","0.625","127","105","22","Otto ""Proc"" Klum"
"1936","Hawaii","3","5","0","0.375","82","109","-27","Otto ""Proc"" Klum"
"1937","Hawaii","2","6","0","0.25","85","199","-114","Otto ""Proc"" Klum"
"1938","Hawaii","4","4","0","0.5","128","113","15","Otto ""Proc"" Klum"
"1939","Hawaii","3","6","0","0.33333","107","167","-60","Otto ""Proc"" Klum"
"1940","Hawaii","2","5","0","0.28571","115","137","-22","Eugene ""Luke"" Gill"
"1941","Hawaii","8","1","0","0.88889","193","83","110","Eugene ""Luke"" Gill & Tom Kaulukukui"
"1946","Hawaii","8","2","0","0.8","275","93","182","Tom Kaulukukui"
"1947","Hawaii","8","5","0","0.61538","294","240","54","Tom Kaulukukui"
"1948","Hawaii","7","4","1","0.625","366","289","77","Tom Kaulukukui"
"1949","Hawaii","6","3","0","0.66667","362","210","152","Tom Kaulukukui"
"1950","Hawaii","5","4","2","0.54545","290","256","34","Tom Kaulukukui"
"1951","Hawaii","4","7","0","0.36364","226","292","-66","Archie Kodros"
"1952","Hawaii","5","5","2","0.5","285","280","5","Hank Vasconcellos"
"1953","Hawaii","5","6","0","0.45455","189","216","-27","Hank Vasconcellos"
"1954","Hawaii","4","4","0","0.5","133","178","-45","Hank Vasconcellos"
"1955","Hawaii","8","3","0","0.72727","187","166","21","Hank Vasconcellos"
"1956","Hawaii","7","3","0","0.7","291","113","178","Hank Vasconcellos"
"1957","Hawaii","4","4","1","0.5","152","96","56","Hank Vasconcellos"
"1958","Hawaii","5","7","0","0.41667","139","260","-121","Hank Vasconcellos"
"1959","Hawaii","3","6","0","0.33333","100","174","-74","Hank Vasconcellos"
"1960","Hawaii","3","7","0","0.3","113","200","-87","Hank Vasconcellos"
"1961","Hawaii","5","3","1","0.61111","184","111","73","Ching Do Kim"
"1962","Hawaii","6","2","0","0.75","112","63","49","Jim Asato"
"1963","Hawaii","5","5","0","0.5","160","167","-7","Jim Asato"
"1964","Hawaii","4","5","0","0.44444","104","131","-27","Jim Asato"
"1965","Hawaii","1","8","1","0.15","85","227","-142","Clark D. Shaughnessy"
"1966","Hawaii","4","6","0","0.4","110","245","-135","Phillip J. ""Phil"" Sarboe"
"1967","Hawaii","6","4","0","0.6","205","118","87","Don King"
"1968","Hawaii","7","3","0","0.7","312","199","113","Dave Holmes"
"1969","Hawaii","6","3","1","0.65","313","235","78","Dave Holmes"
"1970","Hawaii","9","2","0","0.81818","286","149","137","Dave Holmes"
"1971","Hawaii","7","4","0","0.63636","255","225","30","Dave Holmes"
"1972","Hawaii","8","3","0","0.72727","282","214","68","Dave Holmes"
"1973","Hawaii","9","2","0","0.81818","205","152","53","Dave Holmes"
"1974","Hawaii","6","5","0","0.54545","175","211","-36","Larry Price"
"1975","Hawaii","6","5","0","0.54545","180","201","-21","Larry Price"
"1976","Hawaii","3","8","0","0.27273","154","377","-223","Larry Price"
"1977","Hawaii","5","6","0","0.45455","250","233","17","Dick Tomey"
"1978","Hawaii","6","5","0","0.54545","251","280","-29","Dick Tomey"
"1979","Hawaii","6","5","0","0.54545","330","213","117","Dick Tomey"
"1980","Hawaii","8","3","0","0.72727","260","212","48","Dick Tomey"
"1981","Hawaii","9","2","0","0.81818","328","130","198","Dick Tomey"
"1982","Hawaii","6","5","0","0.54545","240","230","10","Dick Tomey"
"1983","Hawaii","5","5","1","0.5","251","236","15","Dick Tomey"
"1984","Hawaii","7","4","0","0.63636","217","181","36","Dick Tomey"
"1985","Hawaii","4","6","2","0.41667","269","262","7","Dick Tomey"
"1986","Hawaii","7","5","0","0.58333","238","235","3","Dick Tomey"
"1987","Hawaii","5","7","0","0.41667","337","299","38","Bob Wagner"
"1988","Hawaii","9","3","0","0.75","383","283","100","Bob Wagner"
"1989","Hawaii","9","3","1","0.73077","470","281","189","Bob Wagner"
"1990","Hawaii","7","5","0","0.58333","374","257","117","Bob Wagner"
"1991","Hawaii","4","7","1","0.375","335","388","-53","Bob Wagner"
"1992","Hawaii","11","2","0","0.84615","421","317","104","Bob Wagner"
"1993","Hawaii","6","6","0","0.5","393","357","36","Bob Wagner"
"1994","Hawaii","3","8","1","0.29167","260","273","-13","Bob Wagner"
"1995","Hawaii","4","8","0","0.33333","285","401","-116","Bob Wagner"
"1996","Hawaii","2","10","0","0.16667","161","433","-272","Fred vonAppen"
"1997","Hawaii","3","9","0","0.25","189","308","-119","Fred vonAppen"
"1998","Hawaii","0","12","0","0","149","422","-273","Fred vonAppen"
"1999","Hawaii","9","4","0","0.69231","371","349","22","June Jones"
"2000","Hawaii","3","9","0","0.25","294","399","-105","June Jones"
"2001","Hawaii","9","3","0","0.75","483","318","165","June Jones"
"2002","Hawaii","10","4","0","0.71429","502","389","113","June Jones"
"2003","Hawaii","9","5","0","0.64286","486","427","59","June Jones"
"2004","Hawaii","8","5","0","0.61538","467","499","-32","June Jones"
"2005","Hawaii","5","7","0","0.41667","368","428","-60","June Jones"
"2006","Hawaii","11","3","0","0.78571","656","337","319","June Jones"
"2007","Hawaii","12","1","0","0.92308","564","331","233","June Jones"
"2008","Hawaii","7","7","0","0.5","345","404","-59","Greg McMackin"
"2009","Hawaii","6","7","0","0.46154","296","383","-87","Greg McMackin"
"2010","Hawaii","10","4","0","0.71429","554","357","197","Greg McMackin"
"2011","Hawaii","6","7","0","0.46154","409","378","31","Greg McMackin"
"2012","Hawaii","3","9","0","0.25","254","428","-174","Norm Chow"
"2013","Hawaii","1","11","0","0.08333","329","465","-136","Norm Chow"
"2014","Hawaii","4","9","0","0.30769","272","349","-77","Norm Chow"
"1978","Idaho","2","9","0","0.18182","163","401","-238","Jerry Davitch"
"1979","Idaho","4","7","0","0.36364","210","268","-58","Jerry Davitch"
"1980","Idaho","6","5","0","0.54545","266","228","38","Jerry Davitch"
"1981","Idaho","3","8","0","0.27273","310","254","56","Jerry Davitch"
"1982","Idaho","9","4","0","0.69231","397","299","98","Dennis Erickson"
"1983","Idaho","8","3","0","0.72727","347","257","90","Dennis Erickson"
"1984","Idaho","6","5","0","0.54545","363","283","80","Dennis Erickson"
"1985","Idaho","9","3","0","0.75","441","247","194","Dennis Erickson"
"2006","Idaho","4","8","0","0.33333","203","417","-214","Dennis Erickson"
"1986","Idaho","8","4","0","0.66667","307","244","63","Keith Gilbertson"
"1987","Idaho","9","3","0","0.75","358","339","19","Keith Gilbertson"
"1988","Idaho","11","2","0","0.84615","392","305","87","Keith Gilbertson"
"1989","Idaho","9","3","0","0.75","407","314","93","John L. Smith"
"1990","Idaho","9","4","0","0.69231","477","342","135","John L. Smith"
"1991","Idaho","6","5","0","0.54545","375","313","62","John L. Smith"
"1992","Idaho","9","3","0","0.75","466","247","219","John L. Smith"
"1993","Idaho","11","3","0","0.78571","593","353","240","John L. Smith"
"1994","Idaho","9","3","0","0.75","493","289","204","John L. Smith"
"1995","Idaho","6","5","0","0.54545","287","209","78","Chris Tormey"
"1996","Idaho","6","5","0","0.54545","374","296","78","Chris Tormey"
"1997","Idaho","5","6","0","0.45455","302","263","39","Chris Tormey"
"1998","Idaho","9","3","0","0.75","392","317","75","Chris Tormey"
"1999","Idaho","7","4","0","0.63636","304","283","21","Chris Tormey"
"2000","Idaho","5","6","0","0.45455","321","377","-56","Tom Cable"
"2001","Idaho","1","10","0","0.09091","313","495","-182","Tom Cable"
"2002","Idaho","2","10","0","0.16667","285","428","-143","Tom Cable"
"2003","Idaho","3","9","0","0.25","248","314","-66","Tom Cable"
"2004","Idaho","3","9","0","0.25","245","473","-228","Nick Holt"
"2005","Idaho","2","9","0","0.18182","243","419","-176","Nick Holt"
"2007","Idaho","1","11","0","0.08333","258","443","-185","Robb Akey"
"2008","Idaho","2","10","0","0.16667","235","513","-278","Robb Akey"
"2009","Idaho","8","5","0","0.61538","425","468","-43","Robb Akey"
"2010","Idaho","6","7","0","0.46154","346","368","-22","Robb Akey"
"2011","Idaho","2","10","0","0.16667","243","399","-156","Robb Akey"
"2012","Idaho","1","7","0","0.125","128","336","-208","Robb Akey"
"2012","Idaho","0","4","0","0","62","173","-111","Jason Gesser"
"2013","Idaho","1","11","0","0.08333","218","561","-343","Paul Petrino"
"2014","Idaho","1","10","0","0.09091","275","410","-135","Paul Petrino"
"1890","Illinois","1","2","0","0.33333","12","84","-72","Scott Williams"
"1891","Illinois","6","0","0","1","142","24","118","Robert Lackey"
"1892","Illinois","9","4","1","0.67857","240","96","144","E.K. Hall"
"1893","Illinois","3","2","3","0.5625","156","106","50","E.K. Hall"
"1894","Illinois","5","3","0","0.625","188","76","112","Louis D. Vail"
"1895","Illinois","4","2","1","0.64286","215","28","187","George A. Huff"
"1896","Illinois","4","2","1","0.64286","148","36","112","George A. Huff"
"1897","Illinois","6","2","0","0.75","200","45","155","George A. Huff"
"1898","Illinois","4","5","0","0.44444","83","78","5","George A. Huff"
"1899","Illinois","3","5","1","0.38889","40","96","-56","George A. Huff"
"1900","Illinois","7","3","2","0.66667","184","67","117","Frederick L. ""Fred"" Smith"
"1901","Illinois","8","2","0","0.8","243","39","204","Edgar G. Holt"
"1902","Illinois","10","2","1","0.80769","380","44","336","Edgar G. Holt"
"1903","Illinois","8","6","0","0.57143","352","117","235","George W. Woodruff"
"1904","Illinois","9","2","1","0.79167","232","42","190","Arthur R. Hall, Justa Lindgren, Fred Lowenthal, & Clyde Matthews"
"1905","Illinois","5","4","0","0.55556","84","136","-52","Fred Lowenthal"
"1906","Illinois","1","3","1","0.3","20","107","-87","Justa Lindgren"
"1907","Illinois","3","2","0","0.6","64","81","-17","Arthur R. Hall"
"1908","Illinois","5","1","1","0.78571","140","37","103","Arthur R. Hall"
"1909","Illinois","5","2","0","0.71429","115","39","76","Arthur R. Hall"
"1910","Illinois","7","0","0","1","89","0","89","Arthur R. Hall"
"1911","Illinois","4","2","1","0.64286","81","51","30","Arthur R. Hall"
"1912","Illinois","3","3","1","0.5","122","48","74","Arthur R. Hall"
"1913","Illinois","4","2","1","0.64286","108","54","54","Robert C. Zuppke"
"1914","Illinois","7","0","0","1","224","22","202","Robert C. Zuppke"
"1915","Illinois","5","0","2","0.85714","183","25","158","Robert C. Zuppke"
"1916","Illinois","3","3","1","0.5","74","58","16","Robert C. Zuppke"
"1917","Illinois","5","2","1","0.6875","134","40","94","Robert C. Zuppke"
"1918","Illinois","5","2","0","0.71429","86","14","72","Robert C. Zuppke"
"1919","Illinois","6","1","0","0.85714","91","48","43","Robert C. Zuppke"
"1920","Illinois","5","2","0","0.71429","97","37","60","Robert C. Zuppke"
"1921","Illinois","3","4","0","0.42857","88","51","37","Robert C. Zuppke"
"1922","Illinois","2","5","0","0.28571","26","60","-34","Robert C. Zuppke"
"1923","Illinois","8","0","0","1","136","20","116","Robert C. Zuppke"
"1924","Illinois","6","1","1","0.8125","204","71","133","Robert C. Zuppke"
"1925","Illinois","5","3","0","0.625","98","59","39","Robert C. Zuppke"
"1926","Illinois","6","2","0","0.75","121","46","75","Robert C. Zuppke"
"1927","Illinois","7","0","1","0.9375","152","24","128","Robert C. Zuppke"
"1928","Illinois","7","1","0","0.875","145","16","129","Robert C. Zuppke"
"1929","Illinois","6","1","1","0.8125","155","27","128","Robert C. Zuppke"
"1930","Illinois","3","5","0","0.375","78","97","-19","Robert C. Zuppke"
"1931","Illinois","2","6","1","0.27778","58","140","-82","Robert C. Zuppke"
"1932","Illinois","5","4","0","0.55556","96","101","-5","Robert C. Zuppke"
"1933","Illinois","5","3","0","0.625","77","32","45","Robert C. Zuppke"
"1934","Illinois","7","1","0","0.875","103","43","60","Robert C. Zuppke"
"1935","Illinois","3","5","0","0.375","59","54","5","Robert C. Zuppke"
"1936","Illinois","4","3","1","0.5625","57","76","-19","Robert C. Zuppke"
"1937","Illinois","3","3","2","0.5","59","45","14","Robert C. Zuppke"
"1938","Illinois","3","5","0","0.375","110","88","22","Robert C. Zuppke"
"1939","Illinois","3","4","1","0.4375","75","74","1","Robert C. Zuppke"
"1940","Illinois","1","7","0","0.125","71","144","-73","Robert C. Zuppke"
"1941","Illinois","2","6","0","0.25","112","163","-51","Robert C. Zuppke"
"1942","Illinois","6","4","0","0.6","227","126","101","Ray Eliot"
"1943","Illinois","3","7","0","0.3","154","308","-154","Ray Eliot"
"1944","Illinois","5","4","1","0.55","273","149","124","Ray Eliot"
"1945","Illinois","2","6","1","0.27778","93","104","-11","Ray Eliot"
"1946","Illinois","8","2","0","0.8","217","105","112","Ray Eliot"
"1947","Illinois","5","3","1","0.61111","204","102","102","Ray Eliot"
"1948","Illinois","3","6","0","0.33333","135","140","-5","Ray Eliot"
"1949","Illinois","3","4","2","0.44444","149","140","9","Ray Eliot"
"1950","Illinois","7","2","0","0.77778","137","56","81","Ray Eliot"
"1951","Illinois","9","0","1","0.95","220","83","137","Ray Eliot"
"1952","Illinois","4","5","0","0.44444","194","175","19","Ray Eliot"
"1953","Illinois","7","1","1","0.83333","228","133","95","Ray Eliot"
"1954","Illinois","1","8","0","0.11111","103","180","-77","Ray Eliot"
"1955","Illinois","5","3","1","0.61111","149","114","35","Ray Eliot"
"1956","Illinois","2","5","2","0.33333","124","154","-30","Ray Eliot"
"1957","Illinois","4","5","0","0.44444","167","133","34","Ray Eliot"
"1958","Illinois","4","5","0","0.44444","144","150","-6","Ray Eliot"
"1959","Illinois","5","3","1","0.61111","111","93","18","Ray Eliot"
"1960","Illinois","5","4","0","0.55556","140","117","23","Peter R. Elliott"
"1961","Illinois","0","9","0","0","53","289","-236","Peter R. Elliott"
"1962","Illinois","2","7","0","0.22222","75","234","-159","Peter R. Elliott"
"1963","Illinois","8","1","1","0.85","170","96","74","Peter R. Elliott"
"1964","Illinois","6","3","0","0.66667","142","100","42","Peter R. Elliott"
"1965","Illinois","6","4","0","0.6","235","118","117","Peter R. Elliott"
"1966","Illinois","4","6","0","0.4","173","193","-20","Peter R. Elliott"
"1967","Illinois","4","6","0","0.4","143","213","-70","Jim Valek"
"1968","Illinois","1","9","0","0.1","107","333","-226","Jim Valek"
"1969","Illinois","0","10","0","0","106","397","-291","Jim Valek"
"1970","Illinois","3","7","0","0.3","165","279","-114","Jim Valek"
"1971","Illinois","5","6","0","0.45455","163","238","-75","Robert L. ""Bob"" Blackman"
"1972","Illinois","3","8","0","0.27273","197","277","-80","Robert L. ""Bob"" Blackman"
"1973","Illinois","5","6","0","0.45455","164","157","7","Robert L. ""Bob"" Blackman"
"1974","Illinois","6","4","1","0.59091","210","206","4","Robert L. ""Bob"" Blackman"
"1975","Illinois","5","6","0","0.45455","229","260","-31","Robert L. ""Bob"" Blackman"
"1976","Illinois","5","6","0","0.45455","235","248","-13","Robert L. ""Bob"" Blackman"
"1977","Illinois","3","8","0","0.27273","141","292","-151","Gary O. Moeller"
"1978","Illinois","1","8","2","0.18182","103","317","-214","Gary O. Moeller"
"1979","Illinois","2","8","1","0.22727","156","266","-110","Gary O. Moeller"
"1980","Illinois","3","7","1","0.31818","241","326","-85","Mike White"
"1981","Illinois","7","4","0","0.63636","287","288","-1","Mike White"
"1982","Illinois","7","5","0","0.58333","338","229","109","Mike White"
"1983","Illinois","10","2","0","0.83333","347","213","134","Mike White"
"1984","Illinois","7","4","0","0.63636","323","209","114","Mike White"
"1985","Illinois","6","5","1","0.54167","304","334","-30","Mike White"
"1986","Illinois","4","7","0","0.36364","189","299","-110","Mike White"
"1987","Illinois","3","7","1","0.31818","153","208","-55","Mike White"
"1988","Illinois","6","5","1","0.54167","245","243","2","John Mackovic"
"1989","Illinois","10","2","0","0.83333","332","182","150","John Mackovic"
"1990","Illinois","8","4","0","0.66667","293","246","47","John Mackovic"
"1991","Illinois","6","5","0","0.54545","261","182","79","John Mackovic"
"1991","Illinois","0","1","0","0","3","6","-3","Lou Tepper"
"1992","Illinois","6","5","1","0.54167","228","235","-7","Lou Tepper"
"1993","Illinois","5","6","0","0.45455","204","210","-6","Lou Tepper"
"1994","Illinois","7","5","0","0.58333","309","156","153","Lou Tepper"
"1995","Illinois","5","5","1","0.5","193","198","-5","Lou Tepper"
"1996","Illinois","2","9","0","0.18182","190","372","-182","Lou Tepper"
"1997","Illinois","0","11","0","0","119","368","-249","Ron Turner"
"1998","Illinois","3","8","0","0.27273","149","326","-177","Ron Turner"
"1999","Illinois","8","4","0","0.66667","388","275","113","Ron Turner"
"2000","Illinois","5","6","0","0.45455","294","286","8","Ron Turner"
"2001","Illinois","10","2","0","0.83333","390","285","105","Ron Turner"
"2002","Illinois","5","7","0","0.41667","346","307","39","Ron Turner"
"2003","Illinois","1","11","0","0.08333","203","398","-195","Ron Turner"
"2004","Illinois","3","8","0","0.27273","240","323","-83","Ron Turner"
"2005","Illinois","2","9","0","0.18182","187","435","-248","Ron Zook"
"2006","Illinois","2","10","0","0.16667","235","321","-86","Ron Zook"
"2007","Illinois","9","4","0","0.69231","362","283","79","Ron Zook"
"2008","Illinois","5","7","0","0.41667","344","319","25","Ron Zook"
"2009","Illinois","3","9","0","0.25","290","362","-72","Ron Zook"
"2010","Illinois","7","6","0","0.53846","423","305","118","Ron Zook"
"2011","Illinois","6","6","0","0.5","274","241","33","Ron Zook"
"2011","Illinois","1","0","0","1","20","14","6","Vic Koenning"
"2012","Illinois","2","10","0","0.16667","200","385","-185","Tim Beckman"
"2013","Illinois","4","8","0","0.33333","356","425","-69","Tim Beckman"
"2014","Illinois","6","7","0","0.46154","337","442","-105","Tim Beckman"
"1887","Indiana","0","1","0","0","8","10","-2","Arthur B. Woodford"
"1888","Indiana","0","0","1","0.5","6","6","0","Arthur B. Woodford"
"1889","Indiana","0","1","1","0.25","8","46","-38","Evans Woollen"
"1891","Indiana","1","5","0","0.16667","46","225","-179","Billy Herod"
"1894","Indiana","0","4","1","0.1","10","125","-115","Gustave Ferbert & Coach Huddleston"
"1895","Indiana","4","3","1","0.5625","108","90","18","Dana Osgood & Coach Wren"
"1896","Indiana","6","3","0","0.66667","186","74","112","Madison G. Gonterman"
"1897","Indiana","6","1","1","0.8125","150","32","118","Madison G. Gonterman"
"1898","Indiana","4","1","2","0.71429","90","30","60","James H. Horne"
"1899","Indiana","6","2","0","0.75","133","33","100","James H. Horne"
"1900","Indiana","4","2","2","0.625","110","29","81","James H. Horne"
"1901","Indiana","6","3","0","0.66667","214","87","127","James H. Horne"
"1902","Indiana","3","5","1","0.38889","94","207","-113","James H. Horne"
"1903","Indiana","4","4","0","0.5","148","124","24","James H. Horne"
"1904","Indiana","6","4","0","0.6","84","116","-32","James H. Horne"
"1905","Indiana","8","1","1","0.85","240","38","202","James M. Sheldon"
"1906","Indiana","4","2","0","0.66667","109","46","63","James M. Sheldon"
"1907","Indiana","2","3","1","0.41667","85","57","28","James M. Sheldon"
"1908","Indiana","3","4","0","0.42857","43","70","-27","James M. Sheldon"
"1909","Indiana","4","3","0","0.57143","129","53","76","James M. Sheldon"
"1910","Indiana","6","1","0","0.85714","111","6","105","James M. Sheldon"
"1911","Indiana","3","3","1","0.5","74","46","28","James M. Sheldon"
"1912","Indiana","2","5","0","0.28571","80","100","-20","James M. Sheldon"
"1913","Indiana","3","4","0","0.42857","90","162","-72","James M. Sheldon"
"1914","Indiana","3","4","0","0.42857","104","130","-26","Clarence C. Childs"
"1915","Indiana","3","3","1","0.5","85","43","42","Clarence C. Childs"
"1916","Indiana","2","4","1","0.35714","51","90","-39","Ewald O. ""Jumbo"" Stiehm"
"1917","Indiana","5","2","0","0.71429","225","59","166","Ewald O. ""Jumbo"" Stiehm"
"1918","Indiana","2","2","0","0.5","64","31","33","Ewald O. ""Jumbo"" Stiehm"
"1919","Indiana","3","4","0","0.42857","70","64","6","Ewald O. ""Jumbo"" Stiehm"
"1920","Indiana","5","2","0","0.71429","129","48","81","Ewald O. ""Jumbo"" Stiehm"
"1921","Indiana","3","4","0","0.42857","86","94","-8","Ewald O. ""Jumbo"" Stiehm"
"1922","Indiana","1","4","2","0.28571","21","113","-92","James P. ""Pat"" Herron"
"1923","Indiana","3","4","0","0.42857","48","117","-69","William A. ""Bill"" Ingram"
"1924","Indiana","4","4","0","0.5","147","100","47","William A. ""Bill"" Ingram"
"1925","Indiana","3","4","1","0.4375","102","115","-13","William A. ""Bill"" Ingram"
"1926","Indiana","3","5","0","0.375","80","137","-57","Harlan O. ""Pat"" Page"
"1927","Indiana","3","4","1","0.4375","104","107","-3","Harlan O. ""Pat"" Page"
"1928","Indiana","4","4","0","0.5","55","68","-13","Harlan O. ""Pat"" Page"
"1929","Indiana","2","6","1","0.27778","58","133","-75","Harlan O. ""Pat"" Page"
"1930","Indiana","2","5","1","0.3125","28","121","-93","Harlan O. ""Pat"" Page"
"1931","Indiana","3","5","2","0.4","57","98","-41","Earle C. ""Billy"" Hayes"
"1932","Indiana","3","4","1","0.4375","65","76","-11","Earle C. ""Billy"" Hayes"
"1933","Indiana","1","5","2","0.25","25","96","-71","Earle C. ""Billy"" Hayes"
"1934","Indiana","3","3","2","0.5","67","110","-43","Alvin N. ""Bo"" McMillin"
"1935","Indiana","4","3","1","0.5625","70","55","15","Alvin N. ""Bo"" McMillin"
"1936","Indiana","5","2","1","0.6875","123","63","60","Alvin N. ""Bo"" McMillin"
"1937","Indiana","5","3","0","0.625","72","32","40","Alvin N. ""Bo"" McMillin"
"1938","Indiana","1","6","1","0.1875","21","67","-46","Alvin N. ""Bo"" McMillin"
"1939","Indiana","2","4","2","0.375","70","96","-26","Alvin N. ""Bo"" McMillin"
"1940","Indiana","3","5","0","0.375","69","100","-31","Alvin N. ""Bo"" McMillin"
"1941","Indiana","2","6","0","0.25","101","126","-25","Alvin N. ""Bo"" McMillin"
"1942","Indiana","7","3","0","0.7","256","79","177","Alvin N. ""Bo"" McMillin"
"1943","Indiana","4","4","2","0.5","193","106","87","Alvin N. ""Bo"" McMillin"
"1944","Indiana","7","3","0","0.7","292","79","213","Alvin N. ""Bo"" McMillin"
"1945","Indiana","9","0","1","0.95","279","56","223","Alvin N. ""Bo"" McMillin"
"1946","Indiana","6","3","0","0.66667","129","95","34","Alvin N. ""Bo"" McMillin"
"1947","Indiana","5","3","1","0.61111","156","102","54","Alvin N. ""Bo"" McMillin"
"1948","Indiana","2","7","0","0.22222","75","217","-142","Clyde B. Smith"
"1949","Indiana","1","8","0","0.11111","117","254","-137","Clyde B. Smith"
"1950","Indiana","3","5","1","0.38889","99","155","-56","Clyde B. Smith"
"1951","Indiana","2","7","0","0.22222","118","191","-73","Clyde B. Smith"
"1952","Indiana","2","7","0","0.22222","143","224","-81","Bernie A. Crimmins"
"1953","Indiana","2","7","0","0.22222","119","227","-108","Bernie A. Crimmins"
"1954","Indiana","3","6","0","0.33333","110","143","-33","Bernie A. Crimmins"
"1955","Indiana","3","6","0","0.33333","91","150","-59","Bernie A. Crimmins"
"1956","Indiana","3","6","0","0.33333","129","263","-134","Bernie A. Crimmins"
"1957","Indiana","1","8","0","0.11111","47","307","-260","Bob Hicks"
"1958","Indiana","5","3","1","0.61111","81","141","-60","Phil Dickens"
"1959","Indiana","4","4","1","0.5","142","105","37","Phil Dickens"
"1960","Indiana","1","8","0","0.11111","69","243","-174","Phil Dickens"
"1961","Indiana","2","7","0","0.22222","96","162","-66","Phil Dickens"
"1962","Indiana","3","6","0","0.33333","126","140","-14","Phil Dickens"
"1963","Indiana","3","6","0","0.33333","151","188","-37","Phil Dickens"
"1964","Indiana","2","7","0","0.22222","154","188","-34","Phil Dickens"
"1965","Indiana","2","8","0","0.2","134","225","-91","John Pont"
"1966","Indiana","1","8","1","0.15","104","229","-125","John Pont"
"1967","Indiana","9","2","0","0.81818","197","159","38","John Pont"
"1968","Indiana","6","4","0","0.6","250","262","-12","John Pont"
"1969","Indiana","4","6","0","0.4","252","242","10","John Pont"
"1970","Indiana","1","9","0","0.1","102","300","-198","John Pont"
"1971","Indiana","3","8","0","0.27273","152","260","-108","John Pont"
"1972","Indiana","5","6","0","0.45455","204","272","-68","John Pont"
"1973","Indiana","2","9","0","0.18182","151","271","-120","Lee Corso"
"1974","Indiana","1","10","0","0.09091","166","292","-126","Lee Corso"
"1975","Indiana","2","8","1","0.22727","104","254","-150","Lee Corso"
"1976","Indiana","5","6","0","0.45455","130","254","-124","Lee Corso"
"1977","Indiana","5","5","1","0.5","205","228","-23","Lee Corso"
"1978","Indiana","4","7","0","0.36364","228","290","-62","Lee Corso"
"1979","Indiana","8","4","0","0.66667","314","252","62","Lee Corso"
"1980","Indiana","6","5","0","0.54545","255","235","20","Lee Corso"
"1981","Indiana","3","8","0","0.27273","144","293","-149","Lee Corso"
"1982","Indiana","5","6","0","0.45455","203","250","-47","Lee Corso"
"1983","Indiana","3","8","0","0.27273","201","360","-159","Sam Wyche"
"1984","Indiana","0","11","0","0","185","338","-153","Bill Mallory"
"1985","Indiana","4","7","0","0.36364","251","340","-89","Bill Mallory"
"1986","Indiana","6","6","0","0.5","273","227","46","Bill Mallory"
"1987","Indiana","8","4","0","0.66667","283","238","45","Bill Mallory"
"1988","Indiana","8","3","1","0.70833","396","235","161","Bill Mallory"
"1989","Indiana","5","6","0","0.45455","289","262","27","Bill Mallory"
"1990","Indiana","6","5","1","0.54167","329","238","91","Bill Mallory"
"1991","Indiana","7","4","1","0.625","305","224","81","Bill Mallory"
"1992","Indiana","5","6","0","0.45455","177","197","-20","Bill Mallory"
"1993","Indiana","8","4","0","0.66667","259","197","62","Bill Mallory"
"1994","Indiana","7","4","0","0.63636","294","285","9","Bill Mallory"
"1995","Indiana","2","9","0","0.18182","159","326","-167","Bill Mallory"
"1996","Indiana","3","8","0","0.27273","242","291","-49","Bill Mallory"
"1997","Indiana","2","9","0","0.18182","120","359","-239","Cam Cameron"
"1998","Indiana","4","7","0","0.36364","245","305","-60","Cam Cameron"
"1999","Indiana","4","7","0","0.36364","291","386","-95","Cam Cameron"
"2000","Indiana","3","8","0","0.27273","337","427","-90","Cam Cameron"
"2001","Indiana","5","6","0","0.45455","305","298","7","Cam Cameron"
"2002","Indiana","3","9","0","0.25","258","445","-187","Gerry DiNardo"
"2003","Indiana","2","10","0","0.16667","177","388","-211","Gerry DiNardo"
"2004","Indiana","3","8","0","0.27273","262","343","-81","Gerry DiNardo"
"2005","Indiana","4","7","0","0.36364","248","361","-113","Terry Hoeppner"
"2006","Indiana","5","7","0","0.41667","277","394","-117","Terry Hoeppner"
"2007","Indiana","7","6","0","0.53846","412","370","42","Bill Lynch"
"2008","Indiana","3","9","0","0.25","246","423","-177","Bill Lynch"
"2009","Indiana","4","8","0","0.33333","282","354","-72","Bill Lynch"
"2010","Indiana","5","7","0","0.41667","326","408","-82","Bill Lynch"
"2011","Indiana","1","11","0","0.08333","257","448","-191","Kevin Wilson"
"2012","Indiana","4","8","0","0.33333","369","423","-54","Kevin Wilson"
"2013","Indiana","5","7","0","0.41667","461","466","-5","Kevin Wilson"
"2014","Indiana","4","8","0","0.33333","301","394","-93","Kevin Wilson"
"1892","Iowa","3","2","1","0.58333","124","70","54","E.A. Dalton"
"1893","Iowa","3","4","0","0.42857","178","161","17","Ben Donnelly"
"1894","Iowa","4","4","1","0.5","162","170","-8","Roger Sherman"
"1896","Iowa","10","5","3","0.63889","202","137","65","Dr. Alfred E. Bull"
"1897","Iowa","4","4","0","0.5","76","110","-34","Otto Wagonhurst"
"1898","Iowa","3","4","2","0.44444","67","97","-30","Alden Knipe"
"1899","Iowa","9","0","1","0.95","257","5","252","Alden Knipe"
"1900","Iowa","7","0","1","0.9375","311","12","299","Alden Knipe"
"1901","Iowa","6","3","0","0.66667","79","115","-36","Alden Knipe"
"1902","Iowa","5","4","0","0.55556","121","238","-117","Alden Knipe"
"1903","Iowa","9","2","0","0.81818","171","102","69","John Chalmers"
"1904","Iowa","7","4","0","0.63636","257","109","148","John Chalmers"
"1905","Iowa","8","3","0","0.72727","309","90","219","John Chalmers"
"1906","Iowa","3","3","0","0.5","56","75","-19","Mark S. Catlin"
"1907","Iowa","3","2","0","0.6","90","48","42","Mark S. Catlin"
"1908","Iowa","2","5","0","0.28571","132","65","67","Mark S. Catlin"
"1909","Iowa","2","4","1","0.35714","58","97","-39","John G. ""Pinky"" Griffith"
"1910","Iowa","5","2","0","0.71429","94","15","79","Jesse B. Hawley"
"1911","Iowa","3","4","0","0.42857","34","53","-19","Jesse B. Hawley"
"1912","Iowa","4","3","0","0.57143","130","138","-8","Jesse B. Hawley"
"1913","Iowa","5","2","0","0.71429","310","51","259","Jesse B. Hawley"
"1914","Iowa","4","3","0","0.57143","204","36","168","Jesse B. Hawley"
"1915","Iowa","3","4","0","0.42857","92","150","-58","Jesse B. Hawley"
"1916","Iowa","4","3","0","0.57143","121","156","-35","Howard H. Jones"
"1917","Iowa","3","6","0","0.33333","91","160","-69","Howard H. Jones"
"1918","Iowa","6","2","1","0.72222","123","36","87","Howard H. Jones"
"1919","Iowa","5","2","0","0.71429","90","44","46","Howard H. Jones"
"1920","Iowa","5","2","0","0.71429","142","54","88","Howard H. Jones"
"1921","Iowa","7","0","0","1","185","36","149","Howard H. Jones"
"1922","Iowa","7","0","0","1","208","33","175","Howard H. Jones"
"1923","Iowa","5","3","0","0.625","124","55","69","Howard H. Jones"
"1924","Iowa","6","1","1","0.8125","106","50","56","Burt Ingwersen"
"1925","Iowa","5","3","0","0.625","122","74","48","Burt Ingwersen"
"1926","Iowa","3","5","0","0.375","113","117","-4","Burt Ingwersen"
"1927","Iowa","4","4","0","0.5","107","83","24","Burt Ingwersen"
"1928","Iowa","6","2","0","0.75","147","42","105","Burt Ingwersen"
"1929","Iowa","4","2","2","0.625","128","28","100","Burt Ingwersen"
"1930","Iowa","4","4","0","0.5","88","74","14","Burt Ingwersen"
"1931","Iowa","1","7","1","0.16667","7","138","-131","Burt Ingwersen"
"1932","Iowa","1","7","0","0.125","62","171","-109","Oscar M. ""Ossie"" Solem"
"1933","Iowa","5","3","0","0.625","131","56","75","Oscar M. ""Ossie"" Solem"
"1934","Iowa","2","5","1","0.3125","98","153","-55","Oscar M. ""Ossie"" Solem"
"1935","Iowa","4","2","2","0.625","122","39","83","Oscar M. ""Ossie"" Solem"
"1936","Iowa","3","4","1","0.4375","85","103","-18","Oscar M. ""Ossie"" Solem"
"1937","Iowa","1","7","0","0.125","36","120","-84","Irl I. Tubbs"
"1938","Iowa","1","6","1","0.1875","46","135","-89","Irl I. Tubbs"
"1939","Iowa","6","1","1","0.8125","130","91","39","Edward N. ""Eddie"" Anderson"
"1940","Iowa","4","4","0","0.5","125","98","27","Edward N. ""Eddie"" Anderson"
"1941","Iowa","3","5","0","0.375","91","99","-8","Edward N. ""Eddie"" Anderson"
"1942","Iowa","6","4","0","0.6","147","135","12","Edward N. ""Eddie"" Anderson"
"1946","Iowa","5","4","0","0.55556","129","92","37","Edward N. ""Eddie"" Anderson"
"1947","Iowa","3","5","1","0.38889","145","179","-34","Edward N. ""Eddie"" Anderson"
"1948","Iowa","4","5","0","0.44444","127","142","-15","Edward N. ""Eddie"" Anderson"
"1949","Iowa","4","5","0","0.44444","184","247","-63","Edward N. ""Eddie"" Anderson"
"1943","Iowa","1","6","1","0.1875","83","153","-70","Ed ""Slip"" Madigan"
"1944","Iowa","1","7","0","0.125","53","240","-187","Ed ""Slip"" Madigan"
"1945","Iowa","2","7","0","0.22222","74","310","-236","Clem Crowe"
"1950","Iowa","3","5","1","0.38889","121","201","-80","Leonard Raffensperger"
"1951","Iowa","2","5","2","0.33333","161","233","-72","Leonard Raffensperger"
"1952","Iowa","2","7","0","0.22222","121","220","-99","Forest Evashevski"
"1953","Iowa","5","3","1","0.61111","187","91","96","Forest Evashevski"
"1954","Iowa","5","4","0","0.55556","192","141","51","Forest Evashevski"
"1955","Iowa","3","5","1","0.38889","166","173","-7","Forest Evashevski"
"1956","Iowa","9","1","0","0.9","219","84","135","Forest Evashevski"
"1957","Iowa","7","1","1","0.83333","263","112","151","Forest Evashevski"
"1958","Iowa","8","1","1","0.85","272","146","126","Forest Evashevski"
"1959","Iowa","5","4","0","0.55556","233","100","133","Forest Evashevski"
"1960","Iowa","8","1","0","0.88889","234","108","126","Forest Evashevski"
"1961","Iowa","5","4","0","0.55556","215","162","53","Jerry Burns"
"1962","Iowa","4","5","0","0.44444","127","166","-39","Jerry Burns"
"1963","Iowa","3","3","2","0.5","126","112","14","Jerry Burns"
"1964","Iowa","3","6","0","0.33333","170","209","-39","Jerry Burns"
"1965","Iowa","1","9","0","0.1","94","192","-98","Jerry Burns"
"1966","Iowa","2","8","0","0.2","86","253","-167","Raymond R. ""Ray"" Nagel"
"1967","Iowa","1","8","1","0.15","161","277","-116","Raymond R. ""Ray"" Nagel"
"1968","Iowa","5","5","0","0.5","322","289","33","Raymond R. ""Ray"" Nagel"
"1969","Iowa","5","5","0","0.5","255","275","-20","Raymond R. ""Ray"" Nagel"
"1970","Iowa","3","6","1","0.35","129","259","-130","Raymond R. ""Ray"" Nagel"
"1971","Iowa","1","10","0","0.09091","121","379","-258","Frank X. Lauterbur"
"1972","Iowa","3","7","1","0.31818","109","208","-99","Frank X. Lauterbur"
"1973","Iowa","0","11","0","0","140","401","-261","Frank X. Lauterbur"
"1974","Iowa","3","8","0","0.27273","157","308","-151","Bob Commings"
"1975","Iowa","3","8","0","0.27273","182","279","-97","Bob Commings"
"1976","Iowa","5","6","0","0.45455","161","234","-73","Bob Commings"
"1977","Iowa","5","6","0","0.45455","171","229","-58","Bob Commings"
"1978","Iowa","2","9","0","0.18182","125","291","-166","Bob Commings"
"1979","Iowa","5","6","0","0.45455","239","216","23","Hayden Fry"
"1980","Iowa","4","7","0","0.36364","154","238","-84","Hayden Fry"
"1981","Iowa","8","4","0","0.66667","260","157","103","Hayden Fry"
"1982","Iowa","8","4","0","0.66667","229","230","-1","Hayden Fry"
"1983","Iowa","9","3","0","0.75","380","189","191","Hayden Fry"
"1984","Iowa","8","4","1","0.65385","359","201","158","Hayden Fry"
"1985","Iowa","10","2","0","0.83333","440","187","253","Hayden Fry"
"1986","Iowa","9","3","0","0.75","391","214","177","Hayden Fry"
"1987","Iowa","10","3","0","0.76923","380","250","130","Hayden Fry"
"1988","Iowa","6","4","3","0.57692","336","233","103","Hayden Fry"
"1989","Iowa","5","6","0","0.45455","197","278","-81","Hayden Fry"
"1990","Iowa","8","4","0","0.66667","427","288","139","Hayden Fry"
"1991","Iowa","10","1","1","0.875","343","179","164","Hayden Fry"
"1992","Iowa","5","7","0","0.41667","243","278","-35","Hayden Fry"
"1993","Iowa","6","6","0","0.5","214","293","-79","Hayden Fry"
"1994","Iowa","5","5","1","0.5","307","324","-17","Hayden Fry"
"1995","Iowa","8","4","0","0.66667","368","259","109","Hayden Fry"
"1996","Iowa","9","3","0","0.75","339","243","96","Hayden Fry"
"1997","Iowa","7","5","0","0.58333","411","159","252","Hayden Fry"
"1998","Iowa","3","8","0","0.27273","172","287","-115","Hayden Fry"
"1999","Iowa","1","10","0","0.09091","162","347","-185","Kirk Ferentz"
"2000","Iowa","3","9","0","0.25","203","330","-127","Kirk Ferentz"
"2001","Iowa","7","5","0","0.58333","391","258","133","Kirk Ferentz"
"2002","Iowa","11","2","0","0.84615","484","256","228","Kirk Ferentz"
"2003","Iowa","10","3","0","0.76923","373","210","163","Kirk Ferentz"
"2004","Iowa","10","2","0","0.83333","292","211","81","Kirk Ferentz"
"2005","Iowa","7","5","0","0.58333","360","240","120","Kirk Ferentz"
"2006","Iowa","6","7","0","0.46154","310","269","41","Kirk Ferentz"
"2007","Iowa","6","6","0","0.5","222","225","-3","Kirk Ferentz"
"2008","Iowa","9","4","0","0.69231","394","169","225","Kirk Ferentz"
"2009","Iowa","11","2","0","0.84615","301","200","101","Kirk Ferentz"
"2010","Iowa","8","5","0","0.61538","376","221","155","Kirk Ferentz"
"2011","Iowa","7","6","0","0.53846","358","310","48","Kirk Ferentz"
"2012","Iowa","4","8","0","0.33333","232","275","-43","Kirk Ferentz"
"2013","Iowa","8","5","0","0.61538","342","246","96","Kirk Ferentz"
"2014","Iowa","7","6","0","0.53846","367","333","34","Kirk Ferentz"
"1892","Iowa St.","1","0","1","0.75","36","6","30","Ira C. Brownlie"
"1893","Iowa St.","0","3","0","0","14","62","-48","W.F. Finney"
"1894","Iowa St.","6","1","0","0.85714","192","32","160","Bert German"
"1895","Iowa St.","3","3","0","0.5","72","53","19","Bert German"
"1896","Iowa St.","8","2","0","0.8","303","46","257","Bert German"
"1897","Iowa St.","3","1","0","0.75","40","32","8","Bert German"
"1898","Iowa St.","3","2","0","0.6","49","50","-1","Bert German"
"1895","Iowa St.","3","5","0","0.375","108","56","52","Glenn Scobey ""Pop"" Warner"
"1899","Iowa St.","5","4","1","0.55","117","38","79","Joe Meyers"
"1900","Iowa St.","2","5","1","0.3125","38","100","-62","C.E. Woodruff"
"1901","Iowa St.","2","6","2","0.3","56","127","-71","Edgar N. Clinton"
"1902","Iowa St.","6","3","1","0.65","246","56","190","A.W. Ristine"
"1903","Iowa St.","8","1","0","0.88889","202","59","143","A.W. Ristine"
"1904","Iowa St.","7","2","0","0.77778","248","48","200","A.W. Ristine"
"1905","Iowa St.","6","3","0","0.66667","203","93","110","A.W. Ristine"
"1906","Iowa St.","9","1","0","0.9","268","30","238","A.W. Ristine"
"1907","Iowa St.","6","2","0","0.75","138","40","98","Clyde Williams"
"1908","Iowa St.","6","3","0","0.66667","186","50","136","Clyde Williams"
"1909","Iowa St.","4","3","1","0.5625","82","62","20","Clyde Williams"
"1910","Iowa St.","4","4","0","0.5","37","85","-48","Clyde Williams"
"1911","Iowa St.","6","1","1","0.8125","88","20","68","Clyde Williams"
"1912","Iowa St.","6","2","0","0.75","151","45","106","Clyde Williams"
"1913","Iowa St.","4","4","0","0.5","112","119","-7","Homer C. Hubbard"
"1914","Iowa St.","4","3","0","0.57143","167","78","89","Homer C. Hubbard"
"1915","Iowa St.","6","2","0","0.75","129","75","54","Charles W. Mayser"
"1916","Iowa St.","5","2","1","0.6875","106","36","70","Charles W. Mayser"
"1917","Iowa St.","5","2","0","0.71429","129","20","109","Charles W. Mayser"
"1918","Iowa St.","0","3","0","0","0","38","-38","Charles W. Mayser"
"1919","Iowa St.","5","2","1","0.6875","73","20","53","Charles W. Mayser"
"1920","Iowa St.","4","4","0","0.5","98","48","50","Norman C. Paine"
"1921","Iowa St.","4","4","0","0.5","87","74","13","Maury A. Kent"
"1922","Iowa St.","2","6","0","0.25","51","124","-73","Sam S. Willaman"
"1923","Iowa St.","4","3","1","0.5625","121","93","28","Sam S. Willaman"
"1924","Iowa St.","4","3","1","0.5625","87","68","19","Sam S. Willaman"
"1925","Iowa St.","4","3","1","0.5625","107","93","14","Sam S. Willaman"
"1926","Iowa St.","4","3","1","0.5625","51","60","-9","C. Noel Workman"
"1927","Iowa St.","4","3","1","0.5625","77","78","-1","C. Noel Workman"
"1928","Iowa St.","2","5","1","0.3125","39","67","-28","C. Noel Workman"
"1929","Iowa St.","1","7","0","0.125","54","135","-81","C. Noel Workman"
"1930","Iowa St.","0","9","0","0","64","134","-70","C. Noel Workman"
"1931","Iowa St.","5","3","0","0.625","72","74","-2","George F. Veenker"
"1932","Iowa St.","3","4","1","0.4375","105","101","4","George F. Veenker"
"1933","Iowa St.","3","5","1","0.38889","73","120","-47","George F. Veenker"
"1934","Iowa St.","5","3","1","0.61111","132","66","66","George F. Veenker"
"1935","Iowa St.","2","4","3","0.38889","82","101","-19","George F. Veenker"
"1936","Iowa St.","3","3","2","0.5","94","112","-18","George F. Veenker"
"1937","Iowa St.","3","6","0","0.33333","50","161","-111","James J. ""Jim"" Yeager"
"1938","Iowa St.","7","1","1","0.83333","125","64","61","James J. ""Jim"" Yeager"
"1939","Iowa St.","2","7","0","0.22222","50","117","-67","James J. ""Jim"" Yeager"
"1940","Iowa St.","4","5","0","0.44444","118","132","-14","James J. ""Jim"" Yeager"
"1941","Iowa St.","2","6","1","0.27778","85","181","-96","Ray Donels"
"1942","Iowa St.","1","2","0","0.33333","19","60","-41","Ray Donels"
"1942","Iowa St.","2","4","0","0.33333","75","117","-42","A.M. ""Mike"" Michalske"
"1943","Iowa St.","4","4","0","0.5","147","104","43","A.M. ""Mike"" Michalske"
"1944","Iowa St.","6","1","1","0.8125","203","39","164","A.M. ""Mike"" Michalske"
"1945","Iowa St.","4","3","1","0.5625","156","97","59","A.M. ""Mike"" Michalske"
"1946","Iowa St.","2","6","1","0.27778","77","239","-162","A.M. ""Mike"" Michalske"
"1947","Iowa St.","3","6","0","0.33333","111","141","-30","Emmett R. ""Abe"" Stuber"
"1948","Iowa St.","4","6","0","0.4","116","197","-81","Emmett R. ""Abe"" Stuber"
"1949","Iowa St.","5","3","1","0.61111","169","134","35","Emmett R. ""Abe"" Stuber"
"1950","Iowa St.","3","6","1","0.35","174","200","-26","Emmett R. ""Abe"" Stuber"
"1951","Iowa St.","4","4","1","0.5","211","216","-5","Emmett R. ""Abe"" Stuber"
"1952","Iowa St.","3","6","0","0.33333","158","199","-41","Emmett R. ""Abe"" Stuber"
"1953","Iowa St.","2","7","0","0.22222","120","211","-91","Emmett R. ""Abe"" Stuber"
"1954","Iowa St.","3","6","0","0.33333","151","182","-31","Vince DiFrancesca"
"1955","Iowa St.","1","7","1","0.16667","69","218","-149","Vince DiFrancesca"
"1956","Iowa St.","2","8","0","0.2","92","260","-168","Vince DiFrancesca"
"1957","Iowa St.","4","5","1","0.45","142","160","-18","James A. ""Jim"" Myers"
"1958","Iowa St.","4","6","0","0.4","127","88","39","Clay Stapleton"
"1959","Iowa St.","7","3","0","0.7","248","80","168","Clay Stapleton"
"1960","Iowa St.","7","3","0","0.7","185","136","49","Clay Stapleton"
"1961","Iowa St.","5","5","0","0.5","151","133","18","Clay Stapleton"
"1962","Iowa St.","5","5","0","0.5","235","235","0","Clay Stapleton"
"1963","Iowa St.","4","5","0","0.44444","129","143","-14","Clay Stapleton"
"1964","Iowa St.","1","8","1","0.15","72","155","-83","Clay Stapleton"
"1965","Iowa St.","5","4","1","0.55","178","147","31","Clay Stapleton"
"1966","Iowa St.","2","6","2","0.3","160","211","-51","Clay Stapleton"
"1967","Iowa St.","2","8","0","0.2","86","275","-189","Clay Stapleton"
"1968","Iowa St.","3","7","0","0.3","178","263","-85","Johnny Majors"
"1969","Iowa St.","3","7","0","0.3","152","231","-79","Johnny Majors"
"1970","Iowa St.","5","6","0","0.45455","248","284","-36","Johnny Majors"
"1971","Iowa St.","8","4","0","0.66667","337","250","87","Johnny Majors"
"1972","Iowa St.","5","6","1","0.45833","319","238","81","Johnny Majors"
"1973","Iowa St.","4","7","0","0.36364","245","236","9","Earle Bruce"
"1974","Iowa St.","4","7","0","0.36364","186","198","-12","Earle Bruce"
"1975","Iowa St.","4","7","0","0.36364","161","263","-102","Earle Bruce"
"1976","Iowa St.","8","3","0","0.72727","369","216","153","Earle Bruce"
"1977","Iowa St.","8","4","0","0.66667","249","178","71","Earle Bruce"
"1978","Iowa St.","8","4","0","0.66667","219","188","31","Earle Bruce"
"1979","Iowa St.","3","8","0","0.27273","137","221","-84","Donnie Duncan"
"1980","Iowa St.","6","5","0","0.54545","245","184","61","Donnie Duncan"
"1981","Iowa St.","5","5","1","0.5","189","218","-29","Donnie Duncan"
"1982","Iowa St.","4","6","1","0.40909","213","221","-8","Donnie Duncan"
"1983","Iowa St.","4","7","0","0.36364","248","385","-137","Jim Criner"
"1984","Iowa St.","2","7","2","0.27273","149","263","-114","Jim Criner"
"1985","Iowa St.","5","6","0","0.45455","155","318","-163","Jim Criner"
"1986","Iowa St.","6","5","0","0.54545","257","244","13","Jim Criner"
"1987","Iowa St.","3","8","0","0.27273","195","417","-222","Jim Walden"
"1988","Iowa St.","5","6","0","0.45455","195","258","-63","Jim Walden"
"1989","Iowa St.","6","5","0","0.54545","294","305","-11","Jim Walden"
"1990","Iowa St.","4","6","1","0.40909","270","307","-37","Jim Walden"
"1991","Iowa St.","3","7","1","0.31818","157","266","-109","Jim Walden"
"1992","Iowa St.","4","7","0","0.36364","231","242","-11","Jim Walden"
"1993","Iowa St.","3","8","0","0.27273","251","324","-73","Jim Walden"
"1994","Iowa St.","0","10","1","0.04545","192","363","-171","Jim Walden"
"1995","Iowa St.","3","8","0","0.27273","264","409","-145","Dan McCarney"
"1996","Iowa St.","2","9","0","0.18182","314","401","-87","Dan McCarney"
"1997","Iowa St.","1","10","0","0.09091","214","493","-279","Dan McCarney"
"1998","Iowa St.","3","8","0","0.27273","221","328","-107","Dan McCarney"
"1999","Iowa St.","4","7","0","0.36364","247","272","-25","Dan McCarney"
"2000","Iowa St.","9","3","0","0.75","343","322","21","Dan McCarney"
"2001","Iowa St.","7","5","0","0.58333","309","245","64","Dan McCarney"
"2002","Iowa St.","7","7","0","0.5","404","396","8","Dan McCarney"
"2003","Iowa St.","2","10","0","0.16667","173","437","-264","Dan McCarney"
"2004","Iowa St.","7","5","0","0.58333","246","259","-13","Dan McCarney"
"2005","Iowa St.","7","5","0","0.58333","339","230","109","Dan McCarney"
"2006","Iowa St.","4","8","0","0.33333","226","369","-143","Dan McCarney"
"2007","Iowa St.","3","9","0","0.25","218","381","-163","Gene Chizik"
"2008","Iowa St.","2","10","0","0.16667","304","430","-126","Gene Chizik"
"2009","Iowa St.","7","6","0","0.53846","267","284","-17","Paul Rhoads"
"2010","Iowa St.","5","7","0","0.41667","260","346","-86","Paul Rhoads"
"2011","Iowa St.","6","7","0","0.46154","295","382","-87","Paul Rhoads"
"2012","Iowa St.","6","7","0","0.46154","319","311","8","Paul Rhoads"
"2013","Iowa St.","3","9","0","0.25","298","432","-134","Paul Rhoads"
"2014","Iowa St.","2","10","0","0.16667","278","466","-188","Paul Rhoads"
"1890","Kansas","1","2","0","0.33333","33","52","-19","Will Coleman"
"1891","Kansas","6","1","1","0.8125","162","60","102","E.M. Hopkins"
"1892","Kansas","7","1","0","0.875","144","36","108","A.W. Shepard"
"1893","Kansas","2","5","0","0.28571","85","108","-23","A.W. Shepard"
"1894","Kansas","4","3","1","0.5625","130","72","58","Hector W. Cowan"
"1895","Kansas","6","1","0","0.85714","192","14","178","Hector W. Cowan"
"1896","Kansas","7","3","0","0.7","136","40","96","Hector W. Cowan"
"1897","Kansas","8","2","0","0.8","252","20","232","Wylie G. Woodruff"
"1898","Kansas","10","1","0","0.90909","174","29","145","Wylie G. Woodruff"
"1899","Kansas","10","0","0","1","280","37","243","Fielding H. ""Hurry Up"" Yost"
"1900","Kansas","2","5","2","0.33333","75","118","-43","Lawrence William ""Larry"" Boynton"
"1901","Kansas","3","5","2","0.4","92","147","-55","John H. Outland"
"1902","Kansas","6","4","0","0.6","108","93","15","Arthur H. Curtis"
"1903","Kansas","6","3","0","0.66667","118","39","79","Harold ""Harry"" Weeks"
"1904","Kansas","8","1","1","0.85","179","38","141","A.R. ""Bert"" Kennedy"
"1905","Kansas","10","1","0","0.90909","250","26","224","A.R. ""Bert"" Kennedy"
"1906","Kansas","7","2","2","0.72727","148","55","93","A.R. ""Bert"" Kennedy"
"1907","Kansas","5","3","0","0.625","111","57","54","A.R. ""Bert"" Kennedy"
"1908","Kansas","9","0","0","1","131","20","111","A.R. ""Bert"" Kennedy"
"1909","Kansas","8","1","0","0.88889","172","22","150","A.R. ""Bert"" Kennedy"
"1910","Kansas","6","1","1","0.8125","75","22","53","A.R. ""Bert"" Kennedy"
"1911","Kansas","4","2","2","0.625","81","44","37","Ralph W. Sherwin"
"1912","Kansas","4","4","0","0.5","128","45","83","Arthur St. L. ""Texas"" Mosse"
"1913","Kansas","5","3","0","0.625","120","40","80","Arthur St. L. ""Texas"" Mosse"
"1914","Kansas","5","2","1","0.6875","158","84","74","H.M. Wheaton"
"1915","Kansas","6","2","0","0.75","153","79","74","Herman P. Olcott"
"1916","Kansas","4","3","1","0.5625","68","72","-4","Herman P. Olcott"
"1917","Kansas","6","2","0","0.75","126","46","80","Herman P. Olcott"
"1918","Kansas","2","2","0","0.5","33","66","-33","Jay Bond"
"1919","Kansas","3","2","3","0.5625","85","35","50","Leon McCarty"
"1920","Kansas","5","2","1","0.6875","117","60","57","Forrest C. ""Phog"" Allen"
"1921","Kansas","4","3","0","0.57143","92","97","-5","George M. ""Potsy"" Clark"
"1922","Kansas","3","4","1","0.4375","104","75","29","George M. ""Potsy"" Clark"
"1923","Kansas","5","0","3","0.8125","125","6","119","George M. ""Potsy"" Clark"
"1924","Kansas","2","5","1","0.3125","91","56","35","George M. ""Potsy"" Clark"
"1925","Kansas","2","5","1","0.3125","30","68","-38","George M. ""Potsy"" Clark"
"1926","Kansas","2","6","0","0.25","34","135","-101","Franklin C. ""Cappy"" Cappon"
"1927","Kansas","3","4","1","0.4375","89","146","-57","Franklin C. ""Cappy"" Cappon"
"1928","Kansas","2","4","2","0.375","34","66","-32","William H. ""Bill"" Hargiss"
"1929","Kansas","4","4","0","0.5","97","50","47","William H. ""Bill"" Hargiss"
"1930","Kansas","6","2","0","0.75","144","50","94","William H. ""Bill"" Hargiss"
"1931","Kansas","5","5","0","0.5","112","54","58","William H. ""Bill"" Hargiss"
"1932","Kansas","1","1","0","0.5","19","33","-14","William H. ""Bill"" Hargiss"
"1932","Kansas","4","2","0","0.66667","70","44","26","Adrian H. ""Ad"" Lindsey"
"1933","Kansas","5","4","1","0.55","102","51","51","Adrian H. ""Ad"" Lindsey"
"1934","Kansas","3","4","3","0.45","74","48","26","Adrian H. ""Ad"" Lindsey"
"1935","Kansas","4","4","1","0.5","102","118","-16","Adrian H. ""Ad"" Lindsey"
"1936","Kansas","1","6","1","0.1875","35","153","-118","Adrian H. ""Ad"" Lindsey"
"1937","Kansas","3","4","2","0.44444","72","74","-2","Adrian H. ""Ad"" Lindsey"
"1938","Kansas","3","6","0","0.33333","132","169","-37","Adrian H. ""Ad"" Lindsey"
"1939","Kansas","2","6","0","0.25","47","107","-60","Gwinn Henry"
"1940","Kansas","2","7","0","0.22222","75","183","-108","Gwinn Henry"
"1941","Kansas","3","6","0","0.33333","74","222","-148","Gwinn Henry"
"1942","Kansas","2","8","0","0.2","77","248","-171","Gwinn Henry"
"1943","Kansas","4","5","1","0.45","96","107","-11","Henry A. Shenk"
"1944","Kansas","3","6","1","0.35","128","153","-25","Henry A. Shenk"
"1945","Kansas","4","5","1","0.45","139","175","-36","Henry A. Shenk"
"1946","Kansas","7","2","1","0.75","157","145","12","George H. Sauer"
"1947","Kansas","8","1","2","0.81818","304","102","202","George H. Sauer"
"1948","Kansas","7","3","0","0.7","199","137","62","Jules V. Sikes"
"1949","Kansas","5","5","0","0.5","259","183","76","Jules V. Sikes"
"1950","Kansas","6","4","0","0.6","284","188","96","Jules V. Sikes"
"1951","Kansas","8","2","0","0.8","316","208","108","Jules V. Sikes"
"1952","Kansas","7","3","0","0.7","214","110","104","Jules V. Sikes"
"1953","Kansas","2","8","0","0.2","83","179","-96","Jules V. Sikes"
"1954","Kansas","0","10","0","0","93","377","-284","Charles V. ""Chuck"" Mather"
"1955","Kansas","3","6","1","0.35","93","222","-129","Charles V. ""Chuck"" Mather"
"1956","Kansas","3","6","1","0.35","163","215","-52","Charles V. ""Chuck"" Mather"
"1957","Kansas","5","4","1","0.55","115","230","-115","Charles V. ""Chuck"" Mather"
"1958","Kansas","4","5","1","0.45","87","175","-88","Jack Mitchell"
"1959","Kansas","5","5","0","0.5","163","134","29","Jack Mitchell"
"1960","Kansas","5","4","1","0.55","219","89","130","Jack Mitchell"
"1961","Kansas","7","3","1","0.68182","269","88","181","Jack Mitchell"
"1962","Kansas","6","3","1","0.65","214","116","98","Jack Mitchell"
"1963","Kansas","5","5","0","0.5","207","122","85","Jack Mitchell"
"1964","Kansas","6","4","0","0.6","136","146","-10","Jack Mitchell"
"1965","Kansas","2","8","0","0.2","119","215","-96","Jack Mitchell"
"1966","Kansas","2","7","1","0.25","106","188","-82","Jack Mitchell"
"1967","Kansas","5","5","0","0.5","166","146","20","Pepper Rodgers"
"1968","Kansas","9","2","0","0.81818","394","190","204","Pepper Rodgers"
"1969","Kansas","1","9","0","0.1","176","290","-114","Pepper Rodgers"
"1970","Kansas","5","6","0","0.45455","270","277","-7","Pepper Rodgers"
"1975","Kansas","7","5","0","0.58333","262","180","82","Bud Moore"
"1976","Kansas","6","5","0","0.54545","260","251","9","Bud Moore"
"1977","Kansas","4","6","1","0.40909","131","269","-138","Bud Moore"
"1978","Kansas","1","10","0","0.09091","124","345","-221","Bud Moore"
"1971","Kansas","4","7","0","0.36364","187","286","-99","Don Fambrough"
"1972","Kansas","5","6","0","0.45455","208","305","-97","Don Fambrough"
"1973","Kansas","7","4","1","0.625","253","220","33","Don Fambrough"
"1974","Kansas","4","7","0","0.36364","157","247","-90","Don Fambrough"
"1979","Kansas","3","8","0","0.27273","172","346","-174","Don Fambrough"
"1980","Kansas","4","5","2","0.45455","171","208","-37","Don Fambrough"
"1981","Kansas","8","4","0","0.66667","188","195","-7","Don Fambrough"
"1982","Kansas","2","7","2","0.27273","150","276","-126","Don Fambrough"
"1983","Kansas","4","6","1","0.40909","296","320","-24","Mike Gottfried"
"1984","Kansas","5","6","0","0.45455","218","298","-80","Mike Gottfried"
"1985","Kansas","6","6","0","0.5","294","281","13","Mike Gottfried"
"1986","Kansas","3","8","0","0.27273","112","327","-215","Bob Valesente"
"1987","Kansas","1","9","1","0.13636","135","398","-263","Bob Valesente"
"1988","Kansas","1","10","0","0.09091","189","496","-307","Glen Mason"
"1989","Kansas","4","7","0","0.36364","248","383","-135","Glen Mason"
"1990","Kansas","3","7","1","0.31818","213","365","-152","Glen Mason"
"1991","Kansas","6","5","0","0.54545","313","244","69","Glen Mason"
"1992","Kansas","8","4","0","0.66667","373","262","111","Glen Mason"
"1993","Kansas","5","7","0","0.41667","242","256","-14","Glen Mason"
"1994","Kansas","6","5","0","0.54545","314","242","72","Glen Mason"
"1995","Kansas","10","2","0","0.83333","345","261","84","Glen Mason"
"1996","Kansas","4","7","0","0.36364","300","358","-58","Glen Mason"
"1997","Kansas","5","6","0","0.45455","177","279","-102","Terry Allen"
"1998","Kansas","4","7","0","0.36364","280","341","-61","Terry Allen"
"1999","Kansas","5","7","0","0.41667","294","354","-60","Terry Allen"
"2000","Kansas","4","7","0","0.36364","261","359","-98","Terry Allen"
"2001","Kansas","3","8","0","0.27273","182","398","-216","Terry Allen"
"2002","Kansas","2","10","0","0.16667","248","507","-259","Mark Mangino"
"2003","Kansas","6","7","0","0.46154","384","396","-12","Mark Mangino"
"2004","Kansas","4","7","0","0.36364","262","235","27","Mark Mangino"
"2005","Kansas","7","5","0","0.58333","269","264","5","Mark Mangino"
"2006","Kansas","6","6","0","0.5","348","306","42","Mark Mangino"
"2007","Kansas","12","1","0","0.92308","556","213","343","Mark Mangino"
"2008","Kansas","8","5","0","0.61538","434","375","59","Mark Mangino"
"2009","Kansas","5","7","0","0.41667","353","341","12","Mark Mangino"
"2010","Kansas","3","9","0","0.25","205","413","-208","Turner Gill"
"2011","Kansas","2","10","0","0.16667","268","525","-257","Turner Gill"
"2012","Kansas","1","11","0","0.08333","219","433","-214","Charlie Weis"
"2013","Kansas","3","9","0","0.25","184","382","-198","Charlie Weis"
"2014","Kansas","2","2","0","0.5","61","102","-41","Charlie Weis"
"2014","Kansas","1","7","0","0.125","153","297","-144","Clint Bowen"
"1988","Kent St. (OH)","5","6","0","0.45455","256","250","6","Dick Crum"
"1989","Kent St. (OH)","0","11","0","0","179","377","-198","Dick Crum"
"1990","Kent St. (OH)","2","9","0","0.18182","177","328","-151","Dick Crum"
"1991","Kent St. (OH)","1","10","0","0.09091","159","307","-148","Pete Cordelli"
"1992","Kent St. (OH)","2","9","0","0.18182","133","301","-168","Pete Cordelli"
"1993","Kent St. (OH)","0","11","0","0","149","357","-208","Pete Cordelli"
"1994","Kent St. (OH)","2","9","0","0.18182","140","293","-153","Jim Corrigall"
"1995","Kent St. (OH)","1","9","1","0.13636","128","390","-262","Jim Corrigall"
"1996","Kent St. (OH)","2","9","0","0.18182","255","492","-237","Jim Corrigall"
"1997","Kent St. (OH)","3","8","0","0.27273","337","490","-153","Jim Corrigall"
"1998","Kent St. (OH)","0","11","0","0","149","454","-305","Dean Pees"
"1999","Kent St. (OH)","2","9","0","0.18182","213","376","-163","Dean Pees"
"2000","Kent St. (OH)","1","10","0","0.09091","128","359","-231","Dean Pees"
"2001","Kent St. (OH)","6","5","0","0.54545","248","281","-33","Dean Pees"
"2002","Kent St. (OH)","3","9","0","0.25","202","424","-222","Dean Pees"
"2003","Kent St. (OH)","5","7","0","0.41667","321","396","-75","Dean Pees"
"2004","Kent St. (OH)","5","6","0","0.45455","335","264","71","Doug Martin"
"2005","Kent St. (OH)","1","10","0","0.09091","180","331","-151","Doug Martin"
"2006","Kent St. (OH)","6","6","0","0.5","214","241","-27","Doug Martin"
"2007","Kent St. (OH)","3","9","0","0.25","259","350","-91","Doug Martin"
"2008","Kent St. (OH)","4","8","0","0.33333","308","380","-72","Doug Martin"
"2009","Kent St. (OH)","5","7","0","0.41667","231","269","-38","Doug Martin"
"2010","Kent St. (OH)","5","7","0","0.41667","256","275","-19","Doug Martin"
"2011","Kent St. (OH)","5","7","0","0.41667","205","291","-86","Darrell Hazell"
"2012","Kent St. (OH)","11","3","0","0.78571","463","343","120","Darrell Hazell"
"2013","Kent St. (OH)","4","8","0","0.33333","249","323","-74","Paul Haynes"
"2014","Kent St. (OH)","2","9","0","0.18182","180","319","-139","Paul Haynes"
"1890","Kentucky","1","0","0","1","8","2","6","No Team"
"1892","Kentucky","2","4","1","0.35714","40","74","-34","Professor A.M. Miller"
"1893","Kentucky","5","2","1","0.6875","280","110","170","John A. Thompson"
"1894","Kentucky","5","2","0","0.71429","220","121","99","W.P. Finney"
"1895","Kentucky","4","5","0","0.44444","64","94","-30","Charles B. Mason"
"1896","Kentucky","3","6","0","0.33333","122","134","-12","Dudley Short"
"1897","Kentucky","2","4","0","0.33333","28","118","-90","Lyman B. Eaton"
"1898","Kentucky","7","0","0","1","180","0","180","W.R. Bass"
"1899","Kentucky","5","2","2","0.66667","98","44","54","W.R. Bass"
"1900","Kentucky","5","5","0","0.5","74","64","10","W.H. Kiler"
"1901","Kentucky","2","6","1","0.27778","39","87","-48","W.H. Kiler"
"1902","Kentucky","3","5","1","0.38889","72","83","-11","E.W. McLeod"
"1903","Kentucky","7","1","0","0.875","204","22","182","Charles A. ""Jack"" Wright"
"1904","Kentucky","9","1","0","0.9","276","15","261","F.E. Schact"
"1905","Kentucky","6","4","0","0.6","209","173","36","F.E. Schact"
"1906","Kentucky","4","3","0","0.57143","110","67","43","J. White Guyn"
"1907","Kentucky","9","1","1","0.86364","181","42","139","J. White Guyn"
"1908","Kentucky","4","3","0","0.57143","87","81","6","J. White Guyn"
"1911","Kentucky","7","3","0","0.7","97","41","56","P.P. Douglass"
"1909","Kentucky","9","1","0","0.9","261","29","232","Edwin R. Sweetland"
"1910","Kentucky","7","2","0","0.77778","140","29","111","Edwin R. Sweetland"
"1912","Kentucky","7","2","0","0.77778","250","41","209","Edwin R. Sweetland"
"1913","Kentucky","6","2","0","0.75","157","58","99","Alpha Brumage"
"1914","Kentucky","5","3","0","0.625","328","93","235","Alpha Brumage"
"1915","Kentucky","6","1","1","0.8125","149","38","111","John J. Tigert"
"1916","Kentucky","4","1","2","0.71429","152","51","101","John J. Tigert"
"1917","Kentucky","3","5","1","0.38889","104","56","48","S.A. Boles"
"1918","Kentucky","2","1","0","0.66667","45","43","2","Thomas A. ""Andy"" Gill"
"1919","Kentucky","3","4","1","0.4375","31","136","-105","Thomas A. ""Andy"" Gill"
"1920","Kentucky","3","4","1","0.4375","113","109","4","William J. ""Bill"" Juneau"
"1921","Kentucky","4","3","1","0.5625","157","89","68","William J. ""Bill"" Juneau"
"1922","Kentucky","6","3","0","0.66667","167","56","111","William J. ""Bill"" Juneau"
"1923","Kentucky","4","3","2","0.55556","135","53","82","John J. ""Jack"" Winn"
"1924","Kentucky","4","5","0","0.44444","129","99","30","Frederick James ""Fred"" Murphy"
"1925","Kentucky","6","3","0","0.66667","92","97","-5","Frederick James ""Fred"" Murphy"
"1926","Kentucky","2","6","1","0.27778","84","91","-7","Frederick James ""Fred"" Murphy"
"1927","Kentucky","3","6","1","0.35","115","161","-46","Harry G. Gamage"
"1928","Kentucky","4","3","1","0.5625","100","41","59","Harry G. Gamage"
"1929","Kentucky","6","1","1","0.8125","237","54","183","Harry G. Gamage"
"1930","Kentucky","5","3","0","0.625","207","55","152","Harry G. Gamage"
"1931","Kentucky","5","2","2","0.66667","130","48","82","Harry G. Gamage"
"1932","Kentucky","4","5","0","0.44444","116","77","39","Harry G. Gamage"
"1933","Kentucky","5","5","0","0.5","91","116","-25","Harry G. Gamage"
"1934","Kentucky","5","5","0","0.5","123","86","37","Chet A. Wynne"
"1935","Kentucky","5","4","0","0.55556","167","94","73","Chet A. Wynne"
"1936","Kentucky","6","4","0","0.6","179","84","95","Chet A. Wynne"
"1937","Kentucky","4","6","0","0.4","93","130","-37","Chet A. Wynne"
"1938","Kentucky","2","7","0","0.22222","150","160","-10","A.D. Kirwan"
"1939","Kentucky","6","2","1","0.72222","161","64","97","A.D. Kirwan"
"1940","Kentucky","5","3","2","0.6","190","107","83","A.D. Kirwan"
"1941","Kentucky","5","4","0","0.55556","151","154","-3","A.D. Kirwan"
"1942","Kentucky","3","6","1","0.35","155","154","1","A.D. Kirwan"
"1944","Kentucky","3","6","0","0.33333","125","147","-22","A.D. Kirwan"
"1945","Kentucky","2","8","0","0.2","96","217","-121","Bernie Shively"
"1946","Kentucky","7","3","0","0.7","233","97","136","Paul W. ""Bear"" Bryant"
"1947","Kentucky","8","3","0","0.72727","175","73","102","Paul W. ""Bear"" Bryant"
"1948","Kentucky","5","3","2","0.6","199","128","71","Paul W. ""Bear"" Bryant"
"1949","Kentucky","9","3","0","0.75","317","74","243","Paul W. ""Bear"" Bryant"
"1950","Kentucky","11","1","0","0.91667","393","69","324","Paul W. ""Bear"" Bryant"
"1951","Kentucky","8","4","0","0.66667","314","121","193","Paul W. ""Bear"" Bryant"
"1952","Kentucky","5","4","2","0.54545","161","173","-12","Paul W. ""Bear"" Bryant"
"1953","Kentucky","7","2","1","0.75","201","116","85","Paul W. ""Bear"" Bryant"
"1954","Kentucky","7","3","0","0.7","151","125","26","Blanton Collier"
"1955","Kentucky","6","3","1","0.65","178","131","47","Blanton Collier"
"1956","Kentucky","6","4","0","0.6","119","105","14","Blanton Collier"
"1957","Kentucky","3","7","0","0.3","128","127","1","Blanton Collier"
"1958","Kentucky","5","4","1","0.55","136","115","21","Blanton Collier"
"1959","Kentucky","4","6","0","0.4","140","107","33","Blanton Collier"
"1960","Kentucky","5","4","1","0.55","206","81","125","Blanton Collier"
"1961","Kentucky","5","5","0","0.5","138","123","15","Blanton Collier"
"1962","Kentucky","3","5","2","0.4","85","101","-16","Charlie Bradshaw"
"1963","Kentucky","3","6","1","0.35","142","168","-26","Charlie Bradshaw"
"1964","Kentucky","5","5","0","0.5","150","194","-44","Charlie Bradshaw"
"1965","Kentucky","6","4","0","0.6","202","160","42","Charlie Bradshaw"
"1966","Kentucky","3","6","1","0.35","107","196","-89","Charlie Bradshaw"
"1967","Kentucky","2","8","0","0.2","111","230","-119","Charlie Bradshaw"
"1968","Kentucky","3","7","0","0.3","141","206","-65","Charlie Bradshaw"
"1969","Kentucky","2","8","0","0.2","104","295","-191","John Ray"
"1970","Kentucky","2","9","0","0.18182","131","233","-102","John Ray"
"1971","Kentucky","3","8","0","0.27273","144","284","-140","John Ray"
"1972","Kentucky","3","8","0","0.27273","131","232","-101","John Ray"
"1973","Kentucky","5","6","0","0.45455","226","196","30","Fran Curci"
"1974","Kentucky","6","5","0","0.54545","248","194","54","Fran Curci"
"1975","Kentucky","2","8","1","0.22727","132","183","-51","Fran Curci"
"1976","Kentucky","9","3","0","0.75","209","151","58","Fran Curci"
"1977","Kentucky","10","1","0","0.90909","252","111","141","Fran Curci"
"1978","Kentucky","4","6","1","0.40909","193","189","4","Fran Curci"
"1979","Kentucky","5","6","0","0.45455","180","143","37","Fran Curci"
"1980","Kentucky","3","8","0","0.27273","167","280","-113","Fran Curci"
"1981","Kentucky","3","8","0","0.27273","134","222","-88","Fran Curci"
"1982","Kentucky","0","10","1","0.04545","96","287","-191","Jerry Claiborne"
"1983","Kentucky","6","5","1","0.54167","228","237","-9","Jerry Claiborne"
"1984","Kentucky","9","3","0","0.75","293","221","72","Jerry Claiborne"
"1985","Kentucky","5","6","0","0.45455","194","211","-17","Jerry Claiborne"
"1986","Kentucky","5","5","1","0.5","228","207","21","Jerry Claiborne"
"1987","Kentucky","5","6","0","0.45455","258","187","71","Jerry Claiborne"
"1988","Kentucky","5","6","0","0.45455","217","208","9","Jerry Claiborne"
"1989","Kentucky","6","5","0","0.54545","212","220","-8","Jerry Claiborne"
"1990","Kentucky","4","7","0","0.36364","228","316","-88","Bill Curry"
"1991","Kentucky","3","8","0","0.27273","190","268","-78","Bill Curry"
"1992","Kentucky","4","7","0","0.36364","207","280","-73","Bill Curry"
"1993","Kentucky","6","6","0","0.5","220","209","11","Bill Curry"
"1994","Kentucky","1","10","0","0.09091","149","405","-256","Bill Curry"
"1995","Kentucky","4","7","0","0.36364","223","269","-46","Bill Curry"
"1996","Kentucky","4","7","0","0.36364","138","322","-184","Bill Curry"
"1997","Kentucky","5","6","0","0.45455","348","362","-14","Hal Clay Mumme"
"1998","Kentucky","7","5","0","0.58333","431","375","56","Hal Clay Mumme"
"1999","Kentucky","6","6","0","0.5","328","343","-15","Hal Clay Mumme"
"2000","Kentucky","2","9","0","0.18182","254","383","-129","Hal Clay Mumme"
"2001","Kentucky","2","9","0","0.18182","259","367","-108","Guy Morriss"
"2002","Kentucky","7","5","0","0.58333","385","301","84","Guy Morriss"
"2003","Kentucky","4","8","0","0.33333","328","321","7","Rich Brooks"
"2004","Kentucky","2","9","0","0.18182","173","341","-168","Rich Brooks"
"2005","Kentucky","3","8","0","0.27273","239","375","-136","Rich Brooks"
"2006","Kentucky","8","5","0","0.61538","347","369","-22","Rich Brooks"
"2007","Kentucky","8","5","0","0.61538","475","385","90","Rich Brooks"
"2008","Kentucky","7","6","0","0.53846","294","279","15","Rich Brooks"
"2009","Kentucky","7","6","0","0.53846","339","295","44","Rich Brooks"
"2010","Kentucky","6","7","0","0.46154","406","369","37","Joker Phillips"
"2011","Kentucky","5","7","0","0.41667","190","296","-106","Joker Phillips"
"2012","Kentucky","2","10","0","0.16667","215","372","-157","Joker Phillips"
"2013","Kentucky","2","10","0","0.16667","246","374","-128","Mark Stoops"
"2014","Kentucky","5","7","0","0.41667","350","375","-25","Mark Stoops"
"1893","Louisiana St.","0","1","0","0","0","34","-34","Dr. Charles E. Coates"
"1894","Louisiana St.","2","1","0","0.66667","72","26","46","Albert P. Simmons"
"1895","Louisiana St.","3","0","0","1","36","16","20","Albert P. Simmons"
"1896","Louisiana St.","6","0","0","1","136","4","132","Allen W. Jeardeau"
"1897","Louisiana St.","1","1","0","0.5","28","34","-6","Allen W. Jeardeau"
"1899","Louisiana St.","2","4","0","0.33333","86","126","-40","John P. Gregg"
"1898","Louisiana St.","1","0","0","1","37","0","37","Edmond A. Chavanne"
"1900","Louisiana St.","2","2","0","0.5","85","35","50","Edmond A. Chavanne"
"1901","Louisiana St.","5","1","0","0.83333","156","50","106","W.S. Boreland"
"1902","Louisiana St.","6","1","0","0.85714","80","27","53","W.S. Boreland"
"1903","Louisiana St.","4","5","0","0.44444","70","93","-23","W.S. Boreland"
"1904","Louisiana St.","3","4","0","0.42857","38","38","0","Dan A. Killian"
"1905","Louisiana St.","3","0","0","1","36","0","36","Dan A. Killian"
"1906","Louisiana St.","2","2","2","0.5","40","37","3","Dan A. Killian"
"1907","Louisiana St.","7","3","0","0.7","266","52","214","Edgar R. Wingard"
"1908","Louisiana St.","10","0","0","1","442","11","431","Edgar R. Wingard"
"1909","Louisiana St.","4","1","0","0.8","124","15","109","Joe G. Pritchard"
"1909","Louisiana St.","2","1","0","0.66667","64","22","42","John W. Mayhew"
"1910","Louisiana St.","1","5","0","0.16667","45","119","-74","John W. Mayhew"
"1911","Louisiana St.","6","3","0","0.66667","186","32","154","James K. ""Pat"" Dwyer"
"1912","Louisiana St.","4","3","0","0.57143","165","36","129","James K. ""Pat"" Dwyer"
"1913","Louisiana St.","6","1","2","0.77778","200","29","171","James K. ""Pat"" Dwyer"
"1914","Louisiana St.","4","4","1","0.5","163","148","15","Edward Thomas MacDonnell, Sr."
"1915","Louisiana St.","6","2","0","0.75","126","49","77","Edward Thomas MacDonnell, Sr."
"1916","Louisiana St.","4","1","0","0.8","146","14","132","Edward Thomas MacDonnell, Sr."
"1916","Louisiana St.","1","0","2","0.66667","62","21","41","Dana X. Bible"
"1916","Louisiana St.","2","0","0","1","30","10","20","Irving R. Pray"
"1919","Louisiana St.","6","2","0","0.75","161","35","126","Irving R. Pray"
"1922","Louisiana St.","3","7","0","0.3","72","244","-172","Irving R. Pray"
"1917","Louisiana St.","3","5","0","0.375","112","94","18","Wayne Sutton"
"1920","Louisiana St.","5","3","1","0.61111","206","63","143","Branch Bocock"
"1921","Louisiana St.","6","1","1","0.8125","180","56","124","Branch Bocock"
"1923","Louisiana St.","3","5","1","0.38889","103","121","-18","Mike Donahue"
"1924","Louisiana St.","5","4","0","0.55556","124","81","43","Mike Donahue"
"1925","Louisiana St.","5","3","1","0.61111","90","70","20","Mike Donahue"
"1926","Louisiana St.","6","3","0","0.66667","128","45","83","Mike Donahue"
"1927","Louisiana St.","4","4","1","0.5","128","83","45","Mike Donahue"
"1928","Louisiana St.","6","2","1","0.72222","180","45","135","Russell T. ""Russ"" Cohen"
"1929","Louisiana St.","6","3","0","0.66667","246","118","128","Russell T. ""Russ"" Cohen"
"1930","Louisiana St.","6","4","0","0.6","296","72","224","Russell T. ""Russ"" Cohen"
"1931","Louisiana St.","5","4","0","0.55556","137","90","47","Russell T. ""Russ"" Cohen"
"1932","Louisiana St.","6","3","1","0.65","187","31","156","Lawrence M. ""Biff"" Jones"
"1933","Louisiana St.","7","0","3","0.85","176","27","149","Lawrence M. ""Biff"" Jones"
"1934","Louisiana St.","7","2","2","0.72727","172","77","95","Lawrence M. ""Biff"" Jones"
"1935","Louisiana St.","9","2","0","0.81818","223","41","182","Bernie H. Moore"
"1936","Louisiana St.","9","1","1","0.86364","295","54","241","Bernie H. Moore"
"1937","Louisiana St.","9","2","0","0.81818","234","33","201","Bernie H. Moore"
"1938","Louisiana St.","6","4","0","0.6","160","89","71","Bernie H. Moore"
"1939","Louisiana St.","4","5","0","0.44444","111","116","-5","Bernie H. Moore"
"1940","Louisiana St.","6","4","0","0.6","139","112","27","Bernie H. Moore"
"1941","Louisiana St.","4","4","2","0.5","119","93","26","Bernie H. Moore"
"1942","Louisiana St.","7","3","0","0.7","192","117","75","Bernie H. Moore"
"1943","Louisiana St.","6","3","0","0.66667","162","158","4","Bernie H. Moore"
"1944","Louisiana St.","2","5","1","0.3125","92","101","-9","Bernie H. Moore"
"1945","Louisiana St.","7","2","0","0.77778","245","92","153","Bernie H. Moore"
"1946","Louisiana St.","9","1","1","0.86364","240","123","117","Bernie H. Moore"
"1947","Louisiana St.","5","3","1","0.61111","149","161","-12","Bernie H. Moore"
"1948","Louisiana St.","3","7","0","0.3","99","271","-172","Gaynell ""Gus"" Tinsley"
"1949","Louisiana St.","8","3","0","0.72727","231","109","122","Gaynell ""Gus"" Tinsley"
"1950","Louisiana St.","4","5","2","0.45455","165","151","14","Gaynell ""Gus"" Tinsley"
"1951","Louisiana St.","7","3","1","0.68182","128","111","17","Gaynell ""Gus"" Tinsley"
"1952","Louisiana St.","3","7","0","0.3","148","214","-66","Gaynell ""Gus"" Tinsley"
"1953","Louisiana St.","5","3","3","0.59091","194","159","35","Gaynell ""Gus"" Tinsley"
"1954","Louisiana St.","5","6","0","0.45455","125","173","-48","Gaynell ""Gus"" Tinsley"
"1955","Louisiana St.","3","5","2","0.4","139","149","-10","Paul Dietzel"
"1956","Louisiana St.","3","7","0","0.3","104","197","-93","Paul Dietzel"
"1957","Louisiana St.","5","5","0","0.5","159","110","49","Paul Dietzel"
"1958","Louisiana St.","11","0","0","1","282","53","229","Paul Dietzel"
"1959","Louisiana St.","9","2","0","0.81818","164","50","114","Paul Dietzel"
"1960","Louisiana St.","5","4","1","0.55","105","50","55","Paul Dietzel"
"1961","Louisiana St.","10","1","0","0.90909","259","57","202","Paul Dietzel"
"1962","Louisiana St.","9","1","1","0.86364","175","34","141","Charles McClendon"
"1963","Louisiana St.","7","4","0","0.63636","142","112","30","Charles McClendon"
"1964","Louisiana St.","8","2","1","0.77273","128","89","39","Charles McClendon"
"1965","Louisiana St.","8","3","0","0.72727","265","164","101","Charles McClendon"
"1966","Louisiana St.","5","4","1","0.55","135","124","11","Charles McClendon"
"1967","Louisiana St.","7","3","1","0.68182","268","127","141","Charles McClendon"
"1968","Louisiana St.","8","3","0","0.72727","221","171","50","Charles McClendon"
"1969","Louisiana St.","9","1","0","0.9","349","91","258","Charles McClendon"
"1970","Louisiana St.","9","3","0","0.75","289","113","176","Charles McClendon"
"1971","Louisiana St.","9","3","0","0.75","353","153","200","Charles McClendon"
"1972","Louisiana St.","9","2","1","0.79167","252","145","107","Charles McClendon"
"1973","Louisiana St.","9","3","0","0.75","267","169","98","Charles McClendon"
"1974","Louisiana St.","5","5","1","0.5","202","168","34","Charles McClendon"
"1975","Louisiana St.","5","6","0","0.45455","159","202","-43","Charles McClendon"
"1976","Louisiana St.","7","3","1","0.68182","255","149","106","Charles McClendon"
"1977","Louisiana St.","8","4","0","0.66667","389","220","169","Charles McClendon"
"1978","Louisiana St.","8","4","0","0.66667","279","193","86","Charles McClendon"
"1979","Louisiana St.","7","5","0","0.58333","275","151","124","Charles McClendon"
"1980","Louisiana St.","7","4","0","0.63636","213","193","20","Jerry Stovall"
"1981","Louisiana St.","3","7","1","0.31818","169","272","-103","Jerry Stovall"
"1982","Louisiana St.","8","3","1","0.70833","385","191","194","Jerry Stovall"
"1983","Louisiana St.","4","7","0","0.36364","251","253","-2","Jerry Stovall"
"1984","Louisiana St.","8","3","1","0.70833","315","226","89","Bill Arnsparger"
"1985","Louisiana St.","9","2","1","0.79167","227","134","93","Bill Arnsparger"
"1986","Louisiana St.","9","3","0","0.75","306","185","121","Bill Arnsparger"
"1987","Louisiana St.","10","1","1","0.875","365","184","181","Mike Archer"
"1988","Louisiana St.","8","4","0","0.66667","249","204","45","Mike Archer"
"1989","Louisiana St.","4","7","0","0.36364","295","252","43","Mike Archer"
"1990","Louisiana St.","5","6","0","0.45455","183","238","-55","Mike Archer"
"1991","Louisiana St.","5","6","0","0.45455","248","263","-15","Curley Hallman"
"1992","Louisiana St.","2","9","0","0.18182","175","261","-86","Curley Hallman"
"1993","Louisiana St.","5","6","0","0.45455","190","308","-118","Curley Hallman"
"1994","Louisiana St.","4","7","0","0.36364","270","271","-1","Curley Hallman"
"1995","Louisiana St.","7","4","1","0.625","324","186","138","Gerry DiNardo"
"1996","Louisiana St.","10","2","0","0.83333","335","210","125","Gerry DiNardo"
"1997","Louisiana St.","9","3","0","0.75","373","188","185","Gerry DiNardo"
"1998","Louisiana St.","4","7","0","0.36364","337","279","58","Gerry DiNardo"
"1999","Louisiana St.","2","8","0","0.2","188","249","-61","Gerry DiNardo"
"1999","Louisiana St.","1","0","0","1","35","10","25","Hal Hunter"
"2000","Louisiana St.","8","4","0","0.66667","320","235","85","Nick L. Saban"
"2001","Louisiana St.","10","3","0","0.76923","418","302","116","Nick L. Saban"
"2002","Louisiana St.","8","5","0","0.61538","323","238","85","Nick L. Saban"
"2003","Louisiana St.","13","1","0","0.92857","475","154","321","Nick L. Saban"
"2004","Louisiana St.","9","3","0","0.75","344","205","139","Nick L. Saban"
"2005","Louisiana St.","11","2","0","0.84615","383","185","198","Les Miles"
"2006","Louisiana St.","11","2","0","0.84615","438","164","274","Les Miles"
"2007","Louisiana St.","12","2","0","0.85714","541","279","262","Les Miles"
"2008","Louisiana St.","8","5","0","0.61538","402","314","88","Les Miles"
"2009","Louisiana St.","9","4","0","0.69231","323","211","112","Les Miles"
"2010","Louisiana St.","11","2","0","0.84615","386","237","149","Les Miles"
"2011","Louisiana St.","13","1","0","0.92857","500","158","342","Les Miles"
"2012","Louisiana St.","10","3","0","0.76923","387","228","159","Les Miles"
"2013","Louisiana St.","10","3","0","0.76923","465","286","179","Les Miles"
"2014","Louisiana St.","8","5","0","0.61538","359","228","131","Les Miles"
"1901","Louisiana Tech","1","2","0","0.33333","11","73","-62","Edwin Barber"
"1902","Louisiana Tech","0","0","1","0.5","0","0","0","Howard F. Crandell"
"1902","Louisiana Tech","1","1","0","0.5","6","40","-34","Frank Singleton"
"1903","Louisiana Tech","1","1","0","0.5","16","21","-5","W.M. Robb"
"1904","Louisiana Tech","1","3","0","0.25","11","60","-49","E.G. Pierce"
"1905","Louisiana Tech","0","1","0","0","0","16","-16","J.Y. Bragg"
"1906","Louisiana Tech","2","1","3","0.58333","36","22","14","Z.T. Young"
"1907","Louisiana Tech","8","1","0","0.88889","237","37","200","George L. Watkins"
"1908","Louisiana Tech","4","3","1","0.5625","205","91","114","A.L. Cornell"
"1909","Louisiana Tech","5","1","0","0.83333","184","23","161","Percy S. Prince"
"1910","Louisiana Tech","7","0","0","1","265","6","259","Percy S. Prince"
"1911","Louisiana Tech","4","1","1","0.75","98","23","75","Percy S. Prince"
"1912","Louisiana Tech","1","2","1","0.375","33","28","5","Percy S. Prince"
"1913","Louisiana Tech","3","4","1","0.4375","105","72","33","Percy S. Prince"
"1914","Louisiana Tech","2","4","0","0.33333","55","129","-74","Percy S. Prince"
"1915","Louisiana Tech","3","1","2","0.66667","110","33","77","Percy S. Prince"
"1919","Louisiana Tech","0","3","0","0","13","48","-35","Percy S. Prince"
"1916","Louisiana Tech","2","4","0","0.33333","40","66","-26","A. Flack"
"1917","Louisiana Tech","2","3","1","0.41667","72","137","-65","V.S. Pugh"
"1920","Louisiana Tech","5","1","0","0.83333","38","19","19","R.F. Clark"
"1921","Louisiana Tech","6","0","0","1","106","20","86","R.F. Clark"
"1922","Louisiana Tech","5","1","1","0.78571","290","26","264","William H. ""Lone Star"" Dietz"
"1923","Louisiana Tech","6","2","0","0.75","194","63","131","William H. ""Lone Star"" Dietz"
"1924","Louisiana Tech","1","6","1","0.1875","42","139","-97","Phillip H. ""Phil"" Arbuckle"
"1925","Louisiana Tech","1","6","2","0.22222","28","176","-148","R.C. Kenney"
"1926","Louisiana Tech","5","2","2","0.66667","134","60","74","Hugh E. Wilson"
"1927","Louisiana Tech","3","5","0","0.375","83","118","-35","Hugh E. Wilson"
"1928","Louisiana Tech","2","7","0","0.22222","48","235","-187","Ferdinand A. ""Tod"" Rockwell"
"1929","Louisiana Tech","3","4","3","0.45","96","143","-47","Ferdinand A. ""Tod"" Rockwell"
"1930","Louisiana Tech","3","6","0","0.33333","39","187","-148","George M. Bohler"
"1931","Louisiana Tech","7","0","0","1","167","36","131","George M. Bohler"
"1932","Louisiana Tech","4","4","0","0.5","113","83","30","George M. Bohler"
"1933","Louisiana Tech","1","7","0","0.125","32","143","-111","George M. Bohler"
"1934","Louisiana Tech","4","6","0","0.4","89","116","-27","Eddie McLane"
"1935","Louisiana Tech","8","1","0","0.88889","255","42","213","Eddie McLane"
"1936","Louisiana Tech","6","2","1","0.72222","153","47","106","Eddie McLane"
"1937","Louisiana Tech","6","3","2","0.63636","120","60","60","Eddie McLane"
"1938","Louisiana Tech","3","7","1","0.31818","98","163","-65","Eddie McLane"
"1939","Louisiana Tech","5","6","0","0.45455","125","127","-2","Ray E. Davis"
"1940","Louisiana Tech","6","4","0","0.6","106","109","-3","Joe Aillet"
"1941","Louisiana Tech","5","4","1","0.55","134","112","22","Joe Aillet"
"1942","Louisiana Tech","6","3","0","0.66667","252","90","162","Joe Aillet"
"1944","Louisiana Tech","3","5","1","0.38889","120","114","6","Joe Aillet"
"1945","Louisiana Tech","6","4","0","0.6","133","123","10","Joe Aillet"
"1946","Louisiana Tech","7","3","0","0.7","195","87","108","Joe Aillet"
"1947","Louisiana Tech","5","4","0","0.55556","154","107","47","Joe Aillet"
"1948","Louisiana Tech","7","2","1","0.75","183","142","41","Joe Aillet"
"1949","Louisiana Tech","7","2","0","0.77778","231","97","134","Joe Aillet"
"1950","Louisiana Tech","5","4","1","0.55","152","165","-13","Joe Aillet"
"1951","Louisiana Tech","4","5","0","0.44444","157","192","-35","Joe Aillet"
"1952","Louisiana Tech","6","1","2","0.77778","181","117","64","Joe Aillet"
"1953","Louisiana Tech","6","3","0","0.66667","222","119","103","Joe Aillet"
"1954","Louisiana Tech","6","3","0","0.66667","189","131","58","Joe Aillet"
"1955","Louisiana Tech","9","1","0","0.9","251","97","154","Joe Aillet"
"1956","Louisiana Tech","4","3","2","0.55556","101","68","33","Joe Aillet"
"1957","Louisiana Tech","6","4","0","0.6","165","141","24","Joe Aillet"
"1958","Louisiana Tech","7","3","0","0.7","206","104","102","Joe Aillet"
"1959","Louisiana Tech","9","1","0","0.9","191","48","143","Joe Aillet"
"1960","Louisiana Tech","8","2","0","0.8","151","96","55","Joe Aillet"
"1961","Louisiana Tech","5","4","0","0.55556","156","109","47","Joe Aillet"
"1962","Louisiana Tech","4","4","0","0.5","125","124","1","Joe Aillet"
"1963","Louisiana Tech","6","3","0","0.66667","188","103","85","Joe Aillet"
"1964","Louisiana Tech","9","1","0","0.9","157","64","93","Joe Aillet"
"1965","Louisiana Tech","4","4","0","0.5","161","122","39","Joe Aillet"
"1966","Louisiana Tech","1","9","0","0.1","83","205","-122","Joe Aillet"
"1967","Louisiana Tech","3","7","0","0.3","156","242","-86","Maxie Lambright"
"1968","Louisiana Tech","9","2","0","0.81818","337","195","142","Maxie Lambright"
"1969","Louisiana Tech","8","2","0","0.8","331","201","130","Maxie Lambright"
"1970","Louisiana Tech","2","8","0","0.2","165","175","-10","Maxie Lambright"
"1971","Louisiana Tech","9","2","0","0.81818","288","175","113","Maxie Lambright"
"1972","Louisiana Tech","12","0","0","1","333","134","199","Maxie Lambright"
"1973","Louisiana Tech","12","1","0","0.92308","355","106","249","Maxie Lambright"
"1974","Louisiana Tech","11","1","0","0.91667","318","145","173","Maxie Lambright"
"1975","Louisiana Tech","8","2","0","0.8","297","185","112","Maxie Lambright"
"1976","Louisiana Tech","6","5","0","0.54545","336","247","89","Maxie Lambright"
"1977","Louisiana Tech","9","1","2","0.83333","305","147","158","Maxie Lambright"
"1978","Louisiana Tech","6","5","0","0.54545","228","186","42","Maxie Lambright"
"1979","Louisiana Tech","1","0","0","1","13","10","3","Pat Patterson"
"1979","Louisiana Tech","2","8","0","0.2","99","212","-113","Larry Beightol"
"1980","Louisiana Tech","5","6","0","0.45455","193","220","-27","Billy Brewer"
"1981","Louisiana Tech","4","6","1","0.40909","205","241","-36","Billy Brewer"
"1982","Louisiana Tech","10","3","0","0.76923","340","177","163","Billy Brewer"
"1983","Louisiana Tech","4","7","0","0.36364","152","195","-43","A.L. Williams"
"1984","Louisiana Tech","10","5","0","0.66667","310","204","106","A.L. Williams"
"1985","Louisiana Tech","8","3","0","0.72727","259","176","83","A.L. Williams"
"1986","Louisiana Tech","6","4","1","0.59091","206","223","-17","A.L. Williams"
"1987","Louisiana Tech","3","8","0","0.27273","108","197","-89","Carl Torbush"
"1988","Louisiana Tech","4","7","0","0.36364","185","352","-167","Joe Peace"
"1989","Louisiana Tech","4","6","0","0.4","283","265","18","Joe Peace"
"1990","Louisiana Tech","8","3","1","0.70833","365","219","146","Joe Peace"
"1991","Louisiana Tech","8","1","2","0.81818","280","194","86","Joe Peace"
"1992","Louisiana Tech","5","6","0","0.45455","199","167","32","Joe Peace"
"1993","Louisiana Tech","3","8","0","0.27273","143","332","-189","Joe Peace"
"1994","Louisiana Tech","3","8","0","0.27273","164","274","-110","Joe Peace"
"1995","Louisiana Tech","5","6","0","0.45455","320","371","-51","Joe Peace"
"1996","Louisiana Tech","6","5","0","0.54545","351","342","9","Gary Crowton"
"1997","Louisiana Tech","9","2","0","0.81818","364","281","83","Gary Crowton"
"1998","Louisiana Tech","6","6","0","0.5","493","402","91","Gary Crowton"
"1999","Louisiana Tech","8","3","0","0.72727","389","306","83","Jack Bicknell, Jr."
"2000","Louisiana Tech","3","9","0","0.25","317","396","-79","Jack Bicknell, Jr."
"2001","Louisiana Tech","7","5","0","0.58333","406","390","16","Jack Bicknell, Jr."
"2002","Louisiana Tech","4","8","0","0.33333","320","426","-106","Jack Bicknell, Jr."
"2003","Louisiana Tech","5","7","0","0.41667","310","394","-84","Jack Bicknell, Jr."
"2004","Louisiana Tech","6","6","0","0.5","308","385","-77","Jack Bicknell, Jr."
"2005","Louisiana Tech","7","4","0","0.63636","316","281","35","Jack Bicknell, Jr."
"2006","Louisiana Tech","3","10","0","0.23077","242","542","-300","Jack Bicknell, Jr."
"2007","Louisiana Tech","5","7","0","0.41667","249","368","-119","Derek Dooley"
"2008","Louisiana Tech","8","5","0","0.61538","320","308","12","Derek Dooley"
"2009","Louisiana Tech","4","8","0","0.33333","350","309","41","Derek Dooley"
"2010","Louisiana Tech","5","7","0","0.41667","321","368","-47","Sonny Dykes"
"2011","Louisiana Tech","8","5","0","0.61538","391","301","90","Sonny Dykes"
"2012","Louisiana Tech","9","3","0","0.75","618","462","156","Sonny Dykes"
"2013","Louisiana Tech","4","8","0","0.33333","230","315","-85","Skip Holtz"
"2014","Louisiana Tech","9","5","0","0.64286","523","346","177","Skip Holtz"
"1904","Louisiana-Lafayette","4","0","1","0.9","70","29","41","No Team"
"1908","Louisiana-Lafayette","6","0","0","1","93","16","77","C.J. McNaspy"
"1909","Louisiana-Lafayette","5","2","1","0.6875","200","59","141","C.J. McNaspy"
"1910","Louisiana-Lafayette","6","2","1","0.72222","110","123","-13","C.J. McNaspy"
"1911","Louisiana-Lafayette","1","4","1","0.25","35","95","-60","C.J. McNaspy"
"1913","Louisiana-Lafayette","4","4","0","0.5","148","155","-7","C.J. McNaspy"
"1917","Louisiana-Lafayette","8","2","0","0.8","336","46","290","C.J. McNaspy"
"1918","Louisiana-Lafayette","4","1","0","0.8","166","100","66","C.J. McNaspy"
"1912","Louisiana-Lafayette","3","4","0","0.42857","90","239","-149","H. Lee Prather"
"1914","Louisiana-Lafayette","5","3","0","0.625","200","107","93","R.B. Dunbar"
"1915","Louisiana-Lafayette","5","2","1","0.6875","127","41","86","R.B. Dunbar"
"1920","Louisiana-Lafayette","2","8","0","0.2","83","232","-149","Herbert O. Tudor"
"1916","Louisiana-Lafayette","7","1","0","0.875","240","30","210","T.R. Mobley"
"1919","Louisiana-Lafayette","2","4","2","0.375","70","146","-76","T.R. Mobley"
"1921","Louisiana-Lafayette","9","2","0","0.81818","217","104","113","T.R. Mobley"
"1922","Louisiana-Lafayette","3","4","2","0.44444","84","54","30","T.R. Mobley"
"1923","Louisiana-Lafayette","7","3","0","0.7","240","107","133","T.R. Mobley"
"1924","Louisiana-Lafayette","6","2","1","0.72222","214","93","121","T.R. Mobley"
"1925","Louisiana-Lafayette","7","2","0","0.77778","176","72","104","T.R. Mobley"
"1926","Louisiana-Lafayette","6","3","1","0.65","153","98","55","T.R. Mobley"
"1927","Louisiana-Lafayette","2","7","1","0.25","30","195","-165","T.R. Mobley"
"1928","Louisiana-Lafayette","4","5","0","0.44444","113","174","-61","T.R. Mobley"
"1929","Louisiana-Lafayette","2","7","0","0.22222","52","203","-151","T.R. Mobley"
"1930","Louisiana-Lafayette","2","8","0","0.2","52","257","-205","T.R. Mobley"
"1931","Louisiana-Lafayette","1","6","1","0.1875","22","210","-188","T.F. Wilbanks"
"1932","Louisiana-Lafayette","3","4","0","0.42857","46","53","-7","T.F. Wilbanks"
"1933","Louisiana-Lafayette","6","3","0","0.66667","128","35","93","T.F. Wilbanks"
"1934","Louisiana-Lafayette","5","4","0","0.55556","121","70","51","T.F. Wilbanks"
"1935","Louisiana-Lafayette","2","8","0","0.2","48","172","-124","T.F. Wilbanks"
"1936","Louisiana-Lafayette","2","7","1","0.25","54","225","-171","T.F. Wilbanks"
"1937","Louisiana-Lafayette","4","3","1","0.5625","59","51","8","Johnny Cain"
"1938","Louisiana-Lafayette","8","2","1","0.77273","141","68","73","Johnny Cain"
"1939","Louisiana-Lafayette","3","5","1","0.38889","82","60","22","Johnny Cain"
"1940","Louisiana-Lafayette","6","3","1","0.65","77","74","3","Johnny Cain"
"1941","Louisiana-Lafayette","6","2","1","0.72222","124","73","51","Johnny Cain"
"1946","Louisiana-Lafayette","6","4","0","0.6","188","130","58","Johnny Cain"
"1942","Louisiana-Lafayette","3","4","0","0.42857","115","98","17","Louis Whitman"
"1943","Louisiana-Lafayette","5","0","1","0.91667","172","40","132","Louis Whitman"
"1944","Louisiana-Lafayette","5","4","0","0.55556","124","70","54","Louis Whitman"
"1945","Louisiana-Lafayette","1","6","1","0.1875","32","183","-151","Louis Whitman"
"1947","Louisiana-Lafayette","6","2","0","0.75","165","58","107","George ""Gee"" Mitchell"
"1948","Louisiana-Lafayette","6","3","1","0.65","179","134","45","George ""Gee"" Mitchell"
"1949","Louisiana-Lafayette","6","3","0","0.66667","174","145","29","George ""Gee"" Mitchell"
"1950","Louisiana-Lafayette","5","4","0","0.55556","159","100","59","A.L. ""Red"" Swanson"
"1951","Louisiana-Lafayette","6","4","0","0.6","227","198","29","Raymond Didier"
"1952","Louisiana-Lafayette","5","2","2","0.66667","203","131","72","Raymond Didier"
"1953","Louisiana-Lafayette","4","7","0","0.36364","168","247","-79","Raymond Didier"
"1954","Louisiana-Lafayette","5","4","0","0.55556","222","159","63","Raymond Didier"
"1955","Louisiana-Lafayette","5","4","0","0.55556","170","139","31","Raymond Didier"
"1956","Louisiana-Lafayette","4","6","0","0.4","239","299","-60","Raymond Didier"
"1957","Louisiana-Lafayette","4","5","1","0.45","99","143","-44","John Robert Bell"
"1958","Louisiana-Lafayette","1","8","0","0.11111","67","176","-109","Jim ""Red"" Hoggatt"
"1959","Louisiana-Lafayette","4","5","0","0.44444","158","157","1","Jim ""Red"" Hoggatt"
"1960","Louisiana-Lafayette","6","4","0","0.6","137","107","30","Jim ""Red"" Hoggatt"
"1961","Louisiana-Lafayette","2","8","0","0.2","99","194","-95","Russ Faulkinberry"
"1962","Louisiana-Lafayette","4","5","1","0.45","116","143","-27","Russ Faulkinberry"
"1963","Louisiana-Lafayette","4","5","0","0.44444","74","150","-76","Russ Faulkinberry"
"1964","Louisiana-Lafayette","5","4","0","0.55556","140","115","25","Russ Faulkinberry"
"1965","Louisiana-Lafayette","7","3","0","0.7","173","85","88","Russ Faulkinberry"
"1966","Louisiana-Lafayette","6","4","0","0.6","139","103","36","Russ Faulkinberry"
"1967","Louisiana-Lafayette","6","4","0","0.6","142","126","16","Russ Faulkinberry"
"1968","Louisiana-Lafayette","8","2","0","0.8","227","153","74","Russ Faulkinberry"
"1969","Louisiana-Lafayette","5","5","0","0.5","179","237","-58","Russ Faulkinberry"
"1970","Louisiana-Lafayette","9","3","0","0.75","276","176","100","Russ Faulkinberry"
"1971","Louisiana-Lafayette","5","4","1","0.55","171","152","19","Russ Faulkinberry"
"1972","Louisiana-Lafayette","5","6","0","0.45455","160","124","36","Russ Faulkinberry"
"1973","Louisiana-Lafayette","0","10","0","0","75","275","-200","Russ Faulkinberry"
"1974","Louisiana-Lafayette","2","9","0","0.18182","149","287","-138","Augie Tammariello"
"1975","Louisiana-Lafayette","6","5","0","0.54545","259","233","26","Augie Tammariello"
"1976","Louisiana-Lafayette","7","4","0","0.63636","261","148","113","Augie Tammariello"
"1977","Louisiana-Lafayette","6","4","2","0.58333","239","181","58","Augie Tammariello"
"1978","Louisiana-Lafayette","3","8","0","0.27273","127","229","-102","Augie Tammariello"
"1979","Louisiana-Lafayette","4","7","0","0.36364","147","168","-21","Augie Tammariello"
"1980","Louisiana-Lafayette","7","4","0","0.63636","194","144","50","Sam Robertson"
"1981","Louisiana-Lafayette","1","9","1","0.13636","135","229","-94","Sam Robertson"
"1982","Louisiana-Lafayette","7","3","1","0.68182","248","196","52","Sam Robertson"
"1983","Louisiana-Lafayette","4","6","0","0.4","194","212","-18","Sam Robertson"
"1984","Louisiana-Lafayette","6","5","0","0.54545","207","198","9","Sam Robertson"
"1985","Louisiana-Lafayette","4","7","0","0.36364","162","306","-144","Sam Robertson"
"1986","Louisiana-Lafayette","6","5","0","0.54545","242","204","38","Nelson Stokley"
"1987","Louisiana-Lafayette","6","5","0","0.54545","191","252","-61","Nelson Stokley"
"1988","Louisiana-Lafayette","6","5","0","0.54545","296","224","72","Nelson Stokley"
"1989","Louisiana-Lafayette","7","4","0","0.63636","241","232","9","Nelson Stokley"
"1990","Louisiana-Lafayette","5","6","0","0.45455","197","242","-45","Nelson Stokley"
"1991","Louisiana-Lafayette","2","8","1","0.22727","148","269","-121","Nelson Stokley"
"1992","Louisiana-Lafayette","2","9","0","0.18182","143","306","-163","Nelson Stokley"
"1993","Louisiana-Lafayette","8","3","0","0.72727","249","227","22","Nelson Stokley"
"1994","Louisiana-Lafayette","6","5","0","0.54545","221","264","-43","Nelson Stokley"
"1995","Louisiana-Lafayette","6","5","0","0.54545","351","275","76","Nelson Stokley"
"1996","Louisiana-Lafayette","5","6","0","0.45455","304","404","-100","Nelson Stokley"
"1997","Louisiana-Lafayette","1","10","0","0.09091","176","553","-377","Nelson Stokley"
"1998","Louisiana-Lafayette","2","9","0","0.18182","199","453","-254","Nelson Stokley"
"1999","Louisiana-Lafayette","2","9","0","0.18182","203","415","-212","Jerry Baldwin"
"2000","Louisiana-Lafayette","1","10","0","0.09091","171","355","-184","Jerry Baldwin"
"2001","Louisiana-Lafayette","3","8","0","0.27273","234","365","-131","Jerry Baldwin"
"2002","Louisiana-Lafayette","3","9","0","0.25","203","352","-149","Rickey Bustle"
"2003","Louisiana-Lafayette","4","8","0","0.33333","266","415","-149","Rickey Bustle"
"2004","Louisiana-Lafayette","4","7","0","0.36364","242","272","-30","Rickey Bustle"
"2005","Louisiana-Lafayette","6","5","0","0.54545","286","304","-18","Rickey Bustle"
"2006","Louisiana-Lafayette","6","6","0","0.5","248","296","-48","Rickey Bustle"
"2007","Louisiana-Lafayette","3","9","0","0.25","285","430","-145","Rickey Bustle"
"2008","Louisiana-Lafayette","6","6","0","0.5","397","404","-7","Rickey Bustle"
"2009","Louisiana-Lafayette","6","6","0","0.5","266","364","-98","Rickey Bustle"
"2010","Louisiana-Lafayette","3","9","0","0.25","268","444","-176","Rickey Bustle"
"2011","Louisiana-Lafayette","9","4","0","0.69231","420","388","32","Mark Hudspeth"
"2012","Louisiana-Lafayette","9","4","0","0.69231","461","365","96","Mark Hudspeth"
"2013","Louisiana-Lafayette","9","4","0","0.69231","439","344","95","Mark Hudspeth"
"2014","Louisiana-Lafayette","9","4","0","0.69231","383","338","45","Mark Hudspeth"
"1951","Louisiana-Monroe","6","2","0","0.75","253","128","125","James L. Malone"
"1952","Louisiana-Monroe","5","4","0","0.55556","243","210","33","James L. Malone"
"1953","Louisiana-Monroe","1","9","0","0.1","113","284","-171","James L. Malone"
"1954","Louisiana-Monroe","1","8","1","0.15","119","337","-218","Devone Payne"
"1955","Louisiana-Monroe","4","6","0","0.4","100","206","-106","Devone Payne"
"1956","Louisiana-Monroe","8","2","0","0.8","220","155","65","Devone Payne"
"1957","Louisiana-Monroe","2","6","0","0.25","105","128","-23","Devone Payne"
"1958","Louisiana-Monroe","6","3","0","0.66667","189","163","26","Jack C. Rowan"
"1959","Louisiana-Monroe","2","8","0","0.2","116","216","-100","Jack C. Rowan"
"1960","Louisiana-Monroe","3","7","0","0.3","91","136","-45","Jack C. Rowan"
"1961","Louisiana-Monroe","3","7","0","0.3","145","171","-26","Jack C. Rowan"
"1962","Louisiana-Monroe","2","6","0","0.25","74","106","-32","Jack C. Rowan"
"1963","Louisiana-Monroe","4","6","0","0.4","113","141","-28","Jack C. Rowan"
"1964","Louisiana-Monroe","0","8","0","0","58","148","-90","Dixie B. White"
"1965","Louisiana-Monroe","1","8","0","0.11111","58","194","-136","Dixie B. White"
"1966","Louisiana-Monroe","7","3","0","0.7","181","101","80","Dixie B. White"
"1967","Louisiana-Monroe","7","3","0","0.7","196","111","85","Dixie B. White"
"1968","Louisiana-Monroe","6","4","0","0.6","170","101","69","Dixie B. White"
"1969","Louisiana-Monroe","1","9","0","0.1","132","216","-84","Dixie B. White"
"1970","Louisiana-Monroe","5","4","0","0.55556","151","146","5","Dixie B. White"
"1971","Louisiana-Monroe","4","6","1","0.40909","122","208","-86","Dixie B. White"
"1972","Louisiana-Monroe","3","7","0","0.3","125","188","-63","Ollie Keller"
"1973","Louisiana-Monroe","3","5","2","0.4","133","222","-89","Ollie Keller"
"1974","Louisiana-Monroe","4","6","0","0.4","162","189","-27","Ollie Keller"
"1975","Louisiana-Monroe","4","6","1","0.40909","252","273","-21","Ollie Keller"
"1976","Louisiana-Monroe","2","9","0","0.18182","206","321","-115","John David Crow"
"1977","Louisiana-Monroe","2","9","0","0.18182","122","297","-175","John David Crow"
"1978","Louisiana-Monroe","6","4","1","0.59091","190","142","48","John David Crow"
"1979","Louisiana-Monroe","3","8","0","0.27273","158","211","-53","John David Crow"
"1980","Louisiana-Monroe","7","4","0","0.63636","296","267","29","John David Crow"
"1981","Louisiana-Monroe","5","6","0","0.45455","309","251","58","Pat Collins"
"1982","Louisiana-Monroe","8","3","0","0.72727","312","216","96","Pat Collins"
"1983","Louisiana-Monroe","8","3","0","0.72727","251","119","132","Pat Collins"
"1984","Louisiana-Monroe","7","4","0","0.63636","198","159","39","Pat Collins"
"1985","Louisiana-Monroe","6","5","0","0.54545","227","201","26","Pat Collins"
"1986","Louisiana-Monroe","5","6","0","0.45455","231","205","26","Pat Collins"
"1987","Louisiana-Monroe","13","2","0","0.86667","484","343","141","Pat Collins"
"1988","Louisiana-Monroe","5","6","0","0.45455","160","214","-54","Pat Collins"
"1989","Louisiana-Monroe","5","5","1","0.5","201","257","-56","Dave Roberts"
"1990","Louisiana-Monroe","7","5","0","0.58333","208","218","-10","Dave Roberts"
"1991","Louisiana-Monroe","7","3","1","0.68182","237","175","62","Dave Roberts"
"1992","Louisiana-Monroe","10","3","0","0.76923","490","295","195","Dave Roberts"
"1993","Louisiana-Monroe","9","3","0","0.75","462","275","187","Dave Roberts"
"1994","Louisiana-Monroe","3","8","0","0.27273","242","384","-142","Ed Zaunbrecher"
"1995","Louisiana-Monroe","2","9","0","0.18182","233","413","-180","Ed Zaunbrecher"
"1996","Louisiana-Monroe","5","6","0","0.45455","192","353","-161","Ed Zaunbrecher"
"1997","Louisiana-Monroe","5","7","0","0.41667","226","319","-93","Ed Zaunbrecher"
"1998","Louisiana-Monroe","5","6","0","0.45455","227","322","-95","Ed Zaunbrecher"
"1999","Louisiana-Monroe","5","6","0","0.45455","186","322","-136","Bobby Keasler"
"2000","Louisiana-Monroe","1","10","0","0.09091","96","415","-319","Bobby Keasler"
"2001","Louisiana-Monroe","2","9","0","0.18182","148","351","-203","Bobby Keasler"
"2002","Louisiana-Monroe","0","3","0","0","22","123","-101","Bobby Keasler"
"2002","Louisiana-Monroe","3","6","0","0.33333","214","328","-114","Mike Collins"
"2003","Louisiana-Monroe","1","11","0","0.08333","239","467","-228","Charlie Weatherbie"
"2004","Louisiana-Monroe","5","6","0","0.45455","211","303","-92","Charlie Weatherbie"
"2005","Louisiana-Monroe","5","6","0","0.45455","239","339","-100","Charlie Weatherbie"
"2006","Louisiana-Monroe","4","8","0","0.33333","262","267","-5","Charlie Weatherbie"
"2007","Louisiana-Monroe","6","6","0","0.5","282","332","-50","Charlie Weatherbie"
"2008","Louisiana-Monroe","4","8","0","0.33333","284","374","-90","Charlie Weatherbie"
"2009","Louisiana-Monroe","6","6","0","0.5","307","328","-21","Charlie Weatherbie"
"2010","Louisiana-Monroe","5","7","0","0.41667","250","389","-139","Todd Berry"
"2011","Louisiana-Monroe","4","8","0","0.33333","295","305","-10","Todd Berry"
"2012","Louisiana-Monroe","8","5","0","0.61538","440","379","61","Todd Berry"
"2013","Louisiana-Monroe","6","6","0","0.5","267","362","-95","Todd Berry"
"2014","Louisiana-Monroe","4","8","0","0.33333","241","315","-74","Todd Berry"
"1912","Louisville (KY)","4","1","0","0.8","165","47","118","Lester Larson"
"1913","Louisville (KY)","5","1","0","0.83333","251","20","231","Lester Larson"
"1914","Louisville (KY)","1","4","0","0.2","26","135","-109","Dr. Bruce Baker"
"1915","Louisville (KY)","1","5","1","0.21429","35","119","-84","Will Duffy"
"1916","Louisville (KY)","2","3","1","0.41667","37","77","-40","Will Duffy"
"1921","Louisville (KY)","2","2","1","0.5","49","29","20","Bill Duncan"
"1922","Louisville (KY)","2","7","0","0.22222","79","248","-169","Bill Duncan"
"1923","Louisville (KY)","5","3","0","0.625","84","73","11","Fred Enke"
"1924","Louisville (KY)","3","5","1","0.38889","43","95","-52","Fred Enke"
"1925","Louisville (KY)","8","0","0","1","133","2","131","Tom King"
"1926","Louisville (KY)","6","2","0","0.75","226","54","172","Tom King"
"1927","Louisville (KY)","4","4","0","0.5","114","163","-49","Tom King"
"1928","Louisville (KY)","1","7","0","0.125","72","186","-114","Tom King"
"1929","Louisville (KY)","3","5","0","0.375","37","101","-64","Tom King"
"1930","Louisville (KY)","5","3","0","0.625","134","73","61","Tom King"
"1931","Louisville (KY)","0","8","0","0","50","251","-201","Jack McGrath"
"1932","Louisville (KY)","0","9","0","0","18","392","-374","C.V. Money"
"1933","Louisville (KY)","1","7","0","0.125","26","214","-188","Ben Cregor"
"1934","Louisville (KY)","2","5","0","0.28571","40","104","-64","Ben Cregor"
"1935","Louisville (KY)","1","6","1","0.1875","47","133","-86","Ben Cregor"
"1936","Louisville (KY)","4","4","0","0.5","88","134","-46","Laurie Apitz"
"1937","Louisville (KY)","2","5","1","0.3125","60","114","-54","Laurie Apitz"
"1938","Louisville (KY)","2","6","0","0.25","40","80","-40","Laurie Apitz"
"1939","Louisville (KY)","5","2","1","0.6875","92","30","62","Laurie Apitz"
"1940","Louisville (KY)","3","5","1","0.38889","91","134","-43","Laurie Apitz"
"1941","Louisville (KY)","4","4","0","0.5","142","134","8","Laurie Apitz"
"1942","Louisville (KY)","2","3","0","0.4","58","95","-37","Laurie Apitz"
"1946","Louisville (KY)","6","2","0","0.75","136","62","74","Frank Camp"
"1947","Louisville (KY)","7","0","1","0.9375","193","63","130","Frank Camp"
"1948","Louisville (KY)","5","5","0","0.5","186","194","-8","Frank Camp"
"1949","Louisville (KY)","8","3","0","0.72727","344","143","201","Frank Camp"
"1950","Louisville (KY)","3","6","1","0.35","239","238","1","Frank Camp"
"1951","Louisville (KY)","5","4","0","0.55556","151","208","-57","Frank Camp"
"1952","Louisville (KY)","3","5","0","0.375","172","224","-52","Frank Camp"
"1953","Louisville (KY)","1","8","0","0.11111","77","291","-214","Frank Camp"
"1954","Louisville (KY)","3","6","0","0.33333","116","177","-61","Frank Camp"
"1955","Louisville (KY)","7","2","0","0.77778","289","134","155","Frank Camp"
"1956","Louisville (KY)","6","3","0","0.66667","153","111","42","Frank Camp"
"1957","Louisville (KY)","9","1","0","0.9","350","106","244","Frank Camp"
"1958","Louisville (KY)","4","4","0","0.5","144","97","47","Frank Camp"
"1959","Louisville (KY)","6","4","0","0.6","218","132","86","Frank Camp"
"1960","Louisville (KY)","7","2","0","0.77778","196","77","119","Frank Camp"
"1961","Louisville (KY)","6","3","0","0.66667","180","92","88","Frank Camp"
"1962","Louisville (KY)","6","4","0","0.6","174","173","1","Frank Camp"
"1963","Louisville (KY)","3","7","0","0.3","118","213","-95","Frank Camp"
"1964","Louisville (KY)","1","9","0","0.1","70","217","-147","Frank Camp"
"1965","Louisville (KY)","6","4","0","0.6","218","164","54","Frank Camp"
"1966","Louisville (KY)","6","4","0","0.6","231","159","72","Frank Camp"
"1967","Louisville (KY)","5","5","0","0.5","260","162","98","Frank Camp"
"1968","Louisville (KY)","5","5","0","0.5","192","233","-41","Frank Camp"
"1969","Louisville (KY)","5","4","1","0.55","206","273","-67","Lee Corso"
"1970","Louisville (KY)","8","3","1","0.70833","252","208","44","Lee Corso"
"1971","Louisville (KY)","6","3","1","0.65","190","111","79","Lee Corso"
"1972","Louisville (KY)","9","1","0","0.9","309","91","218","Lee Corso"
"1973","Louisville (KY)","5","6","0","0.45455","172","148","24","T.W. Alley"
"1974","Louisville (KY)","4","7","0","0.36364","136","254","-118","T.W. Alley"
"1975","Louisville (KY)","2","9","0","0.18182","148","316","-168","Vince Gibson"
"1976","Louisville (KY)","5","6","0","0.45455","177","234","-57","Vince Gibson"
"1977","Louisville (KY)","7","4","1","0.625","291","194","97","Vince Gibson"
"1978","Louisville (KY)","7","4","0","0.63636","319","202","117","Vince Gibson"
"1979","Louisville (KY)","4","6","1","0.40909","167","202","-35","Vince Gibson"
"1980","Louisville (KY)","5","6","0","0.45455","162","203","-41","Bob Weber"
"1981","Louisville (KY)","5","6","0","0.45455","180","212","-32","Bob Weber"
"1982","Louisville (KY)","5","6","0","0.45455","220","355","-135","Bob Weber"
"1983","Louisville (KY)","3","8","0","0.27273","157","351","-194","Bob Weber"
"1984","Louisville (KY)","2","9","0","0.18182","237","360","-123","Bob Weber"
"1985","Louisville (KY)","2","9","0","0.18182","199","429","-230","Howard Schnellenberger"
"1986","Louisville (KY)","3","8","0","0.27273","179","303","-124","Howard Schnellenberger"
"1987","Louisville (KY)","3","7","1","0.31818","215","348","-133","Howard Schnellenberger"
"1988","Louisville (KY)","8","3","0","0.72727","261","245","16","Howard Schnellenberger"
"1989","Louisville (KY)","6","5","0","0.54545","312","222","90","Howard Schnellenberger"
"1990","Louisville (KY)","10","1","1","0.875","345","149","196","Howard Schnellenberger"
"1991","Louisville (KY)","2","9","0","0.18182","135","335","-200","Howard Schnellenberger"
"1992","Louisville (KY)","5","6","0","0.45455","214","243","-29","Howard Schnellenberger"
"1993","Louisville (KY)","9","3","0","0.75","350","243","107","Howard Schnellenberger"
"1994","Louisville (KY)","6","5","0","0.54545","255","253","2","Howard Schnellenberger"
"1995","Louisville (KY)","7","4","0","0.63636","283","165","118","Ron Cooper"
"1996","Louisville (KY)","5","6","0","0.45455","182","205","-23","Ron Cooper"
"1997","Louisville (KY)","1","10","0","0.09091","245","407","-162","Ron Cooper"
"1998","Louisville (KY)","7","5","0","0.58333","473","435","38","John L. Smith"
"1999","Louisville (KY)","7","5","0","0.58333","443","365","78","John L. Smith"
"2000","Louisville (KY)","9","3","0","0.75","405","268","137","John L. Smith"
"2001","Louisville (KY)","11","2","0","0.84615","394","223","171","John L. Smith"
"2002","Louisville (KY)","7","6","0","0.53846","374","319","55","John L. Smith"
"2003","Louisville (KY)","9","4","0","0.69231","450","361","89","Bobby ""Bob"" Petrino"
"2004","Louisville (KY)","11","1","0","0.91667","597","236","361","Bobby ""Bob"" Petrino"
"2005","Louisville (KY)","9","3","0","0.75","521","285","236","Bobby ""Bob"" Petrino"
"2006","Louisville (KY)","12","1","0","0.92308","491","212","279","Bobby ""Bob"" Petrino"
"2014","Louisville (KY)","9","4","0","0.69231","405","283","122","Bobby ""Bob"" Petrino"
"2007","Louisville (KY)","6","6","0","0.5","422","377","45","Steve Kragthorpe"
"2008","Louisville (KY)","5","7","0","0.41667","296","358","-62","Steve Kragthorpe"
"2009","Louisville (KY)","4","8","0","0.33333","217","315","-98","Steve Kragthorpe"
"2010","Louisville (KY)","7","6","0","0.53846","343","252","91","Charlie Strong"
"2011","Louisville (KY)","7","6","0","0.53846","285","261","24","Charlie Strong"
"2012","Louisville (KY)","11","2","0","0.84615","405","309","96","Charlie Strong"
"2013","Louisville (KY)","12","1","0","0.92308","457","158","299","Charlie Strong"
"1900","Maryland","3","4","1","0.4375","68","67","1","F.H. Peters"
"1901","Maryland","1","7","0","0.125","49","129","-80","Emmons Dunbar"
"1902","Maryland","3","5","2","0.4","28","90","-62","D. John Markey"
"1903","Maryland","7","4","0","0.63636","104","64","40","D. John Markey"
"1904","Maryland","2","4","2","0.375","33","62","-29","D. John Markey"
"1905","Maryland","6","4","0","0.6","131","66","65","Fred K. Neilson"
"1906","Maryland","5","3","0","0.625","98","73","25","Fred K. Neilson"
"1907","Maryland","3","5","0","0.375","45","61","-16","Charles W. Melick"
"1908","Maryland","3","8","0","0.27273","27","204","-177","William Lang"
"1909","Maryland","2","5","0","0.28571","19","101","-82","William Lang & Dr. Edward Larkin"
"1910","Maryland","4","3","1","0.5625","73","42","31","Royal Alston"
"1911","Maryland","2","4","2","0.375","25","70","-45","Charley F. Donnelly"
"1911","Maryland","2","0","0","1","12","2","10","H.C. ""Curley"" Byrd"
"1912","Maryland","6","1","1","0.8125","191","60","131","H.C. ""Curley"" Byrd"
"1913","Maryland","6","3","0","0.66667","184","139","45","H.C. ""Curley"" Byrd"
"1914","Maryland","5","3","0","0.625","72","49","23","H.C. ""Curley"" Byrd"
"1915","Maryland","6","3","0","0.66667","161","69","92","H.C. ""Curley"" Byrd"
"1916","Maryland","6","2","0","0.75","142","52","90","H.C. ""Curley"" Byrd"
"1917","Maryland","4","3","1","0.5625","89","159","-70","H.C. ""Curley"" Byrd"
"1918","Maryland","4","1","1","0.75","57","35","22","H.C. ""Curley"" Byrd"
"1919","Maryland","5","4","0","0.55556","93","74","19","H.C. ""Curley"" Byrd"
"1920","Maryland","7","2","0","0.77778","149","55","94","H.C. ""Curley"" Byrd"
"1921","Maryland","3","5","1","0.38889","45","127","-82","H.C. ""Curley"" Byrd"
"1922","Maryland","4","5","1","0.45","77","137","-60","H.C. ""Curley"" Byrd"
"1923","Maryland","7","2","1","0.75","214","56","158","H.C. ""Curley"" Byrd"
"1924","Maryland","3","3","3","0.5","74","78","-4","H.C. ""Curley"" Byrd"
"1925","Maryland","2","5","1","0.3125","53","82","-29","H.C. ""Curley"" Byrd"
"1926","Maryland","5","4","1","0.55","161","93","68","H.C. ""Curley"" Byrd"
"1927","Maryland","4","7","0","0.36364","186","144","42","H.C. ""Curley"" Byrd"
"1928","Maryland","6","3","1","0.65","132","70","62","H.C. ""Curley"" Byrd"
"1929","Maryland","4","4","2","0.5","148","133","15","H.C. ""Curley"" Byrd"
"1930","Maryland","7","5","0","0.58333","231","142","89","H.C. ""Curley"" Byrd"
"1931","Maryland","8","1","1","0.85","194","98","96","H.C. ""Curley"" Byrd"
"1932","Maryland","5","6","0","0.45455","148","158","-10","H.C. ""Curley"" Byrd"
"1933","Maryland","3","7","0","0.3","107","149","-42","H.C. ""Curley"" Byrd"
"1934","Maryland","7","3","0","0.7","143","49","94","H.C. ""Curley"" Byrd"
"1935","Maryland","7","2","2","0.72727","127","78","49","John E. ""Jack"" Faber"
"1940","Maryland","2","6","1","0.27778","39","171","-132","John E. ""Jack"" Faber"
"1941","Maryland","3","5","1","0.38889","49","196","-147","John E. ""Jack"" Faber"
"1936","Maryland","6","5","0","0.54545","117","59","58","Frank M. Dobson"
"1937","Maryland","8","2","0","0.8","127","65","62","Frank M. Dobson"
"1938","Maryland","2","7","0","0.22222","86","235","-149","Frank M. Dobson"
"1939","Maryland","2","7","0","0.22222","64","106","-42","Frank M. Dobson"
"1942","Maryland","7","2","0","0.77778","198","124","74","Clark D. Shaughnessy"
"1946","Maryland","3","6","0","0.33333","136","193","-57","Clark D. Shaughnessy"
"1943","Maryland","4","5","0","0.44444","105","194","-89","Clarence W. ""Doc"" Spears"
"1944","Maryland","1","7","1","0.16667","46","170","-124","Clarence W. ""Doc"" Spears"
"1945","Maryland","6","2","1","0.72222","219","105","114","Paul W. ""Bear"" Bryant"
"1947","Maryland","7","2","2","0.72727","207","121","86","James M. ""Jim"" Tatum"
"1948","Maryland","6","4","0","0.6","207","132","75","James M. ""Jim"" Tatum"
"1949","Maryland","9","1","0","0.9","266","82","184","James M. ""Jim"" Tatum"
"1950","Maryland","7","2","1","0.75","274","120","154","James M. ""Jim"" Tatum"
"1951","Maryland","10","0","0","1","381","75","306","James M. ""Jim"" Tatum"
"1952","Maryland","7","2","0","0.77778","218","85","133","James M. ""Jim"" Tatum"
"1953","Maryland","10","1","0","0.90909","298","38","260","James M. ""Jim"" Tatum"
"1954","Maryland","7","2","1","0.75","280","67","213","James M. ""Jim"" Tatum"
"1955","Maryland","10","1","0","0.90909","217","77","140","James M. ""Jim"" Tatum"
"1956","Maryland","3","6","1","0.35","68","168","-100","Thomas A. ""Tommy"" Mont"
"1957","Maryland","5","5","0","0.5","119","144","-25","Thomas A. ""Tommy"" Mont"
"1958","Maryland","4","6","0","0.4","132","175","-43","Thomas A. ""Tommy"" Mont"
"1959","Maryland","5","5","0","0.5","184","188","-4","Thomas N. ""Tom"" Nugent"
"1960","Maryland","6","4","0","0.6","171","164","7","Thomas N. ""Tom"" Nugent"
"1961","Maryland","7","3","0","0.7","156","141","15","Thomas N. ""Tom"" Nugent"
"1962","Maryland","6","4","0","0.6","170","128","42","Thomas N. ""Tom"" Nugent"
"1963","Maryland","3","7","0","0.3","148","201","-53","Thomas N. ""Tom"" Nugent"
"1964","Maryland","5","5","0","0.5","164","126","38","Thomas N. ""Tom"" Nugent"
"1965","Maryland","4","6","0","0.4","132","164","-32","Thomas N. ""Tom"" Nugent"
"1966","Maryland","4","6","0","0.4","180","204","-24","Louis Henry ""Lou"" Saban"
"1967","Maryland","0","9","0","0","46","231","-185","Bob Ward"
"1968","Maryland","2","8","0","0.2","171","299","-128","Bob Ward"
"1969","Maryland","3","7","0","0.3","100","249","-149","Roy Lester"
"1970","Maryland","2","9","0","0.18182","112","241","-129","Roy Lester"
"1971","Maryland","2","9","0","0.18182","224","283","-59","Roy Lester"
"1972","Maryland","5","5","1","0.5","243","217","26","Jerry Claiborne"
"1973","Maryland","8","4","0","0.66667","335","141","194","Jerry Claiborne"
"1974","Maryland","8","4","0","0.66667","316","104","212","Jerry Claiborne"
"1975","Maryland","9","2","1","0.79167","312","150","162","Jerry Claiborne"
"1976","Maryland","11","1","0","0.91667","294","115","179","Jerry Claiborne"
"1977","Maryland","8","4","0","0.66667","254","179","75","Jerry Claiborne"
"1978","Maryland","9","3","0","0.75","261","167","94","Jerry Claiborne"
"1979","Maryland","7","4","0","0.63636","198","135","63","Jerry Claiborne"
"1980","Maryland","8","4","0","0.66667","211","165","46","Jerry Claiborne"
"1981","Maryland","4","6","1","0.40909","232","194","38","Jerry Claiborne"
"1982","Maryland","8","4","0","0.66667","373","220","153","Bobby Ross"
"1983","Maryland","8","4","0","0.66667","316","253","63","Bobby Ross"
"1984","Maryland","9","3","0","0.75","380","280","100","Bobby Ross"
"1985","Maryland","9","3","0","0.75","326","192","134","Bobby Ross"
"1986","Maryland","5","5","1","0.5","262","211","51","Bobby Ross"
"1987","Maryland","4","7","0","0.36364","194","301","-107","Joe Krivak"
"1988","Maryland","5","6","0","0.45455","260","304","-44","Joe Krivak"
"1989","Maryland","3","7","1","0.31818","215","238","-23","Joe Krivak"
"1990","Maryland","6","5","1","0.54167","237","284","-47","Joe Krivak"
"1991","Maryland","2","9","0","0.18182","138","302","-164","Joe Krivak"
"1992","Maryland","3","8","0","0.27273","292","365","-73","Mark Duffner"
"1993","Maryland","2","9","0","0.18182","243","479","-236","Mark Duffner"
"1994","Maryland","4","7","0","0.36364","270","326","-56","Mark Duffner"
"1995","Maryland","6","5","0","0.54545","210","251","-41","Mark Duffner"
"1996","Maryland","5","6","0","0.45455","187","239","-52","Mark Duffner"
"1997","Maryland","2","9","0","0.18182","161","355","-194","Ron Vanderlinden"
"1998","Maryland","3","8","0","0.27273","202","290","-88","Ron Vanderlinden"
"1999","Maryland","5","6","0","0.45455","292","260","32","Ron Vanderlinden"
"2000","Maryland","5","6","0","0.45455","247","284","-37","Ron Vanderlinden"
"2001","Maryland","10","2","0","0.83333","413","266","147","Ralph Friedgen"
"2002","Maryland","11","3","0","0.78571","451","228","223","Ralph Friedgen"
"2003","Maryland","10","3","0","0.76923","406","206","200","Ralph Friedgen"
"2004","Maryland","5","6","0","0.45455","195","220","-25","Ralph Friedgen"
"2005","Maryland","5","6","0","0.45455","270","275","-5","Ralph Friedgen"
"2006","Maryland","9","4","0","0.69231","284","284","0","Ralph Friedgen"
"2007","Maryland","6","7","0","0.46154","313","280","33","Ralph Friedgen"
"2008","Maryland","8","5","0","0.61538","283","292","-9","Ralph Friedgen"
"2009","Maryland","2","10","0","0.16667","256","375","-119","Ralph Friedgen"
"2010","Maryland","9","4","0","0.69231","419","288","131","Ralph Friedgen"
"2011","Maryland","2","10","0","0.16667","277","411","-134","Randy Edsall"
"2012","Maryland","4","8","0","0.33333","241","326","-85","Randy Edsall"
"2013","Maryland","7","6","0","0.53846","340","329","11","Randy Edsall"
"2014","Maryland","7","6","0","0.53846","370","392","-22","Randy Edsall"
"1898","Massachusetts","1","4","1","0.25","40","46","-6","Doctor Weeks"
"1899","Massachusetts","7","3","0","0.7","136","66","70","Frederick W. ""Fred"" Murphy"
"1900","Massachusetts","8","9","1","0.47222","165","160","5","Frederick W. ""Fred"" Murphy"
"1901","Massachusetts","9","1","0","0.9","90","29","61","James Halligan"
"1902","Massachusetts","2","3","2","0.42857","40","27","13","James Halligan"
"1903","Massachusetts","5","4","0","0.55556","103","46","57","James Halligan"
"1904","Massachusetts","5","2","1","0.6875","97","50","47","Matthew Washington Bullock"
"1907","Massachusetts","5","3","1","0.61111","78","31","47","Matthew Washington Bullock"
"1908","Massachusetts","3","3","3","0.5","43","143","-100","Matthew Washington Bullock"
"1905","Massachusetts","3","7","0","0.3","47","125","-78","Walter Craig"
"1906","Massachusetts","1","7","1","0.16667","33","119","-86","George E. O'Hearn"
"1909","Massachusetts","1","6","2","0.22222","27","110","-83","J.W. Gage"
"1910","Massachusetts","1","6","2","0.22222","28","126","-98","Willard H. Gildersleeve"
"1911","Massachusetts","2","7","0","0.22222","29","112","-83","John H. Hubbard"
"1912","Massachusetts","2","5","2","0.33333","76","126","-50","Arthur E. Brides"
"1913","Massachusetts","4","3","0","0.57143","96","41","55","Arthur E. Brides"
"1914","Massachusetts","2","5","0","0.28571","36","84","-48","Arthur E. Brides"
"1915","Massachusetts","4","2","2","0.625","113","54","59","Arthur E. Brides"
"1916","Massachusetts","2","4","2","0.375","25","180","-155","George Melican"
"1919","Massachusetts","5","2","1","0.6875","114","54","60","Harold Gore"
"1920","Massachusetts","5","2","1","0.6875","126","64","62","Harold Gore"
"1921","Massachusetts","3","4","1","0.4375","78","90","-12","Harold Gore"
"1922","Massachusetts","5","3","0","0.625","77","82","-5","Harold Gore"
"1923","Massachusetts","2","5","0","0.28571","61","65","-4","Harold Gore"
"1924","Massachusetts","6","1","1","0.8125","185","61","124","Harold Gore"
"1925","Massachusetts","6","2","0","0.75","165","75","90","Harold Gore"
"1926","Massachusetts","1","6","0","0.14286","33","110","-77","Harold Gore"
"1927","Massachusetts","0","7","1","0.0625","13","135","-122","Harold Gore"
"1928","Massachusetts","2","5","1","0.3125","25","90","-65","Charles McGeoch"
"1929","Massachusetts","3","4","1","0.4375","56","82","-26","Charles McGeoch"
"1930","Massachusetts","1","8","0","0.11111","32","248","-216","Charles McGeoch"
"1931","Massachusetts","7","1","1","0.83333","250","58","192","Mel Taube"
"1932","Massachusetts","7","2","0","0.77778","194","64","130","Mel Taube"
"1933","Massachusetts","5","3","0","0.625","108","65","43","Mel Taube"
"1934","Massachusetts","5","3","1","0.61111","119","40","79","Mel Taube"
"1935","Massachusetts","5","4","0","0.55556","117","105","12","Mel Taube"
"1936","Massachusetts","2","6","0","0.25","92","94","-2","Elbert Caraway"
"1937","Massachusetts","1","7","1","0.16667","44","135","-91","Elbert Caraway"
"1938","Massachusetts","3","6","0","0.33333","62","125","-63","Elbert Caraway"
"1939","Massachusetts","2","5","2","0.33333","67","103","-36","Elbert Caraway"
"1940","Massachusetts","1","8","0","0.11111","33","142","-109","Elbert Caraway"
"1941","Massachusetts","3","4","1","0.4375","93","120","-27","Walter Hargesheimer"
"1942","Massachusetts","2","5","0","0.28571","43","125","-82","Walter Hargesheimer"
"1946","Massachusetts","6","2","0","0.75","184","48","136","Walter Hargesheimer"
"1945","Massachusetts","2","1","1","0.625","33","32","1","Thomas Eck"
"1947","Massachusetts","3","4","1","0.4375","118","81","37","Thomas Eck"
"1948","Massachusetts","3","4","1","0.4375","124","123","1","Thomas Eck"
"1949","Massachusetts","3","5","0","0.375","150","122","28","Thomas Eck"
"1950","Massachusetts","3","5","0","0.375","167","153","14","Thomas Eck"
"1951","Massachusetts","3","4","1","0.4375","114","110","4","Thomas Eck"
"1952","Massachusetts","4","3","1","0.5625","189","137","52","Charlie O'Rourke"
"1953","Massachusetts","1","7","0","0.125","101","239","-138","Charlie O'Rourke"
"1954","Massachusetts","4","4","0","0.5","127","210","-83","Charlie O'Rourke"
"1955","Massachusetts","4","4","0","0.5","172","183","-11","Charlie O'Rourke"
"1956","Massachusetts","2","5","1","0.3125","90","223","-133","Charlie O'Rourke"
"1957","Massachusetts","1","5","1","0.21429","60","198","-138","Charlie O'Rourke"
"1958","Massachusetts","2","6","0","0.25","117","177","-60","Charlie O'Rourke"
"1959","Massachusetts","3","5","1","0.38889","111","182","-71","Charlie O'Rourke"
"1960","Massachusetts","7","2","0","0.77778","173","121","52","Charles ""Chuck"" Studley"
"1961","Massachusetts","5","4","0","0.55556","146","147","-1","Vic Fusia"
"1962","Massachusetts","6","3","0","0.66667","165","116","49","Vic Fusia"
"1963","Massachusetts","8","0","1","0.94444","265","12","253","Vic Fusia"
"1964","Massachusetts","8","2","0","0.8","222","76","146","Vic Fusia"
"1965","Massachusetts","7","2","0","0.77778","253","59","194","Vic Fusia"
"1966","Massachusetts","6","3","0","0.66667","117","104","13","Vic Fusia"
"1967","Massachusetts","7","2","0","0.77778","192","120","72","Vic Fusia"
"1968","Massachusetts","2","8","0","0.2","155","200","-45","Vic Fusia"
"1969","Massachusetts","6","3","0","0.66667","265","130","135","Vic Fusia"
"1970","Massachusetts","4","5","1","0.45","190","145","45","Vic Fusia"
"1971","Massachusetts","4","4","1","0.5","147","209","-62","Dick MacPherson"
"1972","Massachusetts","9","2","0","0.81818","369","155","214","Dick MacPherson"
"1973","Massachusetts","6","5","0","0.54545","231","244","-13","Dick MacPherson"
"1974","Massachusetts","5","6","0","0.45455","219","232","-13","Dick MacPherson"
"1975","Massachusetts","8","2","0","0.8","210","102","108","Dick MacPherson"
"1976","Massachusetts","5","5","0","0.5","146","178","-32","Dick MacPherson"
"1977","Massachusetts","8","3","0","0.72727","274","145","129","Dick MacPherson"
"1978","Massachusetts","9","4","0","0.69231","343","173","170","Bob Pickett"
"1979","Massachusetts","6","4","0","0.6","207","154","53","Bob Pickett"
"1980","Massachusetts","7","3","0","0.7","212","105","107","Bob Pickett"
"1981","Massachusetts","6","3","0","0.66667","173","184","-11","Bob Pickett"
"1982","Massachusetts","5","6","0","0.45455","220","227","-7","Bob Pickett"
"1983","Massachusetts","3","8","0","0.27273","141","229","-88","Bob Pickett"
"1984","Massachusetts","3","8","0","0.27273","148","219","-71","Bob Stull"
"1985","Massachusetts","7","4","0","0.63636","198","127","71","Bob Stull"
"1986","Massachusetts","8","3","0","0.72727","251","258","-7","Jim Reid"
"1987","Massachusetts","3","8","0","0.27273","257","298","-41","Jim Reid"
"1988","Massachusetts","8","4","0","0.66667","343","291","52","Jim Reid"
"1989","Massachusetts","5","5","1","0.5","298","296","2","Jim Reid"
"1990","Massachusetts","8","2","1","0.77273","224","175","49","Jim Reid"
"1991","Massachusetts","4","7","0","0.36364","205","208","-3","Jim Reid"
"1992","Massachusetts","7","3","0","0.7","180","151","29","Mike Hodges"
"1993","Massachusetts","9","2","0","0.81818","284","221","63","Mike Hodges"
"1994","Massachusetts","5","6","0","0.45455","208","221","-13","Mike Hodges"
"1995","Massachusetts","6","5","0","0.54545","261","227","34","Mike Hodges"
"1996","Massachusetts","6","5","0","0.54545","257","294","-37","Mike Hodges"
"1997","Massachusetts","2","9","0","0.18182","149","367","-218","Mike Hodges"
"1998","Massachusetts","12","3","0","0.8","524","423","101","Mark Whipple"
"1999","Massachusetts","9","4","0","0.69231","415","244","171","Mark Whipple"
"2000","Massachusetts","7","4","0","0.63636","312","246","66","Mark Whipple"
"2001","Massachusetts","3","8","0","0.27273","178","342","-164","Mark Whipple"
"2002","Massachusetts","8","4","0","0.66667","327","250","77","Mark Whipple"
"2003","Massachusetts","10","3","0","0.76923","368","295","73","Mark Whipple"
"2014","Massachusetts","3","9","0","0.25","328","396","-68","Mark Whipple"
"2004","Massachusetts","6","5","0","0.54545","279","256","23","Don Brown"
"2005","Massachusetts","7","4","0","0.63636","259","146","113","Don Brown"
"2006","Massachusetts","13","2","0","0.86667","413","200","213","Don Brown"
"2007","Massachusetts","10","3","0","0.76923","403","249","154","Don Brown"
"2008","Massachusetts","7","5","0","0.58333","345","321","24","Don Brown"
"2009","Massachusetts","5","6","0","0.45455","295","244","51","Kevin Morris"
"2010","Massachusetts","6","5","0","0.54545","292","277","15","Kevin Morris"
"2011","Massachusetts","5","6","0","0.45455","277","307","-30","Kevin Morris"
"2012","Massachusetts","1","11","0","0.08333","152","482","-330","Charley Molnar"
"2013","Massachusetts","1","11","0","0.08333","140","396","-256","Charley Molnar"
"1912","Memphis (TN)","1","2","1","0.375","13","15","-2","Clyde Wilson"
"1913","Memphis (TN)","1","3","0","0.25","26","107","-81","Clyde Wilson"
"1914","Memphis (TN)","3","5","0","0.375","65","102","-37","Clyde Wilson"
"1915","Memphis (TN)","4","3","0","0.57143","186","138","48","Clyde Wilson"
"1916","Memphis (TN)","2","3","1","0.41667","152","90","62","Tom Shea (1)"
"1917","Memphis (TN)","3","2","0","0.6","47","68","-21","V.M. ""Bic"" Campbell"
"1919","Memphis (TN)","3","4","0","0.42857","91","66","25","V.M. ""Bic"" Campbell"
"1918","Memphis (TN)","2","4","0","0.33333","68","96","-28","John Childerson"
"1920","Memphis (TN)","0","7","0","0","36","183","-147","Elmore George"
"1921","Memphis (TN)","4","5","1","0.45","86","205","-119","Rollin Wilson"
"1922","Memphis (TN)","5","2","3","0.65","174","26","148","Lester Barnard"
"1923","Memphis (TN)","6","3","0","0.66667","77","55","22","Lester Barnard"
"1924","Memphis (TN)","1","7","1","0.16667","40","239","-199","Zach Curlin"
"1925","Memphis (TN)","0","7","1","0.0625","37","251","-214","Zach Curlin"
"1926","Memphis (TN)","1","9","0","0.1","39","200","-161","Zach Curlin"
"1927","Memphis (TN)","5","3","1","0.61111","156","116","40","Zach Curlin"
"1928","Memphis (TN)","5","3","2","0.6","157","120","37","Zach Curlin"
"1929","Memphis (TN)","8","0","2","0.9","146","27","119","Zach Curlin"
"1930","Memphis (TN)","6","3","1","0.65","161","92","69","Zach Curlin"
"1931","Memphis (TN)","2","5","2","0.33333","33","102","-69","Zach Curlin"
"1932","Memphis (TN)","4","5","0","0.44444","61","54","7","Zach Curlin"
"1933","Memphis (TN)","7","1","1","0.83333","147","44","103","Zach Curlin"
"1934","Memphis (TN)","3","3","2","0.5","75","63","12","Zach Curlin"
"1935","Memphis (TN)","1","6","1","0.1875","30","209","-179","Zach Curlin"
"1936","Memphis (TN)","0","9","0","0","14","282","-268","Zach Curlin"
"1937","Memphis (TN)","3","6","0","0.33333","117","99","18","Allyn McKeen"
"1938","Memphis (TN)","10","0","0","1","281","41","240","Allyn McKeen"
"1939","Memphis (TN)","3","8","0","0.27273","85","159","-74","C.C. Humphreys"
"1940","Memphis (TN)","5","5","0","0.5","150","172","-22","C.C. Humphreys"
"1941","Memphis (TN)","6","3","0","0.66667","172","76","96","C.C. Humphreys"
"1942","Memphis (TN)","2","7","0","0.22222","87","255","-168","Charlie Jamerson"
"1947","Memphis (TN)","6","2","1","0.72222","238","60","178","Ralph Hatley"
"1948","Memphis (TN)","6","5","0","0.54545","218","129","89","Ralph Hatley"
"1949","Memphis (TN)","9","1","0","0.9","385","73","312","Ralph Hatley"
"1950","Memphis (TN)","9","2","0","0.81818","374","108","266","Ralph Hatley"
"1951","Memphis (TN)","5","3","0","0.625","206","93","113","Ralph Hatley"
"1952","Memphis (TN)","2","7","0","0.22222","141","263","-122","Ralph Hatley"
"1953","Memphis (TN)","6","4","0","0.6","135","140","-5","Ralph Hatley"
"1954","Memphis (TN)","3","4","3","0.45","166","209","-43","Ralph Hatley"
"1955","Memphis (TN)","2","7","0","0.22222","94","218","-124","Ralph Hatley"
"1956","Memphis (TN)","5","4","1","0.55","209","152","57","Ralph Hatley"
"1957","Memphis (TN)","6","4","0","0.6","195","111","84","Ralph Hatley"
"1958","Memphis (TN)","4","5","0","0.44444","142","144","-2","Billy J. Murphy"
"1959","Memphis (TN)","6","4","0","0.6","142","132","10","Billy J. Murphy"
"1960","Memphis (TN)","8","2","0","0.8","303","85","218","Billy J. Murphy"
"1961","Memphis (TN)","8","2","0","0.8","332","75","257","Billy J. Murphy"
"1962","Memphis (TN)","8","1","0","0.88889","261","67","194","Billy J. Murphy"
"1963","Memphis (TN)","9","0","1","0.95","199","52","147","Billy J. Murphy"
"1964","Memphis (TN)","5","4","0","0.55556","173","103","70","Billy J. Murphy"
"1965","Memphis (TN)","5","5","0","0.5","215","153","62","Billy J. Murphy"
"1966","Memphis (TN)","7","2","0","0.77778","121","96","25","Billy J. Murphy"
"1967","Memphis (TN)","6","3","0","0.66667","206","150","56","Billy J. Murphy"
"1968","Memphis (TN)","6","4","0","0.6","258","170","88","Billy J. Murphy"
"1969","Memphis (TN)","8","2","0","0.8","328","191","137","Billy J. Murphy"
"1970","Memphis (TN)","6","4","0","0.6","227","184","43","Billy J. Murphy"
"1971","Memphis (TN)","5","6","0","0.45455","255","202","53","Billy J. Murphy"
"1972","Memphis (TN)","5","5","1","0.5","265","254","11","Fred Pancoast"
"1973","Memphis (TN)","8","3","0","0.72727","264","167","97","Fred Pancoast"
"1974","Memphis (TN)","7","4","0","0.63636","225","148","77","Fred Pancoast"
"1975","Memphis (TN)","7","4","0","0.63636","180","168","12","Richard Williamson"
"1976","Memphis (TN)","8","3","0","0.72727","241","182","59","Richard Williamson"
"1977","Memphis (TN)","6","5","0","0.54545","228","194","34","Richard Williamson"
"1978","Memphis (TN)","4","7","0","0.36364","200","297","-97","Richard Williamson"
"1979","Memphis (TN)","5","6","0","0.45455","166","223","-57","Richard Williamson"
"1980","Memphis (TN)","2","9","0","0.18182","115","255","-140","Richard Williamson"
"1981","Memphis (TN)","1","10","0","0.09091","82","209","-127","Rex Dockery"
"1982","Memphis (TN)","1","10","0","0.09091","129","284","-155","Rex Dockery"
"1983","Memphis (TN)","6","4","1","0.59091","274","205","69","Rex Dockery"
"1984","Memphis (TN)","5","5","1","0.5","201","178","23","Rey Dempsey"
"1985","Memphis (TN)","2","7","2","0.27273","180","243","-63","Rey Dempsey"
"1986","Memphis (TN)","1","10","0","0.09091","104","292","-188","Charlie Bailey"
"1987","Memphis (TN)","5","5","1","0.5","220","210","10","Charlie Bailey"
"1988","Memphis (TN)","6","5","0","0.54545","226","205","21","Charlie Bailey"
"1989","Memphis (TN)","2","9","0","0.18182","174","338","-164","Charles R. ""Chuck"" Stobart"
"1990","Memphis (TN)","4","6","1","0.40909","212","233","-21","Charles R. ""Chuck"" Stobart"
"1991","Memphis (TN)","5","6","0","0.45455","228","229","-1","Charles R. ""Chuck"" Stobart"
"1992","Memphis (TN)","6","5","0","0.54545","312","181","131","Charles R. ""Chuck"" Stobart"
"1993","Memphis (TN)","6","5","0","0.54545","268","215","53","Charles R. ""Chuck"" Stobart"
"1994","Memphis (TN)","6","5","0","0.54545","163","159","4","Charles R. ""Chuck"" Stobart"
"1995","Memphis (TN)","3","8","0","0.27273","150","240","-90","Rip Scherer"
"1996","Memphis (TN)","4","7","0","0.36364","141","219","-78","Rip Scherer"
"1997","Memphis (TN)","4","7","0","0.36364","218","243","-25","Rip Scherer"
"1998","Memphis (TN)","2","9","0","0.18182","226","340","-114","Rip Scherer"
"1999","Memphis (TN)","5","6","0","0.45455","232","182","50","Rip Scherer"
"2000","Memphis (TN)","4","7","0","0.36364","176","199","-23","Rip Scherer"
"2001","Memphis (TN)","5","6","0","0.45455","294","281","13","Tommy West"
"2002","Memphis (TN)","3","9","0","0.25","303","327","-24","Tommy West"
"2003","Memphis (TN)","9","4","0","0.69231","393","250","143","Tommy West"
"2004","Memphis (TN)","8","4","0","0.66667","430","375","55","Tommy West"
"2005","Memphis (TN)","7","5","0","0.58333","326","276","50","Tommy West"
"2006","Memphis (TN)","2","10","0","0.16667","281","365","-84","Tommy West"
"2007","Memphis (TN)","7","6","0","0.53846","380","419","-39","Tommy West"
"2008","Memphis (TN)","6","7","0","0.46154","353","353","0","Tommy West"
"2009","Memphis (TN)","2","10","0","0.16667","262","418","-156","Tommy West"
"2010","Memphis (TN)","1","11","0","0.08333","173","478","-305","Larry Porter"
"2011","Memphis (TN)","2","10","0","0.16667","195","421","-226","Larry Porter"
"2012","Memphis (TN)","4","8","0","0.33333","293","363","-70","Justin Fuente"
"2013","Memphis (TN)","3","9","0","0.25","234","295","-61","Justin Fuente"
"2014","Memphis (TN)","10","3","0","0.76923","471","253","218","Justin Fuente"
"1927","Miami (FL)","3","6","1","0.35","106","187","-81","Howard P. ""Cub"" Buck"
"1928","Miami (FL)","4","4","1","0.5","163","75","88","Howard P. ""Cub"" Buck"
"1929","Miami (FL)","3","2","0","0.6","45","26","19","J. Burton Rix"
"1930","Miami (FL)","3","4","1","0.4375","26","102","-76","Ernest E. Brett"
"1931","Miami (FL)","4","8","0","0.33333","90","170","-80","Thomas E. ""Tom"" McCann"
"1932","Miami (FL)","4","3","1","0.5625","57","39","18","Thomas E. ""Tom"" McCann"
"1933","Miami (FL)","5","1","2","0.75","197","46","151","Thomas E. ""Tom"" McCann"
"1934","Miami (FL)","5","3","1","0.61111","150","92","58","Thomas E. ""Tom"" McCann"
"1935","Miami (FL)","5","3","0","0.625","91","52","39","Irl I. Tubbs"
"1936","Miami (FL)","6","2","2","0.7","129","39","90","Irl I. Tubbs"
"1937","Miami (FL)","4","4","1","0.5","118","67","51","Jack Harding"
"1938","Miami (FL)","8","2","0","0.8","219","52","167","Jack Harding"
"1939","Miami (FL)","5","5","0","0.5","131","106","25","Jack Harding"
"1940","Miami (FL)","3","7","0","0.3","131","197","-66","Jack Harding"
"1941","Miami (FL)","8","2","0","0.8","162","54","108","Jack Harding"
"1942","Miami (FL)","7","2","0","0.77778","195","60","135","Jack Harding"
"1945","Miami (FL)","9","1","1","0.86364","211","99","112","Jack Harding"
"1946","Miami (FL)","8","2","0","0.8","200","147","53","Jack Harding"
"1947","Miami (FL)","2","7","1","0.25","80","140","-60","Jack Harding"
"1943","Miami (FL)","5","1","0","0.83333","124","52","72","Eddie Dunn"
"1944","Miami (FL)","1","7","1","0.16667","73","274","-201","Eddie Dunn"
"1948","Miami (FL)","4","6","0","0.4","154","179","-25","Andy Gustafson"
"1949","Miami (FL)","6","3","0","0.66667","165","96","69","Andy Gustafson"
"1950","Miami (FL)","9","1","1","0.86364","251","97","154","Andy Gustafson"
"1951","Miami (FL)","8","3","0","0.72727","196","126","70","Andy Gustafson"
"1952","Miami (FL)","4","7","0","0.36364","181","192","-11","Andy Gustafson"
"1953","Miami (FL)","4","5","0","0.44444","155","137","18","Andy Gustafson"
"1954","Miami (FL)","8","1","0","0.88889","257","94","163","Andy Gustafson"
"1955","Miami (FL)","6","3","0","0.66667","181","81","100","Andy Gustafson"
"1956","Miami (FL)","8","1","1","0.85","161","53","108","Andy Gustafson"
"1957","Miami (FL)","5","4","1","0.55","161","103","58","Andy Gustafson"
"1958","Miami (FL)","2","8","0","0.2","88","195","-107","Andy Gustafson"
"1959","Miami (FL)","6","4","0","0.6","140","140","0","Andy Gustafson"
"1960","Miami (FL)","6","4","0","0.6","163","143","20","Andy Gustafson"
"1961","Miami (FL)","7","4","0","0.63636","146","85","61","Andy Gustafson"
"1962","Miami (FL)","7","4","0","0.63636","189","217","-28","Andy Gustafson"
"1963","Miami (FL)","3","7","0","0.3","116","174","-58","Andy Gustafson"
"1964","Miami (FL)","4","5","1","0.45","147","133","14","Charlie Tate"
"1965","Miami (FL)","5","4","1","0.55","199","138","61","Charlie Tate"
"1966","Miami (FL)","8","2","1","0.77273","210","103","107","Charlie Tate"
"1967","Miami (FL)","7","4","0","0.63636","257","140","117","Charlie Tate"
"1968","Miami (FL)","5","5","0","0.5","161","131","30","Charlie Tate"
"1969","Miami (FL)","4","6","0","0.4","201","216","-15","Charlie Tate"
"1970","Miami (FL)","1","1","0","0.5","57","45","12","Charlie Tate"
"1970","Miami (FL)","2","7","0","0.22222","109","265","-156","Walt Kichefski"
"1971","Miami (FL)","4","7","0","0.36364","174","221","-47","Fran Curci"
"1972","Miami (FL)","5","6","0","0.45455","214","170","44","Fran Curci"
"1973","Miami (FL)","5","6","0","0.45455","163","240","-77","Peter R. Elliott"
"1974","Miami (FL)","6","5","0","0.54545","167","190","-23","Peter R. Elliott"
"1975","Miami (FL)","2","8","0","0.2","157","239","-82","Carl Selmer"
"1976","Miami (FL)","3","8","0","0.27273","207","213","-6","Carl Selmer"
"1977","Miami (FL)","3","8","0","0.27273","125","245","-120","Louis Henry ""Lou"" Saban"
"1978","Miami (FL)","6","5","0","0.54545","194","193","1","Louis Henry ""Lou"" Saban"
"1979","Miami (FL)","5","6","0","0.45455","191","236","-45","Howard Schnellenberger"
"1980","Miami (FL)","9","3","0","0.75","278","171","107","Howard Schnellenberger"
"1981","Miami (FL)","9","2","0","0.81818","245","145","100","Howard Schnellenberger"
"1982","Miami (FL)","7","4","0","0.63636","241","153","88","Howard Schnellenberger"
"1983","Miami (FL)","11","1","0","0.91667","313","136","177","Howard Schnellenberger"
"1984","Miami (FL)","8","5","0","0.61538","402","314","88","Jimmy Johnson"
"1985","Miami (FL)","10","2","0","0.83333","406","195","211","Jimmy Johnson"
"1986","Miami (FL)","11","1","0","0.91667","430","150","280","Jimmy Johnson"
"1987","Miami (FL)","12","0","0","1","412","125","287","Jimmy Johnson"
"1988","Miami (FL)","11","1","0","0.91667","418","116","302","Jimmy Johnson"
"1989","Miami (FL)","11","1","0","0.91667","426","127","299","Dennis Erickson"
"1990","Miami (FL)","10","2","0","0.83333","447","184","263","Dennis Erickson"
"1991","Miami (FL)","12","0","0","1","386","100","286","Dennis Erickson"
"1992","Miami (FL)","11","1","0","0.91667","369","161","208","Dennis Erickson"
"1993","Miami (FL)","9","3","0","0.75","331","167","164","Dennis Erickson"
"1994","Miami (FL)","10","2","0","0.83333","365","143","222","Dennis Erickson"
"1995","Miami (FL)","8","3","0","0.72727","294","201","93","Butch Davis"
"1996","Miami (FL)","9","3","0","0.75","368","210","158","Butch Davis"
"1997","Miami (FL)","5","6","0","0.45455","314","285","29","Butch Davis"
"1998","Miami (FL)","9","3","0","0.75","448","298","150","Butch Davis"
"1999","Miami (FL)","9","4","0","0.69231","432","220","212","Butch Davis"
"2000","Miami (FL)","11","1","0","0.91667","506","190","316","Butch Davis"
"2001","Miami (FL)","12","0","0","1","512","117","395","Larry Coker"
"2002","Miami (FL)","12","1","0","0.92308","527","248","279","Larry Coker"
"2003","Miami (FL)","11","2","0","0.84615","361","196","165","Larry Coker"
"2004","Miami (FL)","9","3","0","0.75","380","204","176","Larry Coker"
"2005","Miami (FL)","9","3","0","0.75","325","171","154","Larry Coker"
"2006","Miami (FL)","7","6","0","0.53846","255","201","54","Larry Coker"
"2007","Miami (FL)","5","7","0","0.41667","247","312","-65","Randy Shannon"
"2008","Miami (FL)","7","6","0","0.53846","352","314","38","Randy Shannon"
"2009","Miami (FL)","9","4","0","0.69231","394","288","106","Randy Shannon"
"2010","Miami (FL)","7","5","0","0.58333","325","236","89","Randy Shannon"
"2010","Miami (FL)","0","1","0","0","17","33","-16","Jeff Stoutland"
"2011","Miami (FL)","6","6","0","0.5","318","241","77","Al Golden"
"2012","Miami (FL)","7","5","0","0.58333","377","366","11","Al Golden"
"2013","Miami (FL)","9","4","0","0.69231","440","348","92","Al Golden"
"2014","Miami (FL)","6","7","0","0.46154","380","316","64","Al Golden"
"1895","Miami (OH)","3","1","0","0.75","30","10","20","C.K. Fauver"
"1896","Miami (OH)","4","2","0","0.66667","58","30","28","Ernest Merrill"
"1897","Miami (OH)","2","4","1","0.35714","32","56","-24","Herbert McIntyre"
"1900","Miami (OH)","0","4","0","0","12","77","-65","Alonzo Edwin Branch"
"1901","Miami (OH)","1","3","1","0.3","23","29","-6","Thomas Hazzard"
"1902","Miami (OH)","5","3","1","0.61111","91","44","47","Peter McPherson"
"1903","Miami (OH)","1","4","0","0.2","27","110","-83","Peter McPherson"
"1904","Miami (OH)","1","5","0","0.16667","12","283","-271","Arthur K. Smith"
"1898","Miami (OH)","48","23","4","0.66667","931","644","287","No Coach"
"1905","Miami (OH)","12","31","5","0.30208","412","653","-241","No Coach"
"1906","Miami (OH)","1","5","1","0.21429","16","55","-39","Arthur Parmalee"
"1907","Miami (OH)","6","1","0","0.85714","120","37","83","Amos P. Foster"
"1908","Miami (OH)","7","0","0","1","113","10","103","Amos P. Foster"
"1909","Miami (OH)","3","4","0","0.42857","96","83","13","Harold Iddings"
"1910","Miami (OH)","2","4","1","0.35714","26","44","-18","Harold Iddings"
"1911","Miami (OH)","2","4","2","0.375","57","45","12","Edwin R. Sweetland"
"1912","Miami (OH)","3","3","2","0.5","88","106","-18","James C. Donnelly"
"1913","Miami (OH)","6","2","0","0.75","154","68","86","James C. Donnelly"
"1914","Miami (OH)","5","3","0","0.625","131","124","7","James C. Donnelly"
"1915","Miami (OH)","6","2","0","0.75","137","87","50","C.J. Roberts"
"1917","Miami (OH)","6","0","2","0.875","202","0","202","George L. Rider"
"1918","Miami (OH)","5","0","1","0.91667","195","13","182","George L. Rider"
"1916","Miami (OH)","7","0","1","0.9375","238","12","226","George E. Little"
"1919","Miami (OH)","7","1","0","0.875","147","32","115","George E. Little"
"1920","Miami (OH)","5","2","1","0.6875","114","38","76","George E. Little"
"1921","Miami (OH)","8","0","0","1","238","13","225","George E. Little"
"1922","Miami (OH)","4","3","1","0.5625","61","45","16","Harry W. ""Buck"" Ewing"
"1923","Miami (OH)","3","4","1","0.4375","82","81","1","Harry W. ""Buck"" Ewing"
"1924","Miami (OH)","2","6","0","0.25","62","147","-85","Chester Pittser"
"1925","Miami (OH)","5","3","0","0.625","123","55","68","Chester Pittser"
"1926","Miami (OH)","5","2","1","0.6875","112","58","54","Chester Pittser"
"1927","Miami (OH)","8","1","0","0.88889","255","56","199","Chester Pittser"
"1928","Miami (OH)","6","2","0","0.75","140","46","94","Chester Pittser"
"1929","Miami (OH)","7","2","0","0.77778","179","40","139","Chester Pittser"
"1930","Miami (OH)","4","4","1","0.5","131","82","49","Chester Pittser"
"1931","Miami (OH)","4","5","0","0.44444","161","122","39","Chester Pittser"
"1932","Miami (OH)","7","1","0","0.875","182","56","126","Frank Wilton"
"1933","Miami (OH)","7","2","0","0.77778","223","36","187","Frank Wilton"
"1934","Miami (OH)","5","4","0","0.55556","118","70","48","Frank Wilton"
"1935","Miami (OH)","5","3","1","0.61111","174","80","94","Frank Wilton"
"1936","Miami (OH)","7","1","1","0.83333","84","40","44","Frank Wilton"
"1937","Miami (OH)","4","4","1","0.5","175","85","90","Frank Wilton"
"1938","Miami (OH)","6","3","0","0.66667","228","100","128","Frank Wilton"
"1939","Miami (OH)","1","7","1","0.16667","21","104","-83","Frank Wilton"
"1940","Miami (OH)","0","7","1","0.0625","32","200","-168","Frank Wilton"
"1941","Miami (OH)","2","7","0","0.22222","98","176","-78","Frank Wilton"
"1942","Miami (OH)","3","6","0","0.33333","154","195","-41","Stuart K. ""Stu"" Holcomb"
"1943","Miami (OH)","7","2","1","0.75","293","91","202","Stuart K. ""Stu"" Holcomb"
"1944","Miami (OH)","8","1","0","0.88889","185","74","111","Sid Gillman"
"1945","Miami (OH)","7","2","0","0.77778","207","75","132","Sid Gillman"
"1946","Miami (OH)","7","3","0","0.7","220","72","148","Sid Gillman"
"1947","Miami (OH)","9","0","1","0.95","240","97","143","Sid Gillman"
"1948","Miami (OH)","7","1","1","0.83333","249","90","159","George ""Blackie"" Blackburn"
"1949","Miami (OH)","5","4","0","0.55556","251","163","88","Wayne ""Woody"" Hayes"
"1950","Miami (OH)","9","1","0","0.9","356","100","256","Wayne ""Woody"" Hayes"
"1951","Miami (OH)","7","3","0","0.7","225","159","66","Ara R. Parseghian"
"1952","Miami (OH)","8","1","0","0.88889","284","108","176","Ara R. Parseghian"
"1953","Miami (OH)","7","1","1","0.83333","327","52","275","Ara R. Parseghian"
"1954","Miami (OH)","8","1","0","0.88889","294","82","212","Ara R. Parseghian"
"1955","Miami (OH)","9","0","0","1","226","47","179","Ara R. Parseghian"
"1956","Miami (OH)","7","1","1","0.83333","159","83","76","John Pont"
"1957","Miami (OH)","6","3","0","0.66667","163","137","26","John Pont"
"1958","Miami (OH)","6","3","0","0.66667","193","96","97","John Pont"
"1959","Miami (OH)","5","4","0","0.55556","158","94","64","John Pont"
"1960","Miami (OH)","5","5","0","0.5","139","159","-20","John Pont"
"1961","Miami (OH)","6","4","0","0.6","153","115","38","John Pont"
"1962","Miami (OH)","8","2","1","0.77273","241","175","66","John Pont"
"1963","Miami (OH)","5","3","2","0.6","208","178","30","Glenn ""Bo"" Schembechler"
"1964","Miami (OH)","6","3","1","0.65","209","142","67","Glenn ""Bo"" Schembechler"
"1965","Miami (OH)","7","3","0","0.7","247","137","110","Glenn ""Bo"" Schembechler"
"1966","Miami (OH)","9","1","0","0.9","229","76","153","Glenn ""Bo"" Schembechler"
"1967","Miami (OH)","6","4","0","0.6","181","114","67","Glenn ""Bo"" Schembechler"
"1968","Miami (OH)","7","3","0","0.7","240","99","141","Glenn ""Bo"" Schembechler"
"1969","Miami (OH)","7","3","0","0.7","231","139","92","Bill Mallory"
"1970","Miami (OH)","7","3","0","0.7","187","112","75","Bill Mallory"
"1971","Miami (OH)","7","3","0","0.7","207","117","90","Bill Mallory"
"1972","Miami (OH)","7","3","0","0.7","232","116","116","Bill Mallory"
"1973","Miami (OH)","11","0","0","1","223","76","147","Bill Mallory"
"1974","Miami (OH)","10","0","1","0.95455","303","86","217","Dick Crum"
"1975","Miami (OH)","11","1","0","0.91667","306","141","165","Dick Crum"
"1976","Miami (OH)","3","8","0","0.27273","160","208","-48","Dick Crum"
"1977","Miami (OH)","10","1","0","0.90909","262","173","89","Dick Crum"
"1978","Miami (OH)","8","2","1","0.77273","228","161","67","Thomas ""Tom"" Reed"
"1979","Miami (OH)","6","5","0","0.54545","223","142","81","Thomas ""Tom"" Reed"
"1980","Miami (OH)","5","6","0","0.45455","241","192","49","Thomas ""Tom"" Reed"
"1981","Miami (OH)","8","2","1","0.77273","199","154","45","Thomas ""Tom"" Reed"
"1982","Miami (OH)","7","4","0","0.63636","195","121","74","Thomas ""Tom"" Reed"
"1983","Miami (OH)","4","7","0","0.36364","152","189","-37","Tim Rose"
"1984","Miami (OH)","4","7","0","0.36364","175","221","-46","Tim Rose"
"1985","Miami (OH)","8","2","1","0.77273","266","211","55","Tim Rose"
"1986","Miami (OH)","8","4","0","0.66667","346","228","118","Tim Rose"
"1987","Miami (OH)","5","6","0","0.45455","180","235","-55","Tim Rose"
"1988","Miami (OH)","0","10","1","0.04545","167","361","-194","Tim Rose"
"1989","Miami (OH)","2","8","1","0.22727","122","262","-140","Tim Rose"
"1990","Miami (OH)","5","5","1","0.5","200","225","-25","Randy Walker"
"1991","Miami (OH)","6","4","1","0.59091","214","140","74","Randy Walker"
"1992","Miami (OH)","6","4","1","0.59091","210","204","6","Randy Walker"
"1993","Miami (OH)","4","7","0","0.36364","186","248","-62","Randy Walker"
"1994","Miami (OH)","6","4","1","0.59091","262","260","2","Randy Walker"
"1995","Miami (OH)","8","2","1","0.77273","326","165","161","Randy Walker"
"1996","Miami (OH)","6","5","0","0.54545","273","168","105","Randy Walker"
"1997","Miami (OH)","8","3","0","0.72727","412","226","186","Randy Walker"
"1998","Miami (OH)","10","1","0","0.90909","317","142","175","Randy Walker"
"1999","Miami (OH)","7","4","0","0.63636","335","264","71","Terry Hoeppner"
"2000","Miami (OH)","6","5","0","0.54545","272","286","-14","Terry Hoeppner"
"2001","Miami (OH)","7","5","0","0.58333","319","309","10","Terry Hoeppner"
"2002","Miami (OH)","7","5","0","0.58333","384","325","59","Terry Hoeppner"
"2003","Miami (OH)","13","1","0","0.92857","602","272","330","Terry Hoeppner"
"2004","Miami (OH)","8","5","0","0.61538","407","298","109","Terry Hoeppner"
"2005","Miami (OH)","7","4","0","0.63636","371","258","113","Shane Montgomery"
"2006","Miami (OH)","2","10","0","0.16667","222","304","-82","Shane Montgomery"
"2007","Miami (OH)","6","7","0","0.46154","250","333","-83","Shane Montgomery"
"2008","Miami (OH)","2","10","0","0.16667","221","392","-171","Shane Montgomery"
"2009","Miami (OH)","1","11","0","0.08333","187","410","-223","Michael Haywood"
"2010","Miami (OH)","9","4","0","0.69231","267","304","-37","Michael Haywood"
"2010","Miami (OH)","1","0","0","1","35","21","14","Lance Guidry"
"2011","Miami (OH)","4","8","0","0.33333","256","275","-19","Don Treadwell"
"2012","Miami (OH)","4","8","0","0.33333","280","419","-139","Don Treadwell"
"2013","Miami (OH)","0","5","0","0","44","178","-134","Don Treadwell"
"2013","Miami (OH)","0","7","0","0","73","250","-177","Mike Bath"
"2014","Miami (OH)","2","10","0","0.16667","268","382","-114","Chuck Martin"
"1885","Michigan","34","17","4","0.65455","1437","612","825","No Coach"
"1891","Michigan","4","5","0","0.44444","168","124","44","Michael J. ""Mike"" Murphy & Frank Crawford"
"1892","Michigan","7","5","0","0.58333","298","176","122","Frank Barbour"
"1893","Michigan","7","3","0","0.7","278","102","176","Frank Barbour"
"1894","Michigan","9","1","1","0.86364","240","84","156","William McCauley"
"1895","Michigan","8","1","0","0.88889","266","14","252","William McCauley"
"1896","Michigan","9","1","0","0.9","262","11","251","William Ward"
"1897","Michigan","6","2","1","0.72222","166","46","120","Gustave Ferbert"
"1898","Michigan","11","0","0","1","216","28","188","Gustave Ferbert"
"1899","Michigan","8","2","1","0.77273","176","34","142","Gustave Ferbert"
"1900","Michigan","7","2","1","0.75","117","55","62","Langdon ""Biff"" Lea"
"1901","Michigan","11","0","0","1","550","0","550","Fielding H. ""Hurry Up"" Yost"
"1902","Michigan","11","0","0","1","644","12","632","Fielding H. ""Hurry Up"" Yost"
"1903","Michigan","11","0","1","0.95833","565","6","559","Fielding H. ""Hurry Up"" Yost"
"1904","Michigan","10","0","0","1","567","22","545","Fielding H. ""Hurry Up"" Yost"
"1905","Michigan","12","1","0","0.92308","495","2","493","Fielding H. ""Hurry Up"" Yost"
"1906","Michigan","4","1","1","0.75","72","30","42","Fielding H. ""Hurry Up"" Yost"
"1907","Michigan","5","1","0","0.83333","107","6","101","Fielding H. ""Hurry Up"" Yost"
"1908","Michigan","5","2","1","0.6875","128","81","47","Fielding H. ""Hurry Up"" Yost"
"1909","Michigan","6","1","0","0.85714","115","34","81","Fielding H. ""Hurry Up"" Yost"
"1910","Michigan","3","0","3","0.75","29","9","20","Fielding H. ""Hurry Up"" Yost"
"1911","Michigan","5","1","2","0.75","90","38","52","Fielding H. ""Hurry Up"" Yost"
"1912","Michigan","5","2","0","0.71429","158","65","93","Fielding H. ""Hurry Up"" Yost"
"1913","Michigan","6","1","0","0.85714","175","21","154","Fielding H. ""Hurry Up"" Yost"
"1914","Michigan","6","3","0","0.66667","233","68","165","Fielding H. ""Hurry Up"" Yost"
"1915","Michigan","4","3","1","0.5625","130","81","49","Fielding H. ""Hurry Up"" Yost"
"1916","Michigan","7","2","0","0.77778","253","56","197","Fielding H. ""Hurry Up"" Yost"
"1917","Michigan","8","2","0","0.8","304","53","251","Fielding H. ""Hurry Up"" Yost"
"1918","Michigan","5","0","0","1","96","6","90","Fielding H. ""Hurry Up"" Yost"
"1919","Michigan","3","4","0","0.42857","93","102","-9","Fielding H. ""Hurry Up"" Yost"
"1920","Michigan","5","2","0","0.71429","121","21","100","Fielding H. ""Hurry Up"" Yost"
"1921","Michigan","5","1","1","0.78571","187","21","166","Fielding H. ""Hurry Up"" Yost"
"1922","Michigan","6","0","1","0.92857","183","13","170","Fielding H. ""Hurry Up"" Yost"
"1923","Michigan","8","0","0","1","150","12","138","Fielding H. ""Hurry Up"" Yost"
"1925","Michigan","7","1","0","0.875","227","3","224","Fielding H. ""Hurry Up"" Yost"
"1926","Michigan","7","1","0","0.875","191","38","153","Fielding H. ""Hurry Up"" Yost"
"1924","Michigan","6","2","0","0.75","155","54","101","George E. Little"
"1927","Michigan","6","2","0","0.75","137","39","98","Elton E. ""Tad"" Wieman"
"1928","Michigan","3","4","1","0.4375","36","62","-26","Elton E. ""Tad"" Wieman"
"1929","Michigan","5","3","1","0.61111","109","75","34","Harry G. Kipke"
"1930","Michigan","8","0","1","0.94444","111","23","88","Harry G. Kipke"
"1931","Michigan","8","1","1","0.85","181","27","154","Harry G. Kipke"
"1932","Michigan","8","0","0","1","123","13","110","Harry G. Kipke"
"1933","Michigan","7","0","1","0.9375","131","18","113","Harry G. Kipke"
"1934","Michigan","1","7","0","0.125","21","143","-122","Harry G. Kipke"
"1935","Michigan","4","4","0","0.5","68","131","-63","Harry G. Kipke"
"1936","Michigan","1","7","0","0.125","36","127","-91","Harry G. Kipke"
"1937","Michigan","4","4","0","0.5","54","110","-56","Harry G. Kipke"
"1938","Michigan","6","1","1","0.8125","131","40","91","Herbert O. ""Fritz"" Crisler"
"1939","Michigan","6","2","0","0.75","219","94","125","Herbert O. ""Fritz"" Crisler"
"1940","Michigan","7","1","0","0.875","196","34","162","Herbert O. ""Fritz"" Crisler"
"1941","Michigan","6","1","1","0.8125","147","41","106","Herbert O. ""Fritz"" Crisler"
"1942","Michigan","7","3","0","0.7","221","134","87","Herbert O. ""Fritz"" Crisler"
"1943","Michigan","8","1","0","0.88889","302","73","229","Herbert O. ""Fritz"" Crisler"
"1944","Michigan","8","2","0","0.8","204","91","113","Herbert O. ""Fritz"" Crisler"
"1945","Michigan","7","3","0","0.7","187","99","88","Herbert O. ""Fritz"" Crisler"
"1946","Michigan","6","2","1","0.72222","233","73","160","Herbert O. ""Fritz"" Crisler"
"1947","Michigan","10","0","0","1","394","53","341","Herbert O. ""Fritz"" Crisler"
"1948","Michigan","9","0","0","1","252","44","208","Bennie G. Oosterbaan"
"1949","Michigan","6","2","1","0.72222","135","85","50","Bennie G. Oosterbaan"
"1950","Michigan","6","3","1","0.65","150","114","36","Bennie G. Oosterbaan"
"1951","Michigan","4","5","0","0.44444","135","122","13","Bennie G. Oosterbaan"
"1952","Michigan","5","4","0","0.55556","207","134","73","Bennie G. Oosterbaan"
"1953","Michigan","6","3","0","0.66667","163","101","62","Bennie G. Oosterbaan"
"1954","Michigan","6","3","0","0.66667","139","87","52","Bennie G. Oosterbaan"
"1955","Michigan","7","2","0","0.77778","179","94","85","Bennie G. Oosterbaan"
"1956","Michigan","7","2","0","0.77778","233","123","110","Bennie G. Oosterbaan"
"1957","Michigan","5","3","1","0.61111","187","147","40","Bennie G. Oosterbaan"
"1958","Michigan","2","6","1","0.27778","132","211","-79","Bennie G. Oosterbaan"
"1959","Michigan","4","5","0","0.44444","122","161","-39","Chalmers ""Bump"" Elliott"
"1960","Michigan","5","4","0","0.55556","133","84","49","Chalmers ""Bump"" Elliott"
"1961","Michigan","6","3","0","0.66667","212","163","49","Chalmers ""Bump"" Elliott"
"1962","Michigan","2","7","0","0.22222","70","214","-144","Chalmers ""Bump"" Elliott"
"1963","Michigan","3","4","2","0.44444","131","127","4","Chalmers ""Bump"" Elliott"
"1964","Michigan","9","1","0","0.9","235","83","152","Chalmers ""Bump"" Elliott"
"1965","Michigan","4","6","0","0.4","185","161","24","Chalmers ""Bump"" Elliott"
"1966","Michigan","6","4","0","0.6","236","138","98","Chalmers ""Bump"" Elliott"
"1967","Michigan","4","6","0","0.4","144","179","-35","Chalmers ""Bump"" Elliott"
"1968","Michigan","8","2","0","0.8","277","155","122","Chalmers ""Bump"" Elliott"
"1969","Michigan","8","3","0","0.72727","352","148","204","Glenn ""Bo"" Schembechler"
"1970","Michigan","9","1","0","0.9","288","90","198","Glenn ""Bo"" Schembechler"
"1971","Michigan","11","1","0","0.91667","421","83","338","Glenn ""Bo"" Schembechler"
"1972","Michigan","10","1","0","0.90909","264","57","207","Glenn ""Bo"" Schembechler"
"1973","Michigan","10","0","1","0.95455","330","68","262","Glenn ""Bo"" Schembechler"
"1974","Michigan","10","1","0","0.90909","324","75","249","Glenn ""Bo"" Schembechler"
"1975","Michigan","8","2","2","0.75","324","130","194","Glenn ""Bo"" Schembechler"
"1976","Michigan","10","2","0","0.83333","432","95","337","Glenn ""Bo"" Schembechler"
"1977","Michigan","10","2","0","0.83333","353","124","229","Glenn ""Bo"" Schembechler"
"1978","Michigan","10","2","0","0.83333","372","105","267","Glenn ""Bo"" Schembechler"
"1979","Michigan","8","4","0","0.66667","312","151","161","Glenn ""Bo"" Schembechler"
"1980","Michigan","10","2","0","0.83333","322","129","193","Glenn ""Bo"" Schembechler"
"1981","Michigan","9","3","0","0.75","355","162","193","Glenn ""Bo"" Schembechler"
"1982","Michigan","8","4","0","0.66667","345","204","141","Glenn ""Bo"" Schembechler"
"1983","Michigan","9","3","0","0.75","355","160","195","Glenn ""Bo"" Schembechler"
"1984","Michigan","6","6","0","0.5","214","200","14","Glenn ""Bo"" Schembechler"
"1985","Michigan","10","1","1","0.875","342","98","244","Glenn ""Bo"" Schembechler"
"1986","Michigan","11","2","0","0.84615","379","203","176","Glenn ""Bo"" Schembechler"
"1987","Michigan","8","4","0","0.66667","331","172","159","Glenn ""Bo"" Schembechler"
"1988","Michigan","9","2","1","0.79167","361","167","194","Glenn ""Bo"" Schembechler"
"1989","Michigan","10","2","0","0.83333","335","184","151","Glenn ""Bo"" Schembechler"
"1990","Michigan","9","3","0","0.75","389","198","191","Gary O. Moeller"
"1991","Michigan","10","2","0","0.83333","420","203","217","Gary O. Moeller"
"1992","Michigan","9","0","3","0.875","431","171","260","Gary O. Moeller"
"1993","Michigan","8","4","0","0.66667","342","160","182","Gary O. Moeller"
"1994","Michigan","8","4","0","0.66667","330","268","62","Gary O. Moeller"
"1995","Michigan","9","4","0","0.69231","338","223","115","Lloyd Carr"
"1996","Michigan","8","4","0","0.66667","277","184","93","Lloyd Carr"
"1997","Michigan","12","0","0","1","322","114","208","Lloyd Carr"
"1998","Michigan","10","3","0","0.76923","359","235","124","Lloyd Carr"
"1999","Michigan","10","2","0","0.83333","361","247","114","Lloyd Carr"
"2000","Michigan","9","3","0","0.75","404","229","175","Lloyd Carr"
"2001","Michigan","8","4","0","0.66667","320","237","83","Lloyd Carr"
"2002","Michigan","10","3","0","0.76923","361","265","96","Lloyd Carr"
"2003","Michigan","10","3","0","0.76923","460","219","241","Lloyd Carr"
"2004","Michigan","9","3","0","0.75","370","279","91","Lloyd Carr"
"2005","Michigan","7","5","0","0.58333","345","244","101","Lloyd Carr"
"2006","Michigan","11","2","0","0.84615","380","207","173","Lloyd Carr"
"2007","Michigan","9","4","0","0.69231","354","278","76","Lloyd Carr"
"2008","Michigan","3","9","0","0.25","243","347","-104","Rich Rodriguez"
"2009","Michigan","5","7","0","0.41667","354","330","24","Rich Rodriguez"
"2010","Michigan","7","6","0","0.53846","426","458","-32","Rich Rodriguez"
"2011","Michigan","11","2","0","0.84615","433","226","207","Brady Hoke"
"2012","Michigan","8","5","0","0.61538","388","258","130","Brady Hoke"
"2013","Michigan","7","6","0","0.53846","419","349","70","Brady Hoke"
"2014","Michigan","5","7","0","0.41667","251","269","-18","Brady Hoke"
"1890","Minnesota","5","1","1","0.78571","208","33","175","Tom Eck"
"1891","Minnesota","3","1","1","0.7","102","46","56","Ed ""Dad"" Moulton"
"1892","Minnesota","99","83","9","0.54188","3108","2495","613","No Coach"
"1893","Minnesota","7","0","0","1","158","38","120","Wallie Winter"
"1894","Minnesota","3","1","0","0.75","74","8","66","Tom Cochran"
"1895","Minnesota","7","3","0","0.7","136","58","78","Walt W. ""Pudge"" Heffelfinger"
"1896","Minnesota","8","2","0","0.8","168","24","144","Alexander Jerrems"
"1897","Minnesota","4","4","0","0.5","112","77","35","Alexander Jerrems"
"1898","Minnesota","4","5","0","0.44444","92","73","19","Jack Minds"
"1899","Minnesota","6","3","2","0.63636","149","79","70","John M. Harrison & William C. Leary"
"1900","Minnesota","10","0","2","0.91667","299","23","276","Henry L. ""Doc"" Williams"
"1901","Minnesota","9","1","1","0.86364","183","18","165","Henry L. ""Doc"" Williams"
"1902","Minnesota","9","2","1","0.79167","335","34","301","Henry L. ""Doc"" Williams"
"1903","Minnesota","14","0","1","0.96667","656","12","644","Henry L. ""Doc"" Williams"
"1904","Minnesota","13","0","0","1","725","12","713","Henry L. ""Doc"" Williams"
"1905","Minnesota","11","1","0","0.91667","542","22","520","Henry L. ""Doc"" Williams"
"1906","Minnesota","4","1","0","0.8","47","29","18","Henry L. ""Doc"" Williams"
"1907","Minnesota","2","2","1","0.5","55","52","3","Henry L. ""Doc"" Williams"
"1908","Minnesota","3","2","1","0.58333","32","50","-18","Henry L. ""Doc"" Williams"
"1909","Minnesota","6","1","0","0.85714","158","27","131","Henry L. ""Doc"" Williams"
"1910","Minnesota","6","1","0","0.85714","179","6","173","Henry L. ""Doc"" Williams"
"1911","Minnesota","6","0","1","0.92857","102","15","87","Henry L. ""Doc"" Williams"
"1912","Minnesota","4","3","0","0.57143","87","38","49","Henry L. ""Doc"" Williams"
"1913","Minnesota","5","2","0","0.71429","116","32","84","Henry L. ""Doc"" Williams"
"1914","Minnesota","6","1","0","0.85714","123","44","79","Henry L. ""Doc"" Williams"
"1915","Minnesota","6","0","1","0.92857","191","35","156","Henry L. ""Doc"" Williams"
"1916","Minnesota","6","1","0","0.85714","348","28","320","Henry L. ""Doc"" Williams"
"1917","Minnesota","4","1","0","0.8","164","25","139","Henry L. ""Doc"" Williams"
"1918","Minnesota","5","2","1","0.6875","133","39","94","Henry L. ""Doc"" Williams"
"1919","Minnesota","4","2","1","0.64286","130","45","85","Henry L. ""Doc"" Williams"
"1920","Minnesota","1","6","0","0.14286","62","92","-30","Henry L. ""Doc"" Williams"
"1921","Minnesota","3","4","0","0.42857","60","141","-81","Henry L. ""Doc"" Williams"
"1922","Minnesota","3","3","1","0.5","79","65","14","William H. ""Bill"" Spaulding"
"1923","Minnesota","5","1","1","0.78571","114","60","54","William H. ""Bill"" Spaulding"
"1924","Minnesota","3","3","2","0.5","68","63","5","William H. ""Bill"" Spaulding"
"1925","Minnesota","5","2","1","0.6875","176","91","85","Clarence W. ""Doc"" Spears"
"1926","Minnesota","5","3","0","0.625","269","57","212","Clarence W. ""Doc"" Spears"
"1927","Minnesota","6","0","2","0.875","209","51","158","Clarence W. ""Doc"" Spears"
"1928","Minnesota","6","2","0","0.75","182","36","146","Clarence W. ""Doc"" Spears"
"1929","Minnesota","6","2","0","0.75","179","55","124","Clarence W. ""Doc"" Spears"
"1930","Minnesota","3","4","1","0.4375","126","81","45","Herbert O. ""Fritz"" Crisler"
"1931","Minnesota","7","3","0","0.7","191","72","119","Herbert O. ""Fritz"" Crisler"
"1932","Minnesota","5","3","0","0.625","86","42","44","Bernard W. ""Bernie"" Bierman"
"1933","Minnesota","4","0","4","0.75","64","32","32","Bernard W. ""Bernie"" Bierman"
"1934","Minnesota","8","0","0","1","270","38","232","Bernard W. ""Bernie"" Bierman"
"1935","Minnesota","8","0","0","1","194","46","148","Bernard W. ""Bernie"" Bierman"
"1936","Minnesota","7","1","0","0.875","203","32","171","Bernard W. ""Bernie"" Bierman"
"1937","Minnesota","6","2","0","0.75","184","50","134","Bernard W. ""Bernie"" Bierman"
"1938","Minnesota","6","2","0","0.75","97","38","59","Bernard W. ""Bernie"" Bierman"
"1939","Minnesota","3","4","1","0.4375","154","82","72","Bernard W. ""Bernie"" Bierman"
"1940","Minnesota","8","0","0","1","154","71","83","Bernard W. ""Bernie"" Bierman"
"1941","Minnesota","8","0","0","1","186","38","148","Bernard W. ""Bernie"" Bierman"
"1945","Minnesota","4","5","0","0.44444","177","155","22","Bernard W. ""Bernie"" Bierman"
"1946","Minnesota","5","4","0","0.55556","130","114","16","Bernard W. ""Bernie"" Bierman"
"1947","Minnesota","6","3","0","0.66667","174","127","47","Bernard W. ""Bernie"" Bierman"
"1948","Minnesota","7","2","0","0.77778","203","94","109","Bernard W. ""Bernie"" Bierman"
"1949","Minnesota","7","2","0","0.77778","231","80","151","Bernard W. ""Bernie"" Bierman"
"1950","Minnesota","1","7","1","0.16667","79","196","-117","Bernard W. ""Bernie"" Bierman"
"1942","Minnesota","5","4","0","0.55556","152","91","61","George W. Hauser"
"1943","Minnesota","5","4","0","0.55556","170","184","-14","George W. Hauser"
"1944","Minnesota","5","3","1","0.61111","225","162","63","George W. Hauser"
"1951","Minnesota","2","6","1","0.27778","162","258","-96","Wesley E. ""Wes"" Fesler"
"1952","Minnesota","4","3","2","0.55556","131","171","-40","Wesley E. ""Wes"" Fesler"
"1953","Minnesota","4","4","1","0.5","150","160","-10","Wesley E. ""Wes"" Fesler"
"1954","Minnesota","7","2","0","0.77778","195","127","68","Murray Warmath"
"1955","Minnesota","3","6","0","0.33333","110","172","-62","Murray Warmath"
"1956","Minnesota","6","1","2","0.77778","127","87","40","Murray Warmath"
"1957","Minnesota","4","5","0","0.44444","201","188","13","Murray Warmath"
"1958","Minnesota","1","8","0","0.11111","115","157","-42","Murray Warmath"
"1959","Minnesota","2","7","0","0.22222","98","159","-61","Murray Warmath"
"1960","Minnesota","8","2","0","0.8","228","88","140","Murray Warmath"
"1961","Minnesota","8","2","0","0.8","161","78","83","Murray Warmath"
"1962","Minnesota","6","2","1","0.72222","131","61","70","Murray Warmath"
"1963","Minnesota","3","6","0","0.33333","95","117","-22","Murray Warmath"
"1964","Minnesota","5","4","0","0.55556","136","131","5","Murray Warmath"
"1965","Minnesota","5","4","1","0.55","188","160","28","Murray Warmath"
"1966","Minnesota","4","5","1","0.45","124","160","-36","Murray Warmath"
"1967","Minnesota","8","2","0","0.8","163","106","57","Murray Warmath"
"1968","Minnesota","6","4","0","0.6","207","190","17","Murray Warmath"
"1969","Minnesota","4","5","1","0.45","210","260","-50","Murray Warmath"
"1970","Minnesota","3","6","1","0.35","180","237","-57","Murray Warmath"
"1971","Minnesota","4","7","0","0.36364","212","278","-66","Murray Warmath"
"1972","Minnesota","4","7","0","0.36364","185","304","-119","Cal Stoll"
"1973","Minnesota","7","4","0","0.63636","260","295","-35","Cal Stoll"
"1974","Minnesota","4","7","0","0.36364","161","332","-171","Cal Stoll"
"1975","Minnesota","6","5","0","0.54545","236","192","44","Cal Stoll"
"1976","Minnesota","6","5","0","0.54545","201","211","-10","Cal Stoll"
"1977","Minnesota","7","5","0","0.58333","171","180","-9","Cal Stoll"
"1978","Minnesota","5","6","0","0.45455","210","267","-57","Cal Stoll"
"1979","Minnesota","4","6","1","0.40909","264","271","-7","Joe Salem"
"1980","Minnesota","5","6","0","0.45455","210","250","-40","Joe Salem"
"1981","Minnesota","6","5","0","0.54545","274","264","10","Joe Salem"
"1982","Minnesota","3","8","0","0.27273","247","295","-48","Joe Salem"
"1983","Minnesota","1","10","0","0.09091","181","518","-337","Joe Salem"
"1984","Minnesota","4","7","0","0.36364","194","316","-122","Lou Holtz"
"1985","Minnesota","6","5","0","0.54545","273","227","46","Lou Holtz"
"1985","Minnesota","1","0","0","1","20","13","7","John Gutekunst"
"1986","Minnesota","6","6","0","0.5","261","316","-55","John Gutekunst"
"1987","Minnesota","6","5","0","0.54545","257","262","-5","John Gutekunst"
"1988","Minnesota","2","7","2","0.27273","195","246","-51","John Gutekunst"
"1989","Minnesota","6","5","0","0.54545","263","283","-20","John Gutekunst"
"1990","Minnesota","6","5","0","0.54545","224","281","-57","John Gutekunst"
"1991","Minnesota","2","9","0","0.18182","104","302","-198","John Gutekunst"
"1992","Minnesota","2","9","0","0.18182","200","313","-113","Jim Wacker"
"1993","Minnesota","4","7","0","0.36364","253","354","-101","Jim Wacker"
"1994","Minnesota","3","8","0","0.27273","256","348","-92","Jim Wacker"
"1995","Minnesota","3","8","0","0.27273","272","368","-96","Jim Wacker"
"1996","Minnesota","4","7","0","0.36364","236","340","-104","Jim Wacker"
"1997","Minnesota","3","9","0","0.25","238","334","-96","Glen Mason"
"1998","Minnesota","5","6","0","0.45455","229","249","-20","Glen Mason"
"1999","Minnesota","8","4","0","0.66667","368","196","172","Glen Mason"
"2000","Minnesota","6","6","0","0.5","375","318","57","Glen Mason"
"2001","Minnesota","4","7","0","0.36364","308","299","9","Glen Mason"
"2002","Minnesota","8","5","0","0.61538","376","319","57","Glen Mason"
"2003","Minnesota","10","3","0","0.76923","503","285","218","Glen Mason"
"2004","Minnesota","7","5","0","0.58333","361","273","88","Glen Mason"
"2005","Minnesota","7","5","0","0.58333","429","348","81","Glen Mason"
"2006","Minnesota","6","7","0","0.46154","376","338","38","Glen Mason"
"2007","Minnesota","1","11","0","0.08333","315","440","-125","Tim Brewster"
"2008","Minnesota","7","6","0","0.53846","302","322","-20","Tim Brewster"
"2009","Minnesota","6","7","0","0.46154","272","309","-37","Tim Brewster"
"2010","Minnesota","1","6","0","0.14286","174","222","-48","Tim Brewster"
"2010","Minnesota","2","3","0","0.4","104","174","-70","Jeff Horton"
"2011","Minnesota","3","9","0","0.25","221","380","-159","Jerry Kill"
"2012","Minnesota","6","7","0","0.46154","287","321","-34","Jerry Kill"
"2013","Minnesota","4","2","0","0.66667","191","124","67","Jerry Kill"
"2014","Minnesota","8","5","0","0.61538","369","314","55","Jerry Kill"
"2013","Minnesota","4","3","0","0.57143","143","165","-22","Tracy Claeys"
"1893","Mississippi","4","1","0","0.8","120","28","92","Dr. Alexander H. Bondurant"
"1894","Mississippi","6","1","0","0.85714","115","48","67","C.D. Clark"
"1895","Mississippi","2","1","0","0.66667","24","28","-4","H.L. Fairbanks"
"1896","Mississippi","1","2","0","0.33333","24","22","2","John W. Hollister"
"1898","Mississippi","1","1","0","0.5","18","16","2","T.G. Scarbrough"
"1899","Mississippi","3","4","0","0.42857","44","47","-3","W.H. Lyon"
"1900","Mississippi","0","3","0","0","5","30","-25","Z.N. Estes"
"1901","Mississippi","2","4","0","0.33333","34","129","-95","William Shibley"
"1902","Mississippi","4","3","0","0.57143","121","46","75","Daniel S. Martin"
"1903","Mississippi","2","1","1","0.625","34","39","-5","Michael Smith ""Mike"" Harvey"
"1904","Mississippi","4","3","0","0.57143","185","106","79","Michael Smith ""Mike"" Harvey"
"1906","Mississippi","4","2","0","0.66667","71","64","7","T.S. Hammond"
"1907","Mississippi","0","6","0","0","6","195","-189","Frank Mason"
"1908","Mississippi","3","5","0","0.375","99","125","-26","Frank Kyle"
"1909","Mississippi","4","3","2","0.55556","99","49","50","Dr. N.P. Stauffer"
"1910","Mississippi","7","1","0","0.875","144","9","135","Dr. N.P. Stauffer"
"1911","Mississippi","6","3","0","0.66667","184","55","129","Dr. N.P. Stauffer"
"1912","Mississippi","5","3","0","0.625","127","100","27","Leo DeTray"
"1913","Mississippi","6","3","1","0.65","139","79","60","William L. ""Billy"" Driver"
"1914","Mississippi","5","4","1","0.55","110","126","-16","William L. ""Billy"" Driver"
"1915","Mississippi","2","6","0","0.25","51","334","-283","Fred Robbins"
"1916","Mississippi","3","6","0","0.33333","128","188","-60","Fred Robbins"
"1917","Mississippi","1","4","1","0.25","49","226","-177","C.R. ""Dudy"" Noble"
"1918","Mississippi","1","3","0","0.25","39","53","-14","C.R. ""Dudy"" Noble"
"1919","Mississippi","4","4","0","0.5","105","128","-23","R.L. Sullivan"
"1920","Mississippi","4","3","0","0.57143","217","85","132","R.L. Sullivan"
"1921","Mississippi","3","6","0","0.33333","179","133","46","R.L. Sullivan"
"1922","Mississippi","4","5","1","0.45","87","183","-96","Roland A. Cowell"
"1923","Mississippi","4","6","0","0.4","81","145","-64","Roland A. Cowell"
"1924","Mississippi","4","5","0","0.44444","36","142","-106","Chester S. Barnard"
"1925","Mississippi","5","5","0","0.5","147","87","60","Homer Hazel"
"1926","Mississippi","5","4","0","0.55556","113","110","3","Homer Hazel"
"1927","Mississippi","5","3","1","0.61111","177","80","97","Homer Hazel"
"1928","Mississippi","5","4","0","0.55556","156","121","35","Homer Hazel"
"1929","Mississippi","1","6","2","0.22222","73","222","-149","Homer Hazel"
"1930","Mississippi","3","5","1","0.38889","128","140","-12","Ed Walker"
"1931","Mississippi","2","6","1","0.27778","73","210","-137","Ed Walker"
"1932","Mississippi","5","6","0","0.45455","148","148","0","Ed Walker"
"1933","Mississippi","6","3","2","0.63636","167","79","88","Ed Walker"
"1934","Mississippi","4","5","1","0.45","114","98","16","Ed Walker"
"1935","Mississippi","9","3","0","0.75","311","86","225","Ed Walker"
"1936","Mississippi","5","5","2","0.5","150","98","52","Ed Walker"
"1937","Mississippi","4","5","1","0.45","127","106","21","Ed Walker"
"1938","Mississippi","9","2","0","0.81818","232","120","112","Harry J. Mehre"
"1939","Mississippi","7","2","0","0.77778","230","64","166","Harry J. Mehre"
"1940","Mississippi","9","2","0","0.81818","251","100","151","Harry J. Mehre"
"1941","Mississippi","6","2","1","0.72222","131","67","64","Harry J. Mehre"
"1942","Mississippi","2","7","0","0.22222","132","163","-31","Harry J. Mehre"
"1944","Mississippi","2","6","0","0.25","77","178","-101","Harry J. Mehre"
"1945","Mississippi","4","5","0","0.44444","100","183","-83","Harry J. Mehre"
"1946","Mississippi","2","7","0","0.22222","76","144","-68","Harold D. ""Red"" Drew"
"1947","Mississippi","9","2","0","0.81818","269","110","159","John H. Vaught"
"1948","Mississippi","8","1","0","0.88889","226","93","133","John H. Vaught"
"1949","Mississippi","4","5","1","0.45","246","243","3","John H. Vaught"
"1950","Mississippi","5","5","0","0.5","207","183","24","John H. Vaught"
"1951","Mississippi","6","3","1","0.65","254","157","97","John H. Vaught"
"1952","Mississippi","8","1","2","0.81818","244","120","124","John H. Vaught"
"1953","Mississippi","7","2","1","0.75","236","113","123","John H. Vaught"
"1954","Mississippi","9","2","0","0.81818","283","68","215","John H. Vaught"
"1955","Mississippi","10","1","0","0.90909","265","110","155","John H. Vaught"
"1956","Mississippi","7","3","0","0.7","207","82","125","John H. Vaught"
"1957","Mississippi","9","1","1","0.86364","271","59","212","John H. Vaught"
"1958","Mississippi","9","2","0","0.81818","222","68","154","John H. Vaught"
"1959","Mississippi","10","1","0","0.90909","350","21","329","John H. Vaught"
"1960","Mississippi","10","0","1","0.95455","280","70","210","John H. Vaught"
"1961","Mississippi","9","2","0","0.81818","333","52","281","John H. Vaught"
"1962","Mississippi","10","0","0","1","247","53","194","John H. Vaught"
"1963","Mississippi","7","1","2","0.8","214","45","169","John H. Vaught"
"1964","Mississippi","5","5","1","0.5","217","127","90","John H. Vaught"
"1965","Mississippi","7","4","0","0.63636","179","115","64","John H. Vaught"
"1966","Mississippi","8","3","0","0.72727","170","65","105","John H. Vaught"
"1967","Mississippi","6","4","1","0.59091","181","165","16","John H. Vaught"
"1968","Mississippi","7","3","1","0.68182","212","197","15","John H. Vaught"
"1969","Mississippi","8","3","0","0.72727","334","162","172","John H. Vaught"
"1970","Mississippi","7","4","0","0.63636","313","255","58","John H. Vaught"
"1973","Mississippi","5","3","0","0.625","165","137","28","John H. Vaught"
"1971","Mississippi","10","2","0","0.83333","363","222","141","Billy R. Kinard"
"1972","Mississippi","5","5","0","0.5","192","142","50","Billy R. Kinard"
"1973","Mississippi","1","2","0","0.33333","37","40","-3","Billy R. Kinard"
"1974","Mississippi","3","8","0","0.27273","135","241","-106","Ken Cooper"
"1975","Mississippi","6","5","0","0.54545","170","162","8","Ken Cooper"
"1976","Mississippi","6","5","0","0.54545","153","180","-27","Ken Cooper"
"1977","Mississippi","6","5","0","0.54545","208","196","12","Ken Cooper"
"1978","Mississippi","5","6","0","0.45455","181","240","-59","Steve Sloan"
"1979","Mississippi","4","7","0","0.36364","251","298","-47","Steve Sloan"
"1980","Mississippi","3","8","0","0.27273","263","266","-3","Steve Sloan"
"1981","Mississippi","4","6","1","0.40909","167","284","-117","Steve Sloan"
"1982","Mississippi","4","7","0","0.36364","208","262","-54","Steve Sloan"
"1983","Mississippi","7","5","0","0.58333","179","264","-85","Billy Brewer"
"1984","Mississippi","4","6","1","0.40909","194","203","-9","Billy Brewer"
"1985","Mississippi","4","6","1","0.40909","210","276","-66","Billy Brewer"
"1986","Mississippi","8","3","1","0.70833","240","167","73","Billy Brewer"
"1987","Mississippi","3","8","0","0.27273","223","309","-86","Billy Brewer"
"1988","Mississippi","5","6","0","0.45455","221","223","-2","Billy Brewer"
"1989","Mississippi","8","4","0","0.66667","309","314","-5","Billy Brewer"
"1990","Mississippi","9","3","0","0.75","260","226","34","Billy Brewer"
"1991","Mississippi","5","6","0","0.45455","242","223","19","Billy Brewer"
"1992","Mississippi","9","3","0","0.75","243","174","69","Billy Brewer"
"1993","Mississippi","6","5","0","0.54545","242","142","100","Billy Brewer"
"1994","Mississippi","4","7","0","0.36364","246","205","41","Joe Lee Dunn"
"1995","Mississippi","6","5","0","0.54545","209","208","1","Tommy Tuberville"
"1996","Mississippi","5","6","0","0.45455","203","270","-67","Tommy Tuberville"
"1997","Mississippi","8","4","0","0.66667","267","240","27","Tommy Tuberville"
"1998","Mississippi","6","5","0","0.54545","245","256","-11","Tommy Tuberville"
"1998","Mississippi","1","0","0","1","35","18","17","David Cutcliffe"
"1999","Mississippi","8","4","0","0.66667","323","228","95","David Cutcliffe"
"2000","Mississippi","7","5","0","0.58333","352","329","23","David Cutcliffe"
"2001","Mississippi","7","4","0","0.63636","391","310","81","David Cutcliffe"
"2002","Mississippi","7","6","0","0.53846","351","331","20","David Cutcliffe"
"2003","Mississippi","10","3","0","0.76923","442","285","157","David Cutcliffe"
"2004","Mississippi","4","7","0","0.36364","215","278","-63","David Cutcliffe"
"2005","Mississippi","3","8","0","0.27273","148","245","-97","Ed Orgeron"
"2006","Mississippi","4","8","0","0.33333","188","275","-87","Ed Orgeron"
"2007","Mississippi","3","9","0","0.25","241","342","-101","Ed Orgeron"
"2008","Mississippi","9","4","0","0.69231","417","247","170","Houston Nutt"
"2009","Mississippi","9","4","0","0.69231","384","230","154","Houston Nutt"
"2010","Mississippi","4","8","0","0.33333","367","422","-55","Houston Nutt"
"2011","Mississippi","2","10","0","0.16667","193","385","-192","Houston Nutt"
"2012","Mississippi","7","6","0","0.53846","409","359","50","Hugh Freeze"
"2013","Mississippi","8","5","0","0.61538","390","308","82","Hugh Freeze"
"2014","Mississippi","9","4","0","0.69231","368","208","160","Hugh Freeze"
"1895","Mississippi St.","0","2","0","0","0","37","-37","W.M. Matthews"
"1896","Mississippi St.","0","4","0","0","0","135","-135","J.B. Hildebrand"
"1901","Mississippi St.","2","2","1","0.5","34","74","-40","L.B. Harvey"
"1902","Mississippi St.","1","4","1","0.25","42","81","-39","L. Gwinn"
"1903","Mississippi St.","3","0","2","0.8","71","6","65","Daniel S. Martin"
"1904","Mississippi St.","2","5","0","0.28571","106","130","-24","Daniel S. Martin"
"1905","Mississippi St.","3","4","0","0.42857","98","94","4","Daniel S. Martin"
"1906","Mississippi St.","2","2","1","0.5","101","45","56","Daniel S. Martin"
"1907","Mississippi St.","6","3","0","0.66667","210","77","133","Fred Furman"
"1908","Mississippi St.","3","4","0","0.42857","108","113","-5","Fred Furman"
"1909","Mississippi St.","5","4","0","0.55556","150","44","106","W.D. Chadwick"
"1910","Mississippi St.","7","2","0","0.77778","219","36","183","W.D. Chadwick"
"1911","Mississippi St.","7","2","1","0.75","206","29","177","W.D. Chadwick"
"1912","Mississippi St.","4","3","0","0.57143","102","75","27","W.D. Chadwick"
"1913","Mississippi St.","6","1","1","0.8125","156","47","109","W.D. Chadwick"
"1914","Mississippi St.","6","2","0","0.75","289","38","251","Earle C. ""Billy"" Hayes"
"1915","Mississippi St.","5","2","1","0.6875","110","36","74","Earle C. ""Billy"" Hayes"
"1916","Mississippi St.","4","4","1","0.5","125","60","65","Earle C. ""Billy"" Hayes"
"1917","Mississippi St.","7","1","0","0.875","184","39","145","Stanley Lewis ""Robbie"" Robinson"
"1918","Mississippi St.","3","2","0","0.6","65","13","52","Stanley Lewis ""Robbie"" Robinson"
"1919","Mississippi St.","6","2","0","0.75","158","34","124","Stanley Lewis ""Robbie"" Robinson"
"1920","Mississippi St.","5","3","0","0.625","112","68","44","Fred Holtkamp"
"1921","Mississippi St.","4","4","1","0.5","111","125","-14","Fred Holtkamp"
"1922","Mississippi St.","3","4","2","0.44444","56","184","-128","C.R. ""Dudy"" Noble"
"1923","Mississippi St.","5","2","2","0.66667","83","66","17","Earl C. Abell"
"1924","Mississippi St.","5","4","0","0.55556","82","89","-7","Earl C. Abell"
"1925","Mississippi St.","3","4","1","0.4375","101","60","41","Bernard W. ""Bernie"" Bierman"
"1926","Mississippi St.","5","4","0","0.55556","134","98","36","Bernard W. ""Bernie"" Bierman"
"1927","Mississippi St.","5","3","0","0.625","93","54","39","John W. Hancock"
"1928","Mississippi St.","2","4","2","0.375","70","166","-96","John W. Hancock"
"1929","Mississippi St.","1","5","2","0.25","51","139","-88","John W. Hancock"
"1930","Mississippi St.","2","7","0","0.22222","47","170","-123","Chris Cagle"
"1931","Mississippi St.","2","6","0","0.25","47","187","-140","Ray Dauber"
"1932","Mississippi St.","3","5","0","0.375","33","155","-122","Ray Dauber"
"1933","Mississippi St.","3","6","1","0.35","69","149","-80","Ross McKechnie"
"1934","Mississippi St.","4","6","0","0.4","79","126","-47","Ross McKechnie"
"1935","Mississippi St.","8","3","0","0.72727","191","77","114","Ralph I. Sasse"
"1936","Mississippi St.","7","3","1","0.68182","232","38","194","Ralph I. Sasse"
"1937","Mississippi St.","5","4","1","0.55","119","117","2","Ralph I. Sasse"
"1938","Mississippi St.","4","6","0","0.4","123","131","-8","Emerson W. ""Spike"" Nelson"
"1939","Mississippi St.","8","2","0","0.8","216","32","184","Allyn McKeen"
"1940","Mississippi St.","10","0","1","0.95455","245","58","187","Allyn McKeen"
"1941","Mississippi St.","8","1","1","0.85","191","55","136","Allyn McKeen"
"1942","Mississippi St.","8","2","0","0.8","200","77","123","Allyn McKeen"
"1944","Mississippi St.","6","2","0","0.75","219","79","140","Allyn McKeen"
"1945","Mississippi St.","6","3","0","0.66667","221","108","113","Allyn McKeen"
"1946","Mississippi St.","8","2","0","0.8","271","71","200","Allyn McKeen"
"1947","Mississippi St.","7","3","0","0.7","169","89","80","Allyn McKeen"
"1948","Mississippi St.","4","4","1","0.5","103","87","16","Allyn McKeen"
"1949","Mississippi St.","0","8","1","0.05556","38","224","-186","Arthur W. ""Slick"" Morton"
"1950","Mississippi St.","4","5","0","0.44444","169","137","32","Arthur W. ""Slick"" Morton"
"1951","Mississippi St.","4","5","0","0.44444","82","127","-45","Arthur W. ""Slick"" Morton"
"1952","Mississippi St.","5","4","0","0.55556","225","186","39","Murray Warmath"
"1953","Mississippi St.","5","2","3","0.65","196","119","77","Murray Warmath"
"1954","Mississippi St.","6","4","0","0.6","192","120","72","Darrell Royal"
"1955","Mississippi St.","6","4","0","0.6","173","142","31","Darrell Royal"
"1956","Mississippi St.","4","6","0","0.4","148","152","-4","Wade Walker"
"1957","Mississippi St.","6","2","1","0.72222","175","100","75","Wade Walker"
"1958","Mississippi St.","3","6","0","0.33333","127","129","-2","Wade Walker"
"1959","Mississippi St.","2","7","0","0.22222","96","198","-102","Wade Walker"
"1960","Mississippi St.","2","6","1","0.27778","101","119","-18","Wade Walker"
"1961","Mississippi St.","5","5","0","0.5","111","135","-24","Wade Walker"
"1962","Mississippi St.","3","6","0","0.33333","76","132","-56","Paul E. Davis"
"1963","Mississippi St.","7","2","2","0.72727","185","94","91","Paul E. Davis"
"1964","Mississippi St.","4","6","0","0.4","155","143","12","Paul E. Davis"
"1965","Mississippi St.","4","6","0","0.4","202","172","30","Paul E. Davis"
"1966","Mississippi St.","2","8","0","0.2","75","176","-101","Paul E. Davis"
"1967","Mississippi St.","1","9","0","0.1","49","259","-210","Charley Shira"
"1968","Mississippi St.","0","8","2","0.1","146","260","-114","Charley Shira"
"1969","Mississippi St.","3","7","0","0.3","193","385","-192","Charley Shira"
"1970","Mississippi St.","6","5","0","0.54545","171","264","-93","Charley Shira"
"1971","Mississippi St.","2","9","0","0.18182","120","311","-191","Charley Shira"
"1972","Mississippi St.","4","7","0","0.36364","197","254","-57","Charley Shira"
"1973","Mississippi St.","4","5","2","0.45455","219","255","-36","Bob Tyler"
"1974","Mississippi St.","9","3","0","0.75","327","224","103","Bob Tyler"
"1975","Mississippi St.","2","9","0","0.18182","165","166","-1","Bob Tyler"
"1976","Mississippi St.","0","11","0","0","269","178","91","Bob Tyler"
"1977","Mississippi St.","0","11","0","0","193","227","-34","Bob Tyler"
"1978","Mississippi St.","6","5","0","0.54545","232","205","27","Bob Tyler"
"1979","Mississippi St.","3","8","0","0.27273","162","179","-17","Emory Bellard"
"1980","Mississippi St.","9","3","0","0.75","301","247","54","Emory Bellard"
"1981","Mississippi St.","8","4","0","0.66667","212","137","75","Emory Bellard"
"1982","Mississippi St.","5","6","0","0.45455","252","244","8","Emory Bellard"
"1983","Mississippi St.","3","8","0","0.27273","196","279","-83","Emory Bellard"
"1984","Mississippi St.","4","7","0","0.36364","198","230","-32","Emory Bellard"
"1985","Mississippi St.","5","6","0","0.45455","257","288","-31","Emory Bellard"
"1986","Mississippi St.","6","5","0","0.54545","195","275","-80","Rockey Felker"
"1987","Mississippi St.","4","7","0","0.36364","169","259","-90","Rockey Felker"
"1988","Mississippi St.","1","10","0","0.09091","172","332","-160","Rockey Felker"
"1989","Mississippi St.","5","6","0","0.45455","205","207","-2","Rockey Felker"
"1990","Mississippi St.","5","6","0","0.45455","207","236","-29","Rockey Felker"
"1991","Mississippi St.","7","5","0","0.58333","291","194","97","Jackie Sherrill"
"1992","Mississippi St.","7","5","0","0.58333","252","197","55","Jackie Sherrill"
"1993","Mississippi St.","4","5","2","0.45455","241","245","-4","Jackie Sherrill"
"1994","Mississippi St.","8","4","0","0.66667","373","262","111","Jackie Sherrill"
"1995","Mississippi St.","3","8","0","0.27273","261","357","-96","Jackie Sherrill"
"1996","Mississippi St.","5","6","0","0.45455","249","229","20","Jackie Sherrill"
"1997","Mississippi St.","7","4","0","0.63636","226","215","11","Jackie Sherrill"
"1998","Mississippi St.","8","5","0","0.61538","350","256","94","Jackie Sherrill"
"1999","Mississippi St.","10","2","0","0.83333","255","156","99","Jackie Sherrill"
"2000","Mississippi St.","8","4","0","0.66667","390","306","84","Jackie Sherrill"
"2001","Mississippi St.","3","8","0","0.27273","196","288","-92","Jackie Sherrill"
"2002","Mississippi St.","3","9","0","0.25","227","339","-112","Jackie Sherrill"
"2003","Mississippi St.","2","10","0","0.16667","225","471","-246","Jackie Sherrill"
"2004","Mississippi St.","3","8","0","0.27273","173","280","-107","Sylvester ""Sly"" Croom"
"2005","Mississippi St.","3","8","0","0.27273","153","259","-106","Sylvester ""Sly"" Croom"
"2006","Mississippi St.","3","9","0","0.25","221","309","-88","Sylvester ""Sly"" Croom"
"2007","Mississippi St.","8","5","0","0.61538","279","301","-22","Sylvester ""Sly"" Croom"
"2008","Mississippi St.","4","8","0","0.33333","183","296","-113","Sylvester ""Sly"" Croom"
"2009","Mississippi St.","5","7","0","0.41667","307","321","-14","Dan Mullen"
"2010","Mississippi St.","9","4","0","0.69231","377","258","119","Dan Mullen"
"2011","Mississippi St.","7","6","0","0.53846","329","256","73","Dan Mullen"
"2012","Mississippi St.","8","5","0","0.61538","383","303","80","Dan Mullen"
"2013","Mississippi St.","7","6","0","0.53846","360","299","61","Dan Mullen"
"2014","Mississippi St.","10","3","0","0.76923","480","282","198","Dan Mullen"
"1890","Missouri","2","1","0","0.66667","112","34","78","A.L. McRae"
"1891","Missouri","3","1","0","0.75","106","28","78","Hal Reed"
"1892","Missouri","1","2","0","0.33333","28","13","15","E.H. Jones"
"1893","Missouri","4","3","0","0.57143","154","136","18","Harry Orman Robinson"
"1894","Missouri","4","3","0","0.57143","134","108","26","Harry Orman Robinson"
"1895","Missouri","7","1","0","0.875","156","42","114","Clifford Douglas ""Pop"" Bliss"
"1896","Missouri","11","5","1","0.67647","319","94","225","Frank H. Patterson"
"1897","Missouri","5","6","0","0.45455","112","143","-31","Charles Young"
"1898","Missouri","4","4","1","0.5","88","103","-15","David Lewis Fultz"
"1900","Missouri","1","0","0","1","13","0","13","David Lewis Fultz"
"1899","Missouri","9","2","0","0.81818","242","56","186","Ernest Cleveland ""E.C."" White"
"1901","Missouri","1","7","1","0.16667","29","156","-127","Frederick W. ""Fred"" Murphy"
"1902","Missouri","5","3","0","0.625","99","80","19","Pat O'Dea"
"1903","Missouri","1","7","1","0.16667","46","83","-37","John F. Mclean"
"1904","Missouri","3","6","0","0.33333","50","130","-80","John F. Mclean"
"1905","Missouri","5","4","0","0.55556","94","79","15","John F. Mclean"
"1906","Missouri","5","2","1","0.6875","116","44","72","W.J. Monilaw"
"1907","Missouri","7","2","0","0.77778","278","41","237","W.J. Monilaw"
"1908","Missouri","6","2","0","0.75","196","45","151","W.J. Monilaw"
"1909","Missouri","7","0","1","0.9375","86","36","50","William W. ""Bill"" Roper"
"1910","Missouri","4","2","2","0.625","77","17","60","William M. ""Bill"" Hollenback"
"1911","Missouri","2","4","2","0.375","61","67","-6","Chester L. Brewer"
"1912","Missouri","5","3","0","0.625","135","69","66","Chester L. Brewer"
"1913","Missouri","7","1","0","0.875","193","67","126","Chester L. Brewer"
"1914","Missouri","5","3","0","0.625","128","48","80","Henry F. Schulte"
"1915","Missouri","2","5","1","0.3125","72","102","-30","Henry F. Schulte"
"1916","Missouri","6","1","1","0.8125","112","21","91","Henry F. Schulte"
"1917","Missouri","3","5","0","0.375","98","124","-26","Henry F. Schulte"
"1919","Missouri","5","1","2","0.75","91","42","49","John F. Miller"
"1920","Missouri","7","1","0","0.875","156","61","95","James M. ""Jimmy"" Phelan"
"1921","Missouri","6","2","0","0.75","136","50","86","James M. ""Jimmy"" Phelan"
"1922","Missouri","5","3","0","0.625","98","90","8","Thomas ""Tom"" Kelley"
"1923","Missouri","2","3","3","0.4375","31","40","-9","Gwinn Henry"
"1924","Missouri","7","2","0","0.77778","110","41","69","Gwinn Henry"
"1925","Missouri","6","1","1","0.8125","110","44","66","Gwinn Henry"
"1926","Missouri","5","1","2","0.75","122","33","89","Gwinn Henry"
"1927","Missouri","7","2","0","0.77778","129","90","39","Gwinn Henry"
"1928","Missouri","4","4","0","0.5","138","102","36","Gwinn Henry"
"1929","Missouri","5","2","1","0.6875","78","28","50","Gwinn Henry"
"1930","Missouri","2","5","2","0.33333","41","132","-91","Gwinn Henry"
"1931","Missouri","2","8","0","0.2","72","193","-121","Gwinn Henry"
"1932","Missouri","1","7","1","0.16667","32","184","-152","Frank Carideo"
"1933","Missouri","1","8","0","0.11111","58","193","-135","Frank Carideo"
"1934","Missouri","0","8","1","0.05556","25","172","-147","Frank Carideo"
"1943","Missouri","3","5","0","0.375","170","142","28","C.G. ""Chauncey"" Simpson"
"1944","Missouri","3","5","2","0.4","176","224","-48","C.G. ""Chauncey"" Simpson"
"1945","Missouri","6","4","0","0.6","170","174","-4","C.G. ""Chauncey"" Simpson"
"1935","Missouri","3","3","3","0.5","97","77","20","Don B. Faurot"
"1936","Missouri","6","2","1","0.72222","107","74","33","Don B. Faurot"
"1937","Missouri","3","6","1","0.35","42","64","-22","Don B. Faurot"
"1938","Missouri","6","3","0","0.66667","111","82","29","Don B. Faurot"
"1939","Missouri","8","2","0","0.8","155","79","76","Don B. Faurot"
"1940","Missouri","6","3","0","0.66667","213","125","88","Don B. Faurot"
"1941","Missouri","8","2","0","0.8","226","39","187","Don B. Faurot"
"1942","Missouri","8","3","1","0.70833","288","107","181","Don B. Faurot"
"1946","Missouri","5","4","1","0.55","158","166","-8","Don B. Faurot"
"1947","Missouri","6","4","0","0.6","240","116","124","Don B. Faurot"
"1948","Missouri","8","3","0","0.72727","331","161","170","Don B. Faurot"
"1949","Missouri","7","4","0","0.63636","264","225","39","Don B. Faurot"
"1950","Missouri","4","5","1","0.45","166","215","-49","Don B. Faurot"
"1951","Missouri","3","7","0","0.3","169","292","-123","Don B. Faurot"
"1952","Missouri","5","5","0","0.5","147","159","-12","Don B. Faurot"
"1953","Missouri","6","4","0","0.6","130","116","14","Don B. Faurot"
"1954","Missouri","4","5","1","0.45","198","261","-63","Don B. Faurot"
"1955","Missouri","1","9","0","0.1","92","192","-100","Don B. Faurot"
"1956","Missouri","4","5","1","0.45","200","183","17","Don B. Faurot"
"1957","Missouri","5","4","1","0.55","149","157","-8","Frank Broyles"
"1958","Missouri","5","4","1","0.55","164","141","23","Dan Devine"
"1959","Missouri","6","5","0","0.54545","125","124","1","Dan Devine"
"1960","Missouri","11","0","0","1","295","93","202","Dan Devine"
"1961","Missouri","7","2","1","0.75","124","57","67","Dan Devine"
"1962","Missouri","8","1","2","0.81818","204","62","142","Dan Devine"
"1963","Missouri","7","3","0","0.7","151","86","65","Dan Devine"
"1964","Missouri","6","3","1","0.65","142","88","54","Dan Devine"
"1965","Missouri","8","2","1","0.77273","223","101","122","Dan Devine"
"1966","Missouri","6","3","1","0.65","121","116","5","Dan Devine"
"1967","Missouri","7","3","0","0.7","134","76","58","Dan Devine"
"1968","Missouri","8","3","0","0.72727","308","136","172","Dan Devine"
"1969","Missouri","9","2","0","0.81818","365","191","174","Dan Devine"
"1970","Missouri","5","6","0","0.45455","243","223","20","Dan Devine"
"1971","Missouri","1","10","0","0.09091","93","260","-167","Al Onofrio"
"1972","Missouri","7","5","0","0.58333","219","311","-92","Al Onofrio"
"1973","Missouri","8","4","0","0.66667","219","152","67","Al Onofrio"
"1974","Missouri","7","4","0","0.63636","204","217","-13","Al Onofrio"
"1975","Missouri","6","5","0","0.54545","282","241","41","Al Onofrio"
"1976","Missouri","6","5","0","0.54545","246","241","5","Al Onofrio"
"1977","Missouri","4","7","0","0.36364","195","180","15","Al Onofrio"
"1978","Missouri","8","4","0","0.66667","368","236","132","Warren Powers"
"1979","Missouri","7","5","0","0.58333","260","166","94","Warren Powers"
"1980","Missouri","8","4","0","0.66667","332","175","157","Warren Powers"
"1981","Missouri","8","4","0","0.66667","276","159","117","Warren Powers"
"1982","Missouri","5","4","2","0.54545","207","196","11","Warren Powers"
"1983","Missouri","7","5","0","0.58333","292","202","90","Warren Powers"
"1984","Missouri","3","7","1","0.31818","310","301","9","Warren Powers"
"1985","Missouri","1","10","0","0.09091","206","342","-136","Woody Widenhofer"
"1986","Missouri","3","8","0","0.27273","196","314","-118","Woody Widenhofer"
"1987","Missouri","5","6","0","0.45455","226","209","17","Woody Widenhofer"
"1988","Missouri","3","7","1","0.31818","234","330","-96","Woody Widenhofer"
"1989","Missouri","2","9","0","0.18182","171","363","-192","Bob Stull"
"1990","Missouri","4","7","0","0.36364","278","360","-82","Bob Stull"
"1991","Missouri","3","7","1","0.31818","223","403","-180","Bob Stull"
"1992","Missouri","3","8","0","0.27273","214","269","-55","Bob Stull"
"1993","Missouri","3","7","1","0.31818","192","344","-152","Bob Stull"
"1994","Missouri","3","8","1","0.29167","208","325","-117","Larry Smith"
"1995","Missouri","3","8","0","0.27273","186","311","-125","Larry Smith"
"1996","Missouri","5","6","0","0.45455","278","376","-98","Larry Smith"
"1997","Missouri","7","5","0","0.58333","392","367","25","Larry Smith"
"1998","Missouri","8","4","0","0.66667","334","236","98","Larry Smith"
"1999","Missouri","4","7","0","0.36364","224","371","-147","Larry Smith"
"2000","Missouri","3","8","0","0.27273","255","348","-93","Larry Smith"
"2011","Missouri","1","0","0","1","31","27","4","Dave Steckel"
"2001","Missouri","4","7","0","0.36364","240","330","-90","Gary Pinkel"
"2002","Missouri","5","7","0","0.41667","360","352","8","Gary Pinkel"
"2003","Missouri","8","5","0","0.61538","399","287","112","Gary Pinkel"
"2004","Missouri","5","6","0","0.45455","256","215","41","Gary Pinkel"
"2005","Missouri","7","5","0","0.58333","369","350","19","Gary Pinkel"
"2006","Missouri","8","5","0","0.61538","391","254","137","Gary Pinkel"
"2007","Missouri","12","2","0","0.85714","558","326","232","Gary Pinkel"
"2008","Missouri","10","4","0","0.71429","591","381","210","Gary Pinkel"
"2009","Missouri","8","5","0","0.61538","377","330","47","Gary Pinkel"
"2010","Missouri","10","3","0","0.76923","388","209","179","Gary Pinkel"
"2011","Missouri","7","5","0","0.58333","396","279","117","Gary Pinkel"
"2012","Missouri","5","7","0","0.41667","309","341","-32","Gary Pinkel"
"2013","Missouri","12","2","0","0.85714","548","323","225","Gary Pinkel"
"2014","Missouri","11","3","0","0.78571","389","295","94","Gary Pinkel"
"1882","Navy (MD)","1","0","0","1","2","0","2","Vauix Carter"
"1892","Navy (MD)","5","2","0","0.71429","146","64","82","Benjamin L. ""Ben"" Crosby"
"1893","Navy (MD)","5","3","0","0.625","122","78","44","John A. ""Josh"" Hartwell"
"1894","Navy (MD)","4","1","2","0.71429","72","30","42","William C. ""Bill"" Wurtenburg"
"1895","Navy (MD)","5","2","0","0.71429","152","16","136","Matthew ""Matt"" McClung"
"1896","Navy (MD)","5","3","0","0.625","180","53","127","John P. ""Johnny"" Poe"
"1897","Navy (MD)","8","1","0","0.88889","111","34","77","Richard ""Bill"" Armstrong"
"1898","Navy (MD)","7","1","0","0.875","130","56","74","Richard ""Bill"" Armstrong"
"1899","Navy (MD)","5","3","0","0.625","94","27","67","Richard ""Bill"" Armstrong"
"1900","Navy (MD)","6","3","0","0.66667","106","51","55","Garrett Cochran"
"1901","Navy (MD)","6","4","1","0.59091","113","81","32","Arthur R.T. ""Doc"" Hillebrand"
"1902","Navy (MD)","2","7","1","0.25","35","99","-64","Arthur R.T. ""Doc"" Hillebrand"
"1903","Navy (MD)","4","7","1","0.375","77","130","-53","B.C. ""Burr"" Chamberlain"
"1904","Navy (MD)","7","2","1","0.75","149","38","111","Paul J. Dashiell"
"1905","Navy (MD)","10","1","1","0.875","243","23","220","Paul J. Dashiell"
"1906","Navy (MD)","8","2","2","0.75","149","14","135","Paul J. Dashiell"
"1907","Navy (MD)","9","2","1","0.79167","118","34","84","Cmdr. Joseph M. ""Joe"" Reeves"
"1908","Navy (MD)","9","2","1","0.79167","218","38","180","Lt. Frank D. Berrien"
"1909","Navy (MD)","4","3","1","0.5625","99","42","57","Lt. Frank D. Berrien"
"1910","Navy (MD)","8","0","1","0.94444","99","0","99","Lt. Frank D. Berrien"
"1911","Navy (MD)","6","0","3","0.83333","116","11","105","Lt. Douglas L. ""Doug"" Howard"
"1912","Navy (MD)","6","3","0","0.66667","126","61","65","Lt. Douglas L. ""Doug"" Howard"
"1913","Navy (MD)","7","1","1","0.83333","304","29","275","Lt. Douglas L. ""Doug"" Howard"
"1914","Navy (MD)","6","3","0","0.66667","174","83","91","Lt. Douglas L. ""Doug"" Howard"
"1915","Navy (MD)","3","5","1","0.38889","99","118","-19","Lt. Jonas H. Ingram"
"1916","Navy (MD)","6","3","1","0.65","199","76","123","Lt. Jonas H. Ingram"
"1917","Navy (MD)","7","1","0","0.875","442","23","419","Gilmour ""Gloomy Gil"" Dobie"
"1918","Navy (MD)","4","1","0","0.8","283","20","263","Gilmour ""Gloomy Gil"" Dobie"
"1919","Navy (MD)","7","1","0","0.875","298","18","280","Gilmour ""Gloomy Gil"" Dobie"
"1920","Navy (MD)","6","2","0","0.75","164","43","121","Robert C. ""Bob"" Folwell"
"1921","Navy (MD)","6","1","0","0.85714","147","13","134","Robert C. ""Bob"" Folwell"
"1922","Navy (MD)","5","2","0","0.71429","185","37","148","Robert C. ""Bob"" Folwell"
"1923","Navy (MD)","5","1","3","0.72222","168","62","106","Robert C. ""Bob"" Folwell"
"1924","Navy (MD)","2","6","0","0.25","91","79","12","Robert C. ""Bob"" Folwell"
"1925","Navy (MD)","5","2","1","0.6875","134","81","53","John E. ""Jack"" Owsley"
"1926","Navy (MD)","9","0","1","0.95","236","88","148","William A. ""Bill"" Ingram"
"1927","Navy (MD)","6","3","0","0.66667","192","84","108","William A. ""Bill"" Ingram"
"1928","Navy (MD)","5","3","1","0.61111","121","21","100","William A. ""Bill"" Ingram"
"1929","Navy (MD)","6","2","2","0.7","233","59","174","William A. ""Bill"" Ingram"
"1930","Navy (MD)","6","5","0","0.54545","148","117","31","William A. ""Bill"" Ingram"
"1931","Navy (MD)","5","5","1","0.5","78","95","-17","Edgar E. ""Rip"" Miller"
"1932","Navy (MD)","2","6","1","0.27778","67","80","-13","Edgar E. ""Rip"" Miller"
"1933","Navy (MD)","5","4","0","0.55556","90","86","4","Edgar E. ""Rip"" Miller"
"1934","Navy (MD)","8","1","0","0.88889","138","70","68","Lt. Thomas J. ""Tom"" Hamilton"
"1935","Navy (MD)","5","4","0","0.55556","136","89","47","Lt. Thomas J. ""Tom"" Hamilton"
"1936","Navy (MD)","6","3","0","0.66667","115","74","41","Lt. Thomas J. ""Tom"" Hamilton"
"1946","Navy (MD)","1","8","0","0.11111","105","186","-81","Lt. Thomas J. ""Tom"" Hamilton"
"1947","Navy (MD)","1","7","1","0.16667","86","165","-79","Lt. Thomas J. ""Tom"" Hamilton"
"1937","Navy (MD)","4","4","1","0.5","150","74","76","Lt. Harry J. ""Hank"" Hardwick"
"1938","Navy (MD)","4","3","2","0.55556","126","60","66","Lt. Harry J. ""Hank"" Hardwick"
"1939","Navy (MD)","3","5","1","0.38889","88","107","-19","Major Emery E. ""Swede"" Larson"
"1940","Navy (MD)","6","2","1","0.72222","106","46","60","Major Emery E. ""Swede"" Larson"
"1941","Navy (MD)","7","1","1","0.83333","192","34","158","Major Emery E. ""Swede"" Larson"
"1942","Navy (MD)","5","4","0","0.55556","82","58","24","Cmdr. John E. Whelchel"
"1943","Navy (MD)","8","1","0","0.88889","237","80","157","Cmdr. John E. Whelchel"
"1944","Navy (MD)","6","3","0","0.66667","236","88","148","Cmdr. Oscar E. Hagberg"
"1945","Navy (MD)","7","1","1","0.83333","220","65","155","Cmdr. Oscar E. Hagberg"
"1948","Navy (MD)","0","8","1","0.05556","77","227","-150","George H. Sauer"
"1949","Navy (MD)","3","5","1","0.38889","151","238","-87","George H. Sauer"
"1950","Navy (MD)","3","6","0","0.33333","122","176","-54","Edward J. ""Eddie"" Erdelatz"
"1951","Navy (MD)","2","6","1","0.27778","132","155","-23","Edward J. ""Eddie"" Erdelatz"
"1952","Navy (MD)","6","2","1","0.72222","147","75","72","Edward J. ""Eddie"" Erdelatz"
"1953","Navy (MD)","4","3","2","0.55556","186","99","87","Edward J. ""Eddie"" Erdelatz"
"1954","Navy (MD)","8","2","0","0.8","304","73","231","Edward J. ""Eddie"" Erdelatz"
"1955","Navy (MD)","6","2","1","0.72222","188","56","132","Edward J. ""Eddie"" Erdelatz"
"1956","Navy (MD)","6","1","2","0.77778","207","76","131","Edward J. ""Eddie"" Erdelatz"
"1957","Navy (MD)","9","1","1","0.86364","281","71","210","Edward J. ""Eddie"" Erdelatz"
"1958","Navy (MD)","6","3","0","0.66667","212","134","78","Edward J. ""Eddie"" Erdelatz"
"1959","Navy (MD)","5","4","1","0.55","199","166","33","Wayne Hardin"
"1960","Navy (MD)","9","2","0","0.81818","262","103","159","Wayne Hardin"
"1961","Navy (MD)","7","3","0","0.7","201","136","65","Wayne Hardin"
"1962","Navy (MD)","5","5","0","0.5","184","174","10","Wayne Hardin"
"1963","Navy (MD)","9","2","0","0.81818","320","165","155","Wayne Hardin"
"1964","Navy (MD)","3","6","1","0.35","140","185","-45","Wayne Hardin"
"1965","Navy (MD)","4","4","2","0.5","128","129","-1","William T. ""Bill"" Elias"
"1966","Navy (MD)","4","6","0","0.4","147","152","-5","William T. ""Bill"" Elias"
"1967","Navy (MD)","5","4","1","0.55","205","253","-48","William T. ""Bill"" Elias"
"1968","Navy (MD)","2","8","0","0.2","136","303","-167","William T. ""Bill"" Elias"
"1969","Navy (MD)","1","9","0","0.1","98","307","-209","Richard ""Rick"" Forzano"
"1970","Navy (MD)","2","9","0","0.18182","131","327","-196","Richard ""Rick"" Forzano"
"1971","Navy (MD)","3","8","0","0.27273","146","331","-185","Richard ""Rick"" Forzano"
"1972","Navy (MD)","4","7","0","0.36364","181","257","-76","Richard ""Rick"" Forzano"
"1973","Navy (MD)","4","7","0","0.36364","221","232","-11","George Welsh"
"1974","Navy (MD)","4","7","0","0.36364","131","229","-98","George Welsh"
"1975","Navy (MD)","7","4","0","0.63636","227","125","102","George Welsh"
"1976","Navy (MD)","4","7","0","0.36364","187","257","-70","George Welsh"
"1977","Navy (MD)","5","6","0","0.45455","229","230","-1","George Welsh"
"1978","Navy (MD)","9","3","0","0.75","260","136","124","George Welsh"
"1979","Navy (MD)","7","4","0","0.63636","180","154","26","George Welsh"
"1980","Navy (MD)","8","4","0","0.66667","226","146","80","George Welsh"
"1981","Navy (MD)","7","4","1","0.625","244","183","61","George Welsh"
"1982","Navy (MD)","6","5","0","0.54545","220","196","24","Gary Tranquill"
"1983","Navy (MD)","3","8","0","0.27273","202","272","-70","Gary Tranquill"
"1984","Navy (MD)","4","6","1","0.40909","240","254","-14","Gary Tranquill"
"1985","Navy (MD)","4","7","0","0.36364","253","239","14","Gary Tranquill"
"1986","Navy (MD)","3","8","0","0.27273","238","306","-68","Gary Tranquill"
"1987","Navy (MD)","2","9","0","0.18182","160","317","-157","Elliot Uzelac"
"1988","Navy (MD)","3","8","0","0.27273","221","274","-53","Elliot Uzelac"
"1989","Navy (MD)","3","8","0","0.27273","145","272","-127","Elliot Uzelac"
"1990","Navy (MD)","5","6","0","0.45455","209","294","-85","George Chaump"
"1991","Navy (MD)","1","10","0","0.09091","160","321","-161","George Chaump"
"1992","Navy (MD)","1","10","0","0.09091","131","338","-207","George Chaump"
"1993","Navy (MD)","4","7","0","0.36364","203","307","-104","George Chaump"
"1994","Navy (MD)","3","8","0","0.27273","188","399","-211","George Chaump"
"1995","Navy (MD)","5","6","0","0.45455","223","189","34","Charlie Weatherbie"
"1996","Navy (MD)","9","3","0","0.75","392","309","83","Charlie Weatherbie"
"1997","Navy (MD)","7","4","0","0.63636","398","209","189","Charlie Weatherbie"
"1998","Navy (MD)","3","8","0","0.27273","255","376","-121","Charlie Weatherbie"
"1999","Navy (MD)","5","7","0","0.41667","326","306","20","Charlie Weatherbie"
"2000","Navy (MD)","1","10","0","0.09091","182","391","-209","Charlie Weatherbie"
"2001","Navy (MD)","0","7","0","0","122","242","-120","Charlie Weatherbie"
"2001","Navy (MD)","0","3","0","0","61","102","-41","Rick Lantz"
"2002","Navy (MD)","2","10","0","0.16667","290","436","-146","Paul Johnson"
"2003","Navy (MD)","8","5","0","0.61538","396","283","113","Paul Johnson"
"2004","Navy (MD)","10","2","0","0.83333","334","238","96","Paul Johnson"
"2005","Navy (MD)","8","4","0","0.66667","410","313","97","Paul Johnson"
"2006","Navy (MD)","9","4","0","0.69231","367","261","106","Paul Johnson"
"2007","Navy (MD)","8","4","0","0.66667","479","438","41","Paul Johnson"
"2007","Navy (MD)","0","1","0","0","32","35","-3","Ken Niumatalolo"
"2008","Navy (MD)","8","5","0","0.61538","353","286","67","Ken Niumatalolo"
"2009","Navy (MD)","10","4","0","0.71429","392","272","120","Ken Niumatalolo"
"2010","Navy (MD)","9","4","0","0.69231","386","303","83","Ken Niumatalolo"
"2011","Navy (MD)","5","7","0","0.41667","356","347","9","Ken Niumatalolo"
"2012","Navy (MD)","8","5","0","0.61538","325","334","-9","Ken Niumatalolo"
"2013","Navy (MD)","9","4","0","0.69231","436","317","119","Ken Niumatalolo"
"2014","Navy (MD)","8","5","0","0.61538","414","355","59","Ken Niumatalolo"
"1898","Nevada","4","1","0","0.8","121","18","103","F.F. Ellis"
"1899","Nevada","3","2","0","0.6","85","52","33","A. King Dickson"
"1900","Nevada","4","2","1","0.64286","78","34","44","James Hopper"
"1901","Nevada","3","3","0","0.5","64","31","33","Dr. Allen C. Steckle"
"1902","Nevada","1","2","0","0.33333","21","40","-19","Dr. Allen C. Steckle"
"1903","Nevada","2","4","2","0.375","56","40","16","Dr. Allen C. Steckle"
"1904","Nevada","3","3","0","0.5","55","69","-14","Bruce C. Shorts"
"1915","Nevada","0","6","0","0","22","158","-136","Jack Glascock"
"1916","Nevada","3","5","0","0.375","142","160","-18","Jack Glascock"
"1917","Nevada","1","6","0","0.14286","57","327","-270","Jack Glascock"
"1919","Nevada","8","1","1","0.85","450","32","418","R.O. ""William"" Courtright"
"1920","Nevada","7","3","1","0.68182","186","167","19","R.O. ""William"" Courtright"
"1921","Nevada","4","3","1","0.5625","183","113","70","R.O. ""William"" Courtright"
"1922","Nevada","5","3","1","0.61111","165","120","45","R.O. ""William"" Courtright"
"1923","Nevada","2","3","3","0.4375","107","107","0","R.O. ""William"" Courtright"
"1924","Nevada","3","4","1","0.4375","101","125","-24","Charles F. Erb"
"1925","Nevada","4","3","1","0.5625","107","115","-8","Lawrence T. ""Buck"" Shaw"
"1926","Nevada","4","4","0","0.5","116","119","-3","Lawrence T. ""Buck"" Shaw"
"1927","Nevada","2","6","1","0.27778","54","209","-155","Lawrence T. ""Buck"" Shaw"
"1928","Nevada","0","7","1","0.0625","31","170","-139","Lawrence T. ""Buck"" Shaw"
"1929","Nevada","2","5","1","0.3125","63","180","-117","George Philbrook"
"1930","Nevada","2","4","2","0.375","77","73","4","George Philbrook"
"1931","Nevada","2","5","2","0.33333","76","134","-58","George Philbrook"
"1932","Nevada","3","3","2","0.5","41","99","-58","C.L. ""Brick"" Mitchell"
"1933","Nevada","4","4","0","0.5","60","144","-84","C.L. ""Brick"" Mitchell"
"1934","Nevada","1","7","1","0.16667","15","153","-138","C.L. ""Brick"" Mitchell"
"1935","Nevada","2","6","0","0.25","57","139","-82","C.L. ""Brick"" Mitchell"
"1936","Nevada","4","4","0","0.5","91","103","-12","Doug Dashiell"
"1937","Nevada","2","6","0","0.25","61","175","-114","Doug Dashiell"
"1938","Nevada","2","3","1","0.41667","65","117","-52","Doug Dashiell"
"1939","Nevada","5","4","0","0.55556","49","101","-52","James W. ""Jim"" Aiken"
"1940","Nevada","4","4","1","0.5","252","79","173","James W. ""Jim"" Aiken"
"1941","Nevada","3","5","1","0.38889","100","114","-14","James W. ""Jim"" Aiken"
"1942","Nevada","4","3","1","0.5625","81","80","1","James W. ""Jim"" Aiken"
"1943","Nevada","4","1","1","0.75","114","25","89","James W. ""Jim"" Aiken"
"1944","Nevada","4","4","0","0.5","92","93","-1","James W. ""Jim"" Aiken"
"1945","Nevada","7","3","0","0.7","240","147","93","James W. ""Jim"" Aiken"
"1946","Nevada","7","2","0","0.77778","324","82","242","James W. ""Jim"" Aiken"
"1947","Nevada","9","2","0","0.81818","321","154","167","Joseph L. ""Joe"" Sheeketski"
"1948","Nevada","9","2","0","0.81818","480","133","347","Joseph L. ""Joe"" Sheeketski"
"1949","Nevada","5","5","0","0.5","235","212","23","Joseph L. ""Joe"" Sheeketski"
"1950","Nevada","1","9","0","0.1","117","363","-246","Joseph L. ""Joe"" Sheeketski"
"1952","Nevada","2","3","0","0.4","111","126","-15","Jake Lawlor"
"1953","Nevada","2","3","0","0.4","87","116","-29","Jake Lawlor"
"1954","Nevada","2","5","0","0.28571","81","181","-100","Jake Lawlor"
"1955","Nevada","2","5","0","0.28571","70","199","-129","Gordon McEachron"
"1956","Nevada","0","7","1","0.0625","122","198","-76","Gordon McEachron"
"1957","Nevada","1","8","0","0.11111","107","229","-122","Gordon McEachron"
"1958","Nevada","3","3","0","0.5","100","97","3","Gordon McEachron"
"1959","Nevada","4","3","0","0.57143","130","91","39","Dick Trachok"
"1960","Nevada","3","6","0","0.33333","121","153","-32","Dick Trachok"
"1961","Nevada","5","4","0","0.55556","153","179","-26","Dick Trachok"
"1962","Nevada","5","3","1","0.61111","139","87","52","Dick Trachok"
"1963","Nevada","3","6","0","0.33333","134","182","-48","Dick Trachok"
"1964","Nevada","1","9","0","0.1","104","263","-159","Dick Trachok"
"1965","Nevada","6","4","0","0.6","210","162","48","Dick Trachok"
"1966","Nevada","6","3","0","0.66667","217","153","64","Dick Trachok"
"1967","Nevada","4","4","1","0.5","150","159","-9","Dick Trachok"
"1968","Nevada","3","6","1","0.35","176","183","-7","Dick Trachok"
"1969","Nevada","5","5","0","0.5","222","225","-3","Jerry Scattine"
"1970","Nevada","6","3","1","0.65","280","220","60","Jerry Scattine"
"1971","Nevada","5","5","0","0.5","181","165","16","Jerry Scattine"
"1972","Nevada","6","5","0","0.54545","276","223","53","Jerry Scattine"
"1973","Nevada","7","4","0","0.63636","295","143","152","Jerry Scattine"
"1974","Nevada","5","6","0","0.45455","209","254","-45","Jerry Scattine"
"1975","Nevada","3","8","0","0.27273","121","285","-164","Jerry Scattine"
"1976","Nevada","8","3","0","0.72727","409","243","166","Chris Ault"
"1977","Nevada","8","3","0","0.72727","421","154","267","Chris Ault"
"1978","Nevada","11","1","0","0.91667","413","121","292","Chris Ault"
"1979","Nevada","8","4","0","0.66667","325","198","127","Chris Ault"
"1980","Nevada","6","4","1","0.59091","202","113","89","Chris Ault"
"1981","Nevada","7","4","0","0.63636","310","194","116","Chris Ault"
"1982","Nevada","6","5","0","0.54545","294","228","66","Chris Ault"
"1983","Nevada","9","5","0","0.64286","402","257","145","Chris Ault"
"1984","Nevada","7","4","0","0.63636","325","298","27","Chris Ault"
"1985","Nevada","11","2","0","0.84615","483","213","270","Chris Ault"
"1986","Nevada","13","1","0","0.92857","531","231","300","Chris Ault"
"1987","Nevada","5","6","0","0.45455","314","300","14","Chris Ault"
"1988","Nevada","7","4","0","0.63636","333","242","91","Chris Ault"
"1989","Nevada","7","4","0","0.63636","349","257","92","Chris Ault"
"1990","Nevada","13","2","0","0.86667","497","321","176","Chris Ault"
"1991","Nevada","12","1","0","0.92308","546","244","302","Chris Ault"
"1992","Nevada","7","5","0","0.58333","318","283","35","Chris Ault"
"1994","Nevada","9","2","0","0.81818","414","272","142","Chris Ault"
"1995","Nevada","9","3","0","0.75","521","375","146","Chris Ault"
"2004","Nevada","5","7","0","0.41667","356","413","-57","Chris Ault"
"2005","Nevada","9","3","0","0.75","410","383","27","Chris Ault"
"2006","Nevada","8","5","0","0.61538","391","249","142","Chris Ault"
"2007","Nevada","6","7","0","0.46154","435","418","17","Chris Ault"
"2008","Nevada","7","6","0","0.53846","489","420","69","Chris Ault"
"2009","Nevada","8","5","0","0.61538","497","371","126","Chris Ault"
"2010","Nevada","13","1","0","0.92857","574","300","274","Chris Ault"
"2011","Nevada","7","6","0","0.53846","412","327","85","Chris Ault"
"2012","Nevada","7","6","0","0.53846","492","439","53","Chris Ault"
"1993","Nevada","7","4","0","0.63636","419","315","104","Jeff Horton"
"1996","Nevada","9","3","0","0.75","515","278","237","Jeff Tisdel"
"1997","Nevada","5","6","0","0.45455","353","320","33","Jeff Tisdel"
"1998","Nevada","6","5","0","0.54545","371","316","55","Jeff Tisdel"
"1999","Nevada","3","8","0","0.27273","283","418","-135","Jeff Tisdel"
"2000","Nevada","2","10","0","0.16667","207","464","-257","Chris Tormey"
"2001","Nevada","3","8","0","0.27273","286","431","-145","Chris Tormey"
"2002","Nevada","5","7","0","0.41667","331","371","-40","Chris Tormey"
"2003","Nevada","6","6","0","0.5","282","338","-56","Chris Tormey"
"2013","Nevada","4","8","0","0.33333","323","413","-90","Brian Polian"
"2014","Nevada","7","6","0","0.53846","379","354","25","Brian Polian"
"1968","Nevada-Las Vegas","8","1","0","0.88889","266","103","163","Bill Ireland"
"1969","Nevada-Las Vegas","6","4","0","0.6","271","255","16","Bill Ireland"
"1970","Nevada-Las Vegas","6","4","0","0.6","313","241","72","Bill Ireland"
"1971","Nevada-Las Vegas","5","4","1","0.55","257","171","86","Bill Ireland"
"1972","Nevada-Las Vegas","1","10","0","0.09091","149","289","-140","Bill Ireland"
"1973","Nevada-Las Vegas","8","3","0","0.72727","304","151","153","Ron Meyer"
"1974","Nevada-Las Vegas","12","1","0","0.92308","444","251","193","Ron Meyer"
"1975","Nevada-Las Vegas","7","4","0","0.63636","332","212","120","Ron Meyer"
"1976","Nevada-Las Vegas","9","3","0","0.75","359","288","71","Tony Knap"
"1977","Nevada-Las Vegas","9","2","0","0.81818","300","243","57","Tony Knap"
"1978","Nevada-Las Vegas","7","4","0","0.63636","249","182","67","Tony Knap"
"1979","Nevada-Las Vegas","9","1","2","0.83333","370","300","70","Tony Knap"
"1980","Nevada-Las Vegas","7","4","0","0.63636","384","257","127","Tony Knap"
"1981","Nevada-Las Vegas","6","6","0","0.5","326","433","-107","Tony Knap"
"1982","Nevada-Las Vegas","3","8","0","0.27273","246","332","-86","Harvey Hyde"
"1983","Nevada-Las Vegas","7","4","0","0.63636","255","192","63","Harvey Hyde"
"1984","Nevada-Las Vegas","11","2","0","0.84615","387","255","132","Harvey Hyde"
"1985","Nevada-Las Vegas","5","5","1","0.5","189","210","-21","Harvey Hyde"
"1986","Nevada-Las Vegas","6","5","0","0.54545","286","241","45","Wayne Nunnely"
"1987","Nevada-Las Vegas","5","6","0","0.45455","244","290","-46","Wayne Nunnely"
"1988","Nevada-Las Vegas","4","7","0","0.36364","176","313","-137","Wayne Nunnely"
"1989","Nevada-Las Vegas","4","7","0","0.36364","233","340","-107","Wayne Nunnely"
"1990","Nevada-Las Vegas","4","7","0","0.36364","239","324","-85","Jim Strong"
"1991","Nevada-Las Vegas","4","7","0","0.36364","220","360","-140","Jim Strong"
"1992","Nevada-Las Vegas","6","5","0","0.54545","243","311","-68","Jim Strong"
"1993","Nevada-Las Vegas","3","8","0","0.27273","259","347","-88","Jim Strong"
"1994","Nevada-Las Vegas","7","5","0","0.58333","315","329","-14","Jeff Horton"
"1995","Nevada-Las Vegas","2","9","0","0.18182","222","520","-298","Jeff Horton"
"1996","Nevada-Las Vegas","1","11","0","0.08333","276","551","-275","Jeff Horton"
"1997","Nevada-Las Vegas","3","8","0","0.27273","281","332","-51","Jeff Horton"
"1998","Nevada-Las Vegas","0","11","0","0","156","389","-233","Jeff Horton"
"1999","Nevada-Las Vegas","3","8","0","0.27273","160","324","-164","John Robinson (1)"
"2000","Nevada-Las Vegas","8","5","0","0.61538","370","275","95","John Robinson (1)"
"2001","Nevada-Las Vegas","4","7","0","0.36364","284","270","14","John Robinson (1)"
"2002","Nevada-Las Vegas","5","7","0","0.41667","292","366","-74","John Robinson (1)"
"2003","Nevada-Las Vegas","6","6","0","0.5","256","272","-16","John Robinson (1)"
"2004","Nevada-Las Vegas","2","9","0","0.18182","229","357","-128","John Robinson (1)"
"2005","Nevada-Las Vegas","2","9","0","0.18182","207","381","-174","Mike Sanford"
"2006","Nevada-Las Vegas","2","10","0","0.16667","238","382","-144","Mike Sanford"
"2007","Nevada-Las Vegas","2","10","0","0.16667","218","343","-125","Mike Sanford"
"2008","Nevada-Las Vegas","5","7","0","0.41667","307","391","-84","Mike Sanford"
"2009","Nevada-Las Vegas","5","7","0","0.41667","298","389","-91","Mike Sanford"
"2010","Nevada-Las Vegas","2","11","0","0.15385","239","516","-277","Bobby Hauck"
"2011","Nevada-Las Vegas","2","10","0","0.16667","207","485","-278","Bobby Hauck"
"2012","Nevada-Las Vegas","2","11","0","0.15385","286","424","-138","Bobby Hauck"
"2013","Nevada-Las Vegas","7","6","0","0.53846","389","414","-25","Bobby Hauck"
"2014","Nevada-Las Vegas","2","11","0","0.15385","285","500","-215","Bobby Hauck"
"1894","New Mexico","1","1","1","0.5","26","8","18","W.A. Zimmer"
"1901","New Mexico","0","3","1","0.125","7","54","-47","Joe Napier"
"1903","New Mexico","3","0","1","0.875","30","0","30","Walter McEwan"
"1904","New Mexico","1","0","0","1","11","0","11","Walter McEwan"
"1905","New Mexico","5","1","1","0.78571","90","45","45","Martin F. Angel"
"1906","New Mexico","3","1","0","0.75","59","30","29","Martin F. Angel"
"1907","New Mexico","1","0","0","1","44","0","44","Martin F. Angel"
"1908","New Mexico","5","1","0","0.83333","107","40","67","H.H. Conwell"
"1909","New Mexico","4","2","0","0.66667","117","77","40","C.L. McBirnie"
"1910","New Mexico","0","3","0","0","0","90","-90","Carl Hamilton"
"1911","New Mexico","1","3","1","0.3","62","22","40","Ralph F. Hutchinson"
"1912","New Mexico","0","4","0","0","15","76","-61","Ralph F. Hutchinson"
"1913","New Mexico","3","2","0","0.6","84","27","57","Ralph F. Hutchinson"
"1914","New Mexico","3","1","1","0.7","83","33","50","Ralph F. Hutchinson"
"1915","New Mexico","3","1","0","0.75","97","6","91","Ralph F. Hutchinson"
"1916","New Mexico","3","2","0","0.6","216","70","146","Ralph F. Hutchinson"
"1917","New Mexico","1","2","0","0.33333","47","129","-82","Frank Worth"
"1919","New Mexico","3","0","2","0.8","136","15","121","John F. McGough"
"1920","New Mexico","3","3","0","0.5","105","90","15","Roy W. Johnson"
"1921","New Mexico","2","2","0","0.5","41","31","10","Roy W. Johnson"
"1922","New Mexico","3","4","0","0.42857","58","61","-3","Roy W. Johnson"
"1923","New Mexico","3","5","0","0.375","189","98","91","Roy W. Johnson"
"1924","New Mexico","5","1","0","0.83333","103","12","91","Roy W. Johnson"
"1925","New Mexico","2","4","1","0.35714","52","77","-25","Roy W. Johnson"
"1926","New Mexico","4","2","1","0.64286","121","110","11","Roy W. Johnson"
"1927","New Mexico","8","0","1","0.94444","215","28","187","Roy W. Johnson"
"1928","New Mexico","5","2","1","0.6875","172","51","121","Roy W. Johnson"
"1929","New Mexico","2","4","2","0.375","133","100","33","Roy W. Johnson"
"1930","New Mexico","4","5","0","0.44444","148","133","15","Roy W. Johnson"
"1931","New Mexico","3","3","1","0.5","80","70","10","Charles Riley"
"1932","New Mexico","1","6","1","0.1875","24","184","-160","Charles Riley"
"1933","New Mexico","3","4","1","0.4375","92","108","-16","Charles Riley"
"1934","New Mexico","8","1","0","0.88889","251","73","178","Gwinn Henry"
"1935","New Mexico","6","4","0","0.6","145","102","43","Gwinn Henry"
"1936","New Mexico","2","7","0","0.22222","71","95","-24","Gwinn Henry"
"1937","New Mexico","4","4","1","0.5","69","93","-24","Ted E. Shipkey"
"1938","New Mexico","8","3","0","0.72727","199","72","127","Ted E. Shipkey"
"1939","New Mexico","8","2","0","0.8","167","98","69","Ted E. Shipkey"
"1940","New Mexico","5","4","0","0.55556","166","94","72","Ted E. Shipkey"
"1941","New Mexico","5","4","1","0.55","116","135","-19","Ted E. Shipkey"
"1942","New Mexico","4","5","2","0.45455","134","99","35","Willis L. Barnes"
"1943","New Mexico","3","2","0","0.6","85","59","26","Willis L. Barnes"
"1944","New Mexico","1","7","0","0.125","87","261","-174","Willis L. Barnes"
"1945","New Mexico","6","1","1","0.8125","208","61","147","Willis L. Barnes"
"1946","New Mexico","5","5","2","0.5","127","224","-97","Willis L. Barnes"
"1947","New Mexico","4","5","1","0.45","171","182","-11","Berl Huffman"
"1948","New Mexico","2","9","0","0.18182","146","216","-70","Berl Huffman"
"1949","New Mexico","2","8","0","0.2","98","307","-209","Berl Huffman"
"1950","New Mexico","2","8","0","0.2","160","337","-177","Dudley S. ""Dud"" DeGroot"
"1951","New Mexico","4","7","0","0.36364","213","262","-49","Dudley S. ""Dud"" DeGroot"
"1952","New Mexico","7","2","0","0.77778","119","46","73","Dudley S. ""Dud"" DeGroot"
"1953","New Mexico","5","3","1","0.61111","154","103","51","Robert ""Bob"" Titchenal"
"1954","New Mexico","5","5","0","0.5","152","168","-16","Robert ""Bob"" Titchenal"
"1955","New Mexico","2","8","0","0.2","61","213","-152","Robert ""Bob"" Titchenal"
"1956","New Mexico","4","6","0","0.4","167","205","-38","M.R. ""Dick"" Clausen"
"1957","New Mexico","4","6","0","0.4","140","144","-4","M.R. ""Dick"" Clausen"
"1958","New Mexico","7","3","0","0.7","210","185","25","Marvin ""Marv"" Levy"
"1959","New Mexico","7","3","0","0.7","260","135","125","Marvin ""Marv"" Levy"
"1960","New Mexico","5","5","0","0.5","234","182","52","Bill Weeks"
"1961","New Mexico","7","4","0","0.63636","215","197","18","Bill Weeks"
"1962","New Mexico","7","2","1","0.75","210","159","51","Bill Weeks"
"1963","New Mexico","6","4","0","0.6","177","143","34","Bill Weeks"
"1964","New Mexico","9","2","0","0.81818","185","90","95","Bill Weeks"
"1965","New Mexico","3","7","0","0.3","127","226","-99","Bill Weeks"
"1966","New Mexico","2","8","0","0.2","101","320","-219","Bill Weeks"
"1967","New Mexico","1","9","0","0.1","152","433","-281","Bill Weeks"
"1968","New Mexico","0","10","0","0","120","403","-283","Rudy Feldman"
"1969","New Mexico","4","6","0","0.4","171","281","-110","Rudy Feldman"
"1970","New Mexico","7","3","0","0.7","291","222","69","Rudy Feldman"
"1971","New Mexico","6","3","2","0.63636","341","292","49","Rudy Feldman"
"1972","New Mexico","3","8","0","0.27273","208","327","-119","Rudy Feldman"
"1973","New Mexico","4","7","0","0.36364","257","287","-30","Rudy Feldman"
"1974","New Mexico","4","6","1","0.40909","192","263","-71","Bill Mondt"
"1975","New Mexico","6","5","0","0.54545","291","232","59","Bill Mondt"
"1976","New Mexico","4","7","0","0.36364","229","235","-6","Bill Mondt"
"1977","New Mexico","5","7","0","0.41667","273","339","-66","Bill Mondt"
"1978","New Mexico","7","5","0","0.58333","284","205","79","Bill Mondt"
"1979","New Mexico","5","7","0","0.41667","211","229","-18","Bill Mondt"
"1980","New Mexico","4","7","0","0.36364","246","364","-118","Joe Morrison"
"1981","New Mexico","4","7","1","0.375","225","231","-6","Joe Morrison"
"1982","New Mexico","10","1","0","0.90909","374","225","149","Joe Morrison"
"1983","New Mexico","6","6","0","0.5","239","233","6","Joe Lee Dunn"
"1984","New Mexico","4","8","0","0.33333","251","359","-108","Joe Lee Dunn"
"1985","New Mexico","3","8","0","0.27273","289","415","-126","Joe Lee Dunn"
"1986","New Mexico","4","8","0","0.33333","317","338","-21","Joe Lee Dunn"
"1987","New Mexico","0","11","0","0","209","444","-235","Mike Sheppard"
"1988","New Mexico","2","10","0","0.16667","170","518","-348","Mike Sheppard"
"1989","New Mexico","2","10","0","0.16667","298","378","-80","Mike Sheppard"
"1990","New Mexico","2","10","0","0.16667","279","400","-121","Mike Sheppard"
"1991","New Mexico","3","9","0","0.25","240","473","-233","Mike Sheppard"
"1992","New Mexico","3","8","0","0.27273","247","287","-40","Dennis Franchione"
"1993","New Mexico","6","5","0","0.54545","335","256","79","Dennis Franchione"
"1994","New Mexico","5","7","0","0.41667","401","386","15","Dennis Franchione"
"1995","New Mexico","4","7","0","0.36364","256","303","-47","Dennis Franchione"
"1996","New Mexico","6","5","0","0.54545","331","280","51","Dennis Franchione"
"1997","New Mexico","9","4","0","0.69231","404","274","130","Dennis Franchione"
"1998","New Mexico","3","9","0","0.25","274","397","-123","Rocky Long"
"1999","New Mexico","4","7","0","0.36364","240","298","-58","Rocky Long"
"2000","New Mexico","5","7","0","0.41667","229","249","-20","Rocky Long"
"2001","New Mexico","6","5","0","0.54545","304","243","61","Rocky Long"
"2002","New Mexico","7","7","0","0.5","341","358","-17","Rocky Long"
"2003","New Mexico","8","5","0","0.61538","391","290","101","Rocky Long"
"2004","New Mexico","7","5","0","0.58333","244","224","20","Rocky Long"
"2005","New Mexico","6","5","0","0.54545","326","327","-1","Rocky Long"
"2006","New Mexico","6","7","0","0.46154","284","312","-28","Rocky Long"
"2007","New Mexico","9","4","0","0.69231","321","247","74","Rocky Long"
"2008","New Mexico","4","8","0","0.33333","253","273","-20","Rocky Long"
"2009","New Mexico","1","11","0","0.08333","196","431","-235","Mike Locksley"
"2010","New Mexico","1","11","0","0.08333","190","532","-342","Mike Locksley"
"2011","New Mexico","0","4","0","0","71","173","-102","Mike Locksley"
"2011","New Mexico","1","7","0","0.125","73","327","-254","George Barlow"
"2012","New Mexico","4","9","0","0.30769","335","393","-58","Bob Davie"
"2013","New Mexico","3","9","0","0.25","393","513","-120","Bob Davie"
"2014","New Mexico","4","8","0","0.33333","332","431","-99","Bob Davie"
"1893","New Mexico St.","1","1","0","0.5","16","18","-2","W.M. Clutte"
"1894","New Mexico St.","2","0","0","1","11","4","7","Alfred Holt"
"1897","New Mexico St.","1","0","1","0.75","10","0","10","Charles M. Barber"
"1898","New Mexico St.","2","1","0","0.66667","57","6","51","Charles M. Barber"
"1900","New Mexico St.","3","3","1","0.5","49","27","22","William A. Sutherland"
"1899","New Mexico St.","1","0","0","1","38","0","38","John O. Miller"
"1901","New Mexico St.","2","1","0","0.66667","38","6","32","John O. Miller"
"1902","New Mexico St.","0","1","2","0.33333","0","6","-6","John O. Miller"
"1903","New Mexico St.","2","0","1","0.83333","34","0","34","John O. Miller"
"1904","New Mexico St.","1","2","1","0.375","42","33","9","John O. Miller"
"1905","New Mexico St.","5","0","1","0.91667","128","0","128","John O. Miller"
"1906","New Mexico St.","4","0","0","1","71","12","59","John O. Miller"
"1907","New Mexico St.","3","0","0","1","88","6","82","John O. Miller"
"1908","New Mexico St.","4","2","0","0.66667","179","42","137","W.G. Hummell"
"1909","New Mexico St.","1","3","1","0.3","19","91","-72","J.H. Squires"
"1910","New Mexico St.","3","2","0","0.6","61","23","38","Arthur H. Badenoch"
"1911","New Mexico St.","7","0","0","1","192","6","186","Arthur H. Badenoch"
"1912","New Mexico St.","5","1","0","0.83333","256","24","232","Arthur H. Badenoch"
"1913","New Mexico St.","7","0","1","0.9375","124","24","100","Arthur H. Badenoch"
"1914","New Mexico St.","4","2","1","0.64286","80","29","51","Clarence W. Russell"
"1915","New Mexico St.","5","2","0","0.71429","85","19","66","Clarence W. Russell"
"1916","New Mexico St.","2","4","1","0.35714","64","153","-89","Clarence W. Russell"
"1917","New Mexico St.","4","2","0","0.66667","231","75","156","John G. ""Pinky"" Griffith"
"1919","New Mexico St.","2","3","1","0.41667","83","69","14","Anthony Savage"
"1920","New Mexico St.","5","1","1","0.78571","159","62","97","Arthur J. Bergman"
"1921","New Mexico St.","4","2","0","0.66667","126","37","89","Arthur J. Bergman"
"1922","New Mexico St.","6","2","0","0.75","210","53","157","Arthur J. Bergman"
"1923","New Mexico St.","9","0","0","1","218","17","201","Robert Roswell ""Buster"" Brown"
"1924","New Mexico St.","7","3","0","0.7","241","30","211","Robert Roswell ""Buster"" Brown"
"1925","New Mexico St.","5","3","1","0.61111","151","75","76","Robert Roswell ""Buster"" Brown"
"1926","New Mexico St.","5","3","1","0.61111","90","65","25","Authur L. Burkholder"
"1927","New Mexico St.","3","5","0","0.375","185","107","78","Ted R. Coffman"
"1928","New Mexico St.","5","5","0","0.5","261","149","112","Ted R. Coffman"
"1929","New Mexico St.","3","2","3","0.5625","132","57","75","Gerald H. Hines"
"1930","New Mexico St.","5","3","0","0.625","115","73","42","Gerald H. Hines"
"1931","New Mexico St.","6","4","0","0.6","149","90","59","Gerald H. Hines"
"1932","New Mexico St.","4","5","1","0.45","245","81","164","Gerald H. Hines"
"1933","New Mexico St.","2","6","0","0.25","100","72","28","Gerald H. Hines"
"1934","New Mexico St.","4","1","3","0.6875","169","25","144","Gerald H. Hines"
"1935","New Mexico St.","7","1","2","0.8","210","42","168","Gerald H. Hines"
"1936","New Mexico St.","6","4","1","0.59091","261","118","143","Gerald H. Hines"
"1937","New Mexico St.","7","2","0","0.77778","128","60","68","Gerald H. Hines"
"1938","New Mexico St.","7","2","0","0.77778","166","75","91","Gerald H. Hines"
"1939","New Mexico St.","3","6","0","0.33333","93","141","-48","Gerald H. Hines"
"1940","New Mexico St.","3","6","0","0.33333","95","200","-105","Julius J. Johnston"
"1941","New Mexico St.","2","7","0","0.22222","93","228","-135","Julius J. Johnston"
"1942","New Mexico St.","1","8","0","0.11111","33","223","-190","Julius J. Johnston"
"1943","New Mexico St.","4","0","0","1","107","20","87","Maurice Moulder"
"1946","New Mexico St.","5","5","0","0.5","155","154","1","Raymond A. Curfman"
"1947","New Mexico St.","3","6","0","0.33333","140","169","-29","Raymond A. Curfman"
"1948","New Mexico St.","3","7","0","0.3","138","393","-255","Vaughn D. Corley"
"1949","New Mexico St.","4","6","0","0.4","265","315","-50","Vaughn D. Corley"
"1950","New Mexico St.","2","7","0","0.22222","95","249","-154","Vaughn D. Corley"
"1951","New Mexico St.","1","9","0","0.1","115","337","-222","Joseph T. Coleman"
"1952","New Mexico St.","2","6","1","0.27778","118","255","-137","Joseph T. Coleman"
"1953","New Mexico St.","2","7","0","0.22222","56","316","-260","James Patton"
"1954","New Mexico St.","0","9","0","0","87","306","-219","James Patton"
"1955","New Mexico St.","3","7","0","0.3","141","226","-85","Anthony Cavallo"
"1956","New Mexico St.","1","9","0","0.1","131","276","-145","Anthony Cavallo"
"1957","New Mexico St.","3","7","0","0.3","157","215","-58","Anthony Cavallo"
"1958","New Mexico St.","4","6","0","0.4","172","228","-56","Warren B. Woodson"
"1959","New Mexico St.","8","3","0","0.72727","360","158","202","Warren B. Woodson"
"1960","New Mexico St.","11","0","0","1","394","113","281","Warren B. Woodson"
"1961","New Mexico St.","5","4","1","0.55","341","195","146","Warren B. Woodson"
"1962","New Mexico St.","4","6","0","0.4","191","259","-68","Warren B. Woodson"
"1963","New Mexico St.","3","6","1","0.35","158","209","-51","Warren B. Woodson"
"1964","New Mexico St.","6","4","0","0.6","131","171","-40","Warren B. Woodson"
"1965","New Mexico St.","8","2","0","0.8","236","153","83","Warren B. Woodson"
"1966","New Mexico St.","7","3","0","0.7","321","159","162","Warren B. Woodson"
"1967","New Mexico St.","7","2","1","0.75","339","145","194","Warren B. Woodson"
"1968","New Mexico St.","5","5","0","0.5","228","244","-16","Jim Wood"
"1969","New Mexico St.","5","5","0","0.5","199","235","-36","Jim Wood"
"1970","New Mexico St.","4","6","0","0.4","282","277","5","Jim Wood"
"1971","New Mexico St.","5","5","1","0.5","220","208","12","Jim Wood"
"1972","New Mexico St.","2","9","0","0.18182","193","400","-207","Jim Wood"
"1973","New Mexico St.","5","6","0","0.45455","244","289","-45","Jim Bradley"
"1974","New Mexico St.","5","6","0","0.45455","237","199","38","Jim Bradley"
"1975","New Mexico St.","5","6","0","0.45455","179","300","-121","Jim Bradley"
"1976","New Mexico St.","4","6","1","0.40909","152","241","-89","Jim Bradley"
"1977","New Mexico St.","4","7","0","0.36364","238","281","-43","Jim Bradley"
"1978","New Mexico St.","6","5","0","0.54545","274","296","-22","Gil Krueger"
"1979","New Mexico St.","2","9","0","0.18182","175","367","-192","Gil Krueger"
"1980","New Mexico St.","3","7","1","0.31818","212","247","-35","Gil Krueger"
"1981","New Mexico St.","3","8","0","0.27273","158","286","-128","Gil Krueger"
"1982","New Mexico St.","3","8","0","0.27273","216","353","-137","Gil Krueger"
"1983","New Mexico St.","5","6","0","0.45455","211","292","-81","Fred Zechman"
"1984","New Mexico St.","2","9","0","0.18182","185","336","-151","Fred Zechman"
"1985","New Mexico St.","1","10","0","0.09091","190","369","-179","Fred Zechman"
"1986","New Mexico St.","1","10","0","0.09091","189","416","-227","Mike Knoll"
"1987","New Mexico St.","2","9","0","0.18182","121","328","-207","Mike Knoll"
"1988","New Mexico St.","1","10","0","0.09091","171","377","-206","Mike Knoll"
"1989","New Mexico St.","0","11","0","0","162","428","-266","Mike Knoll"
"1990","New Mexico St.","1","10","0","0.09091","200","422","-222","Jim Hess"
"1991","New Mexico St.","2","9","0","0.18182","224","350","-126","Jim Hess"
"1992","New Mexico St.","6","5","0","0.54545","286","330","-44","Jim Hess"
"1993","New Mexico St.","5","6","0","0.45455","231","350","-119","Jim Hess"
"1994","New Mexico St.","3","8","0","0.27273","235","422","-187","Jim Hess"
"1995","New Mexico St.","4","7","0","0.36364","349","389","-40","Jim Hess"
"1996","New Mexico St.","1","10","0","0.09091","166","396","-230","Jim Hess"
"1997","New Mexico St.","2","9","0","0.18182","221","398","-177","Tony Samuel"
"1998","New Mexico St.","3","8","0","0.27273","331","424","-93","Tony Samuel"
"1999","New Mexico St.","6","5","0","0.54545","311","274","37","Tony Samuel"
"2000","New Mexico St.","3","8","0","0.27273","295","357","-62","Tony Samuel"
"2001","New Mexico St.","5","7","0","0.41667","286","400","-114","Tony Samuel"
"2002","New Mexico St.","7","5","0","0.58333","327","328","-1","Tony Samuel"
"2003","New Mexico St.","3","9","0","0.25","262","341","-79","Tony Samuel"
"2004","New Mexico St.","5","6","0","0.45455","273","355","-82","Tony Samuel"
"2005","New Mexico St.","0","12","0","0","198","465","-267","Hal Clay Mumme"
"2006","New Mexico St.","4","8","0","0.33333","374","369","5","Hal Clay Mumme"
"2007","New Mexico St.","4","9","0","0.30769","312","471","-159","Hal Clay Mumme"
"2008","New Mexico St.","3","9","0","0.25","266","409","-143","Hal Clay Mumme"
"2009","New Mexico St.","3","10","0","0.23077","149","411","-262","DeWayne Walker"
"2010","New Mexico St.","2","10","0","0.16667","188","474","-286","DeWayne Walker"
"2011","New Mexico St.","4","9","0","0.30769","319","478","-159","DeWayne Walker"
"2012","New Mexico St.","1","11","0","0.08333","224","473","-249","DeWayne Walker"
"2013","New Mexico St.","2","10","0","0.16667","251","535","-284","Doug Martin"
"2014","New Mexico St.","2","10","0","0.16667","294","469","-175","Doug Martin"
"1888","North Carolina","1","1","0","0.5","50","25","25","Hector W. Cowan"
"1891","North Carolina","0","2","0","0","10","10","0","William P. Graves"
"1894","North Carolina","6","3","0","0.66667","178","71","107","Vernon K. Irvine"
"1895","North Carolina","7","1","1","0.83333","146","17","129","Thomas Gawthrop ""Doggie"" Trenchard"
"1913","North Carolina","5","4","0","0.55556","91","76","15","Thomas Gawthrop ""Doggie"" Trenchard"
"1914","North Carolina","10","1","0","0.90909","359","52","307","Thomas Gawthrop ""Doggie"" Trenchard"
"1915","North Carolina","4","3","1","0.5625","105","98","7","Thomas Gawthrop ""Doggie"" Trenchard"
"1896","North Carolina","3","4","1","0.4375","106","100","6","Gordon Johnston"
"1897","North Carolina","7","3","0","0.7","150","53","97","William A. ""Billy"" Reynolds"
"1898","North Carolina","9","0","0","1","187","8","179","William A. ""Billy"" Reynolds"
"1899","North Carolina","7","3","1","0.68182","173","58","115","William A. ""Billy"" Reynolds"
"1900","North Carolina","4","1","3","0.6875","163","22","141","William A. ""Billy"" Reynolds"
"1901","North Carolina","7","2","0","0.77778","198","45","153","Charles O. Jenkins"
"1902","North Carolina","5","1","3","0.72222","122","34","88","Herman P. Olcott"
"1903","North Carolina","6","3","0","0.66667","137","72","65","Herman P. Olcott"
"1904","North Carolina","5","2","2","0.66667","170","34","136","Robert Roswell ""Buster"" Brown"
"1905","North Carolina","4","3","1","0.5625","82","90","-8","William J. ""Bill"" Warner"
"1906","North Carolina","1","4","2","0.28571","18","83","-65","William S. ""Willis"" Keinholz"
"1907","North Carolina","4","4","1","0.5","93","97","-4","Dr. Otis F. Lamson"
"1908","North Carolina","3","3","3","0.5","62","71","-9","Edward L. ""Eddie"" Green"
"1909","North Carolina","5","2","0","0.71429","54","18","36","Arthur E. Brides"
"1910","North Carolina","3","6","0","0.33333","70","67","3","Arthur E. Brides"
"1911","North Carolina","6","1","1","0.8125","66","31","35","Branch Bocock"
"1912","North Carolina","3","4","1","0.4375","85","168","-83","William C. Martin"
"1916","North Carolina","5","4","0","0.55556","134","93","41","Thomas J. Campbell"
"1919","North Carolina","4","3","1","0.5625","49","94","-45","Thomas J. Campbell"
"1920","North Carolina","2","6","0","0.25","16","91","-75","Myron E. Fuller"
"1921","North Carolina","5","2","2","0.66667","85","75","10","Robert A. ""Bob"" Fetzer & William M. ""Bill"" Fetzer"
"1922","North Carolina","9","1","0","0.9","200","72","128","Robert A. ""Bob"" Fetzer & William M. ""Bill"" Fetzer"
"1923","North Carolina","5","3","1","0.61111","77","85","-8","Robert A. ""Bob"" Fetzer & William M. ""Bill"" Fetzer"
"1924","North Carolina","4","5","0","0.44444","38","57","-19","Robert A. ""Bob"" Fetzer & William M. ""Bill"" Fetzer"
"1925","North Carolina","7","1","1","0.83333","123","20","103","Robert A. ""Bob"" Fetzer & William M. ""Bill"" Fetzer"
"1926","North Carolina","4","5","0","0.44444","59","74","-15","Charles C. ""Chuck"" Collins"
"1927","North Carolina","4","6","0","0.4","86","107","-21","Charles C. ""Chuck"" Collins"
"1928","North Carolina","5","3","2","0.6","186","115","71","Charles C. ""Chuck"" Collins"
"1929","North Carolina","9","1","0","0.9","346","60","286","Charles C. ""Chuck"" Collins"
"1930","North Carolina","5","3","2","0.6","153","103","50","Charles C. ""Chuck"" Collins"
"1931","North Carolina","4","3","3","0.55","114","92","22","Charles C. ""Chuck"" Collins"
"1932","North Carolina","3","5","2","0.4","84","142","-58","Charles C. ""Chuck"" Collins"
"1933","North Carolina","4","5","0","0.44444","71","90","-19","Charles C. ""Chuck"" Collins"
"1934","North Carolina","7","1","1","0.83333","125","34","91","Carl G. Snavely"
"1935","North Carolina","8","1","0","0.88889","270","44","226","Carl G. Snavely"
"1945","North Carolina","5","5","0","0.5","113","149","-36","Carl G. Snavely"
"1946","North Carolina","8","2","1","0.77273","271","129","142","Carl G. Snavely"
"1947","North Carolina","8","2","0","0.8","210","93","117","Carl G. Snavely"
"1948","North Carolina","9","1","1","0.86364","261","94","167","Carl G. Snavely"
"1949","North Carolina","7","4","0","0.63636","190","205","-15","Carl G. Snavely"
"1950","North Carolina","3","5","2","0.4","101","122","-21","Carl G. Snavely"
"1951","North Carolina","2","8","0","0.2","120","224","-104","Carl G. Snavely"
"1952","North Carolina","2","6","0","0.25","110","206","-96","Carl G. Snavely"
"1936","North Carolina","8","2","0","0.8","190","100","90","Raymond ""Bear"" Wolf"
"1937","North Carolina","7","1","1","0.83333","173","39","134","Raymond ""Bear"" Wolf"
"1938","North Carolina","6","2","1","0.72222","117","37","80","Raymond ""Bear"" Wolf"
"1939","North Carolina","8","1","1","0.85","228","52","176","Raymond ""Bear"" Wolf"
"1940","North Carolina","6","4","0","0.6","159","98","61","Raymond ""Bear"" Wolf"
"1941","North Carolina","3","7","0","0.3","130","172","-42","Raymond ""Bear"" Wolf"
"1942","North Carolina","5","2","2","0.66667","149","102","47","James M. ""Jim"" Tatum"
"1956","North Carolina","0","9","1","0.05","99","183","-84","James M. ""Jim"" Tatum"
"1957","North Carolina","6","4","0","0.6","142","129","13","James M. ""Jim"" Tatum"
"1958","North Carolina","6","4","0","0.6","195","109","86","James M. ""Jim"" Tatum"
"1943","North Carolina","6","3","0","0.66667","173","93","80","Thomas B. ""Tom"" Young"
"1944","North Carolina","1","7","1","0.16667","33","173","-140","Eugene T. ""Gene"" McEver"
"1953","North Carolina","4","6","0","0.4","173","187","-14","George T. Barclay"
"1954","North Carolina","4","5","1","0.45","140","222","-82","George T. Barclay"
"1955","North Carolina","3","7","0","0.3","117","218","-101","George T. Barclay"
"1959","North Carolina","5","5","0","0.5","198","142","56","James B. ""Jim"" Hickey"
"1960","North Carolina","3","7","0","0.3","117","161","-44","James B. ""Jim"" Hickey"
"1961","North Carolina","5","5","0","0.5","121","141","-20","James B. ""Jim"" Hickey"
"1962","North Carolina","3","7","0","0.3","112","206","-94","James B. ""Jim"" Hickey"
"1963","North Carolina","9","2","0","0.81818","197","103","94","James B. ""Jim"" Hickey"
"1964","North Carolina","5","5","0","0.5","178","135","43","James B. ""Jim"" Hickey"
"1965","North Carolina","4","6","0","0.4","146","195","-49","James B. ""Jim"" Hickey"
"1966","North Carolina","2","8","0","0.2","90","196","-106","James B. ""Jim"" Hickey"
"1967","North Carolina","2","8","0","0.2","104","182","-78","Bill Dooley"
"1968","North Carolina","3","7","0","0.3","178","272","-94","Bill Dooley"
"1969","North Carolina","5","5","0","0.5","200","164","36","Bill Dooley"
"1970","North Carolina","8","4","0","0.66667","372","227","145","Bill Dooley"
"1971","North Carolina","9","3","0","0.75","288","152","136","Bill Dooley"
"1972","North Carolina","11","1","0","0.91667","324","210","114","Bill Dooley"
"1973","North Carolina","4","7","0","0.36364","242","266","-24","Bill Dooley"
"1974","North Carolina","7","5","0","0.58333","364","279","85","Bill Dooley"
"1975","North Carolina","3","7","1","0.31818","207","272","-65","Bill Dooley"
"1976","North Carolina","9","3","0","0.75","243","220","23","Bill Dooley"
"1977","North Carolina","8","3","1","0.70833","251","102","149","Bill Dooley"
"1978","North Carolina","5","6","0","0.45455","199","218","-19","Dick Crum"
"1979","North Carolina","8","3","1","0.70833","290","167","123","Dick Crum"
"1980","North Carolina","11","1","0","0.91667","297","130","167","Dick Crum"
"1981","North Carolina","10","2","0","0.83333","375","150","225","Dick Crum"
"1982","North Carolina","8","4","0","0.66667","348","149","199","Dick Crum"
"1983","North Carolina","8","4","0","0.66667","337","216","121","Dick Crum"
"1984","North Carolina","5","5","1","0.5","234","274","-40","Dick Crum"
"1985","North Carolina","5","6","0","0.45455","224","223","1","Dick Crum"
"1986","North Carolina","7","4","1","0.625","305","279","26","Dick Crum"
"1987","North Carolina","5","6","0","0.45455","214","207","7","Dick Crum"
"1988","North Carolina","1","10","0","0.09091","217","391","-174","Mack Brown"
"1989","North Carolina","1","10","0","0.09091","138","297","-159","Mack Brown"
"1990","North Carolina","6","4","1","0.59091","227","186","41","Mack Brown"
"1991","North Carolina","7","4","0","0.63636","282","199","83","Mack Brown"
"1992","North Carolina","9","3","0","0.75","289","233","56","Mack Brown"
"1993","North Carolina","10","3","0","0.76923","431","253","178","Mack Brown"
"1994","North Carolina","8","4","0","0.66667","374","267","107","Mack Brown"
"1995","North Carolina","7","5","0","0.58333","284","220","64","Mack Brown"
"1996","North Carolina","10","2","0","0.83333","357","123","234","Mack Brown"
"1997","North Carolina","10","1","0","0.90909","306","143","163","Mack Brown"
"1997","North Carolina","1","0","0","1","42","3","39","Carl Torbush"
"1998","North Carolina","7","5","0","0.58333","288","283","5","Carl Torbush"
"1999","North Carolina","3","8","0","0.27273","186","272","-86","Carl Torbush"
"2000","North Carolina","6","5","0","0.54545","269","284","-15","Carl Torbush"
"2001","North Carolina","8","5","0","0.61538","337","271","66","John Bunting"
"2002","North Carolina","3","9","0","0.25","223","421","-198","John Bunting"
"2003","North Carolina","2","10","0","0.16667","317","459","-142","John Bunting"
"2004","North Carolina","6","6","0","0.5","319","382","-63","John Bunting"
"2005","North Carolina","5","6","0","0.45455","198","288","-90","John Bunting"
"2006","North Carolina","3","9","0","0.25","216","366","-150","John Bunting"
"2007","North Carolina","4","8","0","0.33333","254","294","-40","Butch Davis"
"2008","North Carolina","0","5","0","0","360","275","85","Butch Davis"
"2009","North Carolina","0","5","0","0","309","222","87","Butch Davis"
"2010","North Carolina","8","5","0","0.61538","329","302","27","Butch Davis"
"2011","North Carolina","7","6","0","0.53846","364","323","41","Everett Withers"
"2012","North Carolina","8","4","0","0.66667","487","308","179","Larry Fedora"
"2013","North Carolina","7","6","0","0.53846","425","318","107","Larry Fedora"
"2014","North Carolina","6","7","0","0.46154","432","507","-75","Larry Fedora"
"1892","North Carolina St.","1","0","0","1","14","6","8","Perrin Busbee"
"1896","North Carolina St.","1","0","0","1","6","0","6","Perrin Busbee"
"1897","North Carolina St.","1","2","0","0.33333","19","58","-39","Perrin Busbee"
"1893","North Carolina St.","2","0","0","1","25","6","19","Bart Gatling"
"1894","North Carolina St.","0","2","0","0","0","60","-60","Bart Gatling"
"1895","North Carolina St.","2","2","1","0.5","76","82","-6","Bart Gatling"
"1898","North Carolina St.","1","1","0","0.5","21","34","-13","W.C. Riddick"
"1899","North Carolina St.","1","2","2","0.4","29","55","-26","W.C. Riddick"
"1900","North Carolina St.","0","5","0","0","7","69","-62","Dr. John McKee"
"1901","North Carolina St.","1","2","0","0.33333","27","75","-48","Dr. John McKee"
"1902","North Carolina St.","3","4","2","0.44444","81","42","39","Arthur Devlin"
"1903","North Carolina St.","4","4","0","0.5","142","74","68","Arthur Devlin"
"1904","North Carolina St.","3","1","2","0.66667","89","11","78","William S. ""Willis"" Keinholz"
"1905","North Carolina St.","4","1","1","0.75","65","10","55","George S. Whitney"
"1906","North Carolina St.","3","1","4","0.625","100","10","90","William M. ""Willie"" Heston"
"1907","North Carolina St.","6","0","1","0.92857","81","13","68","Mickey Whitehurst"
"1908","North Carolina St.","6","1","0","0.85714","157","11","146","Mickey Whitehurst"
"1909","North Carolina St.","6","1","0","0.85714","115","24","91","Edward L. ""Eddie"" Green"
"1910","North Carolina St.","4","0","2","0.83333","125","12","113","Edward L. ""Eddie"" Green"
"1911","North Carolina St.","5","3","0","0.625","84","34","50","Edward L. ""Eddie"" Green"
"1912","North Carolina St.","4","3","0","0.57143","54","105","-51","Edward L. ""Eddie"" Green"
"1913","North Carolina St.","6","1","0","0.85714","155","27","128","Edward L. ""Eddie"" Green"
"1914","North Carolina St.","3","3","1","0.5","119","53","66","Jack Hegarty"
"1915","North Carolina St.","4","3","1","0.5625","90","121","-31","Jack Hegarty"
"1916","North Carolina St.","2","5","0","0.28571","24","191","-167","Brit Paterson"
"1917","North Carolina St.","6","2","1","0.72222","112","71","41","Harry Hartsell"
"1921","North Carolina St.","3","3","3","0.5","61","98","-37","Harry Hartsell"
"1922","North Carolina St.","4","6","0","0.4","101","92","9","Harry Hartsell"
"1923","North Carolina St.","3","7","0","0.3","56","134","-78","Harry Hartsell"
"1918","North Carolina St.","1","3","0","0.25","54","174","-120","Tal Stafford"
"1919","North Carolina St.","7","2","0","0.77778","351","75","276","William M. ""Bill"" Fetzer"
"1920","North Carolina St.","7","3","0","0.7","284","112","172","William M. ""Bill"" Fetzer"
"1924","North Carolina St.","2","6","2","0.3","43","147","-104","Lawrence T. ""Buck"" Shaw"
"1925","North Carolina St.","3","5","1","0.38889","51","74","-23","G.K. ""Gus"" Tebell"
"1926","North Carolina St.","4","6","0","0.4","66","102","-36","G.K. ""Gus"" Tebell"
"1927","North Carolina St.","9","1","0","0.9","216","69","147","G.K. ""Gus"" Tebell"
"1928","North Carolina St.","4","5","1","0.45","157","100","57","G.K. ""Gus"" Tebell"
"1929","North Carolina St.","1","8","0","0.11111","44","207","-163","G.K. ""Gus"" Tebell"
"1930","North Carolina St.","2","8","0","0.2","54","125","-71","John M. Van Liew"
"1931","North Carolina St.","3","6","0","0.33333","60","104","-44","John P. ""Clipper"" Smith"
"1932","North Carolina St.","6","1","2","0.77778","97","29","68","John P. ""Clipper"" Smith"
"1933","North Carolina St.","1","5","3","0.27778","23","62","-39","John P. ""Clipper"" Smith"
"1934","North Carolina St.","2","6","1","0.27778","44","112","-68","Heartley W. ""Hunk"" Anderson"
"1935","North Carolina St.","6","4","0","0.6","87","76","11","Heartley W. ""Hunk"" Anderson"
"1936","North Carolina St.","3","7","0","0.3","79","84","-5","Heartley W. ""Hunk"" Anderson"
"1937","North Carolina St.","5","3","1","0.61111","91","92","-1","Williams ""Doc"" Newton"
"1938","North Carolina St.","3","7","1","0.31818","59","100","-41","Williams ""Doc"" Newton"
"1939","North Carolina St.","2","8","0","0.2","49","191","-142","Williams ""Doc"" Newton"
"1940","North Carolina St.","3","6","0","0.33333","120","161","-41","Williams ""Doc"" Newton"
"1941","North Carolina St.","4","5","2","0.45455","122","143","-21","Williams ""Doc"" Newton"
"1942","North Carolina St.","4","4","2","0.5","70","142","-72","Williams ""Doc"" Newton"
"1943","North Carolina St.","3","6","0","0.33333","78","227","-149","Williams ""Doc"" Newton"
"1944","North Carolina St.","7","2","0","0.77778","173","63","110","Beattie Feathers"
"1945","North Carolina St.","3","6","0","0.33333","131","144","-13","Beattie Feathers"
"1946","North Carolina St.","8","3","0","0.72727","226","101","125","Beattie Feathers"
"1947","North Carolina St.","5","3","1","0.61111","92","57","35","Beattie Feathers"
"1948","North Carolina St.","3","6","1","0.35","107","128","-21","Beattie Feathers"
"1949","North Carolina St.","3","7","0","0.3","134","192","-58","Beattie Feathers"
"1950","North Carolina St.","5","4","1","0.55","92","119","-27","Beattie Feathers"
"1951","North Carolina St.","3","7","0","0.3","141","203","-62","Beattie Feathers"
"1952","North Carolina St.","3","7","0","0.3","91","336","-245","Horace Hendrickson"
"1953","North Carolina St.","1","9","0","0.1","80","265","-185","Horace Hendrickson"
"1954","North Carolina St.","2","8","0","0.2","104","193","-89","Earle Edwards"
"1955","North Carolina St.","4","5","1","0.45","206","193","13","Earle Edwards"
"1956","North Carolina St.","3","7","0","0.3","94","169","-75","Earle Edwards"
"1957","North Carolina St.","7","1","2","0.8","155","67","88","Earle Edwards"
"1958","North Carolina St.","2","7","1","0.25","120","160","-40","Earle Edwards"
"1959","North Carolina St.","1","9","0","0.1","117","201","-84","Earle Edwards"
"1960","North Carolina St.","6","3","1","0.65","148","113","35","Earle Edwards"
"1961","North Carolina St.","4","6","0","0.4","129","149","-20","Earle Edwards"
"1962","North Carolina St.","3","6","1","0.35","108","139","-31","Earle Edwards"
"1963","North Carolina St.","8","3","0","0.72727","188","107","81","Earle Edwards"
"1964","North Carolina St.","5","5","0","0.5","119","194","-75","Earle Edwards"
"1965","North Carolina St.","6","4","0","0.6","134","110","24","Earle Edwards"
"1966","North Carolina St.","5","5","0","0.5","191","168","23","Earle Edwards"
"1967","North Carolina St.","9","2","0","0.81818","214","94","120","Earle Edwards"
"1968","North Carolina St.","6","4","0","0.6","205","185","20","Earle Edwards"
"1969","North Carolina St.","3","6","1","0.35","183","201","-18","Earle Edwards"
"1970","North Carolina St.","3","7","1","0.31818","90","179","-89","Earle Edwards"
"1971","North Carolina St.","3","8","0","0.27273","147","274","-127","Al Michaels"
"1972","North Carolina St.","8","3","1","0.70833","409","240","169","Lou Holtz"
"1973","North Carolina St.","9","3","0","0.75","396","251","145","Lou Holtz"
"1974","North Carolina St.","9","2","1","0.79167","317","241","76","Lou Holtz"
"1975","North Carolina St.","7","4","1","0.625","260","210","50","Lou Holtz"
"1976","North Carolina St.","3","7","1","0.31818","205","258","-53","Bo Rein"
"1977","North Carolina St.","8","4","0","0.66667","259","181","78","Bo Rein"
"1978","North Carolina St.","9","3","0","0.75","280","208","72","Bo Rein"
"1979","North Carolina St.","7","4","0","0.63636","258","213","45","Bo Rein"
"1980","North Carolina St.","6","5","0","0.54545","222","212","10","Monte Kiffin"
"1981","North Carolina St.","4","7","0","0.36364","182","223","-41","Monte Kiffin"
"1982","North Carolina St.","6","5","0","0.54545","206","255","-49","Monte Kiffin"
"1983","North Carolina St.","3","8","0","0.27273","236","246","-10","Thomas ""Tom"" Reed"
"1984","North Carolina St.","3","8","0","0.27273","263","311","-48","Thomas ""Tom"" Reed"
"1985","North Carolina St.","3","8","0","0.27273","186","305","-119","Thomas ""Tom"" Reed"
"1986","North Carolina St.","8","3","1","0.70833","328","274","54","Dick Sheridan"
"1987","North Carolina St.","4","7","0","0.36364","212","302","-90","Dick Sheridan"
"1988","North Carolina St.","8","3","1","0.70833","312","165","147","Dick Sheridan"
"1989","North Carolina St.","7","5","0","0.58333","290","230","60","Dick Sheridan"
"1990","North Carolina St.","7","5","0","0.58333","298","189","109","Dick Sheridan"
"1991","North Carolina St.","9","3","0","0.75","304","222","82","Dick Sheridan"
"1992","North Carolina St.","9","3","1","0.73077","335","211","124","Dick Sheridan"
"1993","North Carolina St.","7","5","0","0.58333","278","327","-49","Mike O'Cain"
"1994","North Carolina St.","9","3","0","0.75","305","275","30","Mike O'Cain"
"1995","North Carolina St.","3","8","0","0.27273","260","354","-94","Mike O'Cain"
"1996","North Carolina St.","3","8","0","0.27273","268","401","-133","Mike O'Cain"
"1997","North Carolina St.","6","5","0","0.54545","325","268","57","Mike O'Cain"
"1998","North Carolina St.","7","5","0","0.58333","366","352","14","Mike O'Cain"
"1999","North Carolina St.","6","6","0","0.5","244","302","-58","Mike O'Cain"
"2000","North Carolina St.","8","4","0","0.66667","379","338","41","Chuck Amato"
"2001","North Carolina St.","7","5","0","0.58333","319","257","62","Chuck Amato"
"2002","North Carolina St.","11","3","0","0.78571","460","238","222","Chuck Amato"
"2003","North Carolina St.","8","5","0","0.61538","489","385","104","Chuck Amato"
"2004","North Carolina St.","5","6","0","0.45455","264","218","46","Chuck Amato"
"2005","North Carolina St.","7","5","0","0.58333","249","212","37","Chuck Amato"
"2006","North Carolina St.","3","9","0","0.25","210","262","-52","Chuck Amato"
"2007","North Carolina St.","5","7","0","0.41667","249","339","-90","Tom O'Brien"
"2008","North Carolina St.","6","7","0","0.46154","305","342","-37","Tom O'Brien"
"2009","North Carolina St.","5","7","0","0.41667","364","374","-10","Tom O'Brien"
"2010","North Carolina St.","9","4","0","0.69231","414","277","137","Tom O'Brien"
"2011","North Carolina St.","8","5","0","0.61538","367","321","46","Tom O'Brien"
"2012","North Carolina St.","7","5","0","0.58333","341","295","46","Tom O'Brien"
"2012","North Carolina St.","0","1","0","0","24","38","-14","Dana Bible"
"2013","North Carolina St.","3","9","0","0.25","274","362","-88","Dave Doeren"
"2014","North Carolina St.","8","5","0","0.61538","392","351","41","Dave Doeren"
"2013","North Carolina-Charlotte","5","6","0","0.45455","367","343","24","Brad Lambert"
"2014","North Carolina-Charlotte","5","6","0","0.45455","427","348","79","Brad Lambert"
"1980","Northern Illinois","7","4","0","0.63636","216","175","41","Bill Mallory"
"1981","Northern Illinois","3","8","0","0.27273","160","217","-57","Bill Mallory"
"1982","Northern Illinois","5","5","0","0.5","137","136","1","Bill Mallory"
"1983","Northern Illinois","10","2","0","0.83333","314","203","111","Bill Mallory"
"1984","Northern Illinois","4","6","1","0.40909","153","188","-35","Lee Corso"
"1985","Northern Illinois","4","7","0","0.36364","174","259","-85","Jerry Pettibone"
"1986","Northern Illinois","2","9","0","0.18182","144","308","-164","Jerry Pettibone"
"1987","Northern Illinois","5","5","1","0.5","305","262","43","Jerry Pettibone"
"1988","Northern Illinois","7","4","0","0.63636","155","185","-30","Jerry Pettibone"
"1989","Northern Illinois","9","2","0","0.81818","344","269","75","Jerry Pettibone"
"1990","Northern Illinois","6","5","0","0.54545","333","260","73","Jerry Pettibone"
"1991","Northern Illinois","2","9","0","0.18182","143","364","-221","Charlie Sadler"
"1992","Northern Illinois","5","6","0","0.45455","203","193","10","Charlie Sadler"
"1993","Northern Illinois","4","7","0","0.36364","227","334","-107","Charlie Sadler"
"1994","Northern Illinois","4","7","0","0.36364","301","294","7","Charlie Sadler"
"1995","Northern Illinois","3","8","0","0.27273","220","420","-200","Charlie Sadler"
"1996","Northern Illinois","1","10","0","0.09091","157","400","-243","Joe Novak"
"1997","Northern Illinois","0","11","0","0","129","382","-253","Joe Novak"
"1998","Northern Illinois","2","9","0","0.18182","160","329","-169","Joe Novak"
"1999","Northern Illinois","5","6","0","0.45455","289","289","0","Joe Novak"
"2000","Northern Illinois","6","5","0","0.54545","409","280","129","Joe Novak"
"2001","Northern Illinois","6","5","0","0.54545","303","292","11","Joe Novak"
"2002","Northern Illinois","8","4","0","0.66667","375","298","77","Joe Novak"
"2003","Northern Illinois","10","2","0","0.83333","386","258","128","Joe Novak"
"2004","Northern Illinois","9","3","0","0.75","421","304","117","Joe Novak"
"2005","Northern Illinois","7","5","0","0.58333","389","274","115","Joe Novak"
"2006","Northern Illinois","7","6","0","0.53846","331","275","56","Joe Novak"
"2007","Northern Illinois","2","10","0","0.16667","229","370","-141","Joe Novak"
"2008","Northern Illinois","6","7","0","0.46154","314","234","80","Jerry Kill"
"2009","Northern Illinois","7","6","0","0.53846","372","281","91","Jerry Kill"
"2010","Northern Illinois","10","3","0","0.76923","492","248","244","Jerry Kill"
"2010","Northern Illinois","1","0","0","1","40","17","23","Tom Matukewicz"
"2011","Northern Illinois","11","3","0","0.78571","536","424","112","Dave Doeren"
"2012","Northern Illinois","12","1","0","0.92308","530","247","283","Dave Doeren"
"2012","Northern Illinois","0","1","0","0","10","31","-21","Rod Carey"
"2013","Northern Illinois","12","2","0","0.85714","555","351","204","Rod Carey"
"2014","Northern Illinois","11","3","0","0.78571","441","359","82","Rod Carey"
"1893","Northwestern (IL)","2","5","3","0.35","92","176","-84","Paul Noyes"
"1894","Northwestern (IL)","4","5","0","0.44444","72","228","-156","A.A. Ewing"
"1895","Northwestern (IL)","6","5","0","0.54545","192","132","60","Alvin H. Culver"
"1896","Northwestern (IL)","6","1","2","0.77778","156","46","110","Alvin H. Culver"
"1897","Northwestern (IL)","5","4","1","0.55","71","59","12","Jesse Van Doozer"
"1898","Northwestern (IL)","9","4","1","0.67857","246","129","117","W.H. Bannard"
"1899","Northwestern (IL)","6","6","0","0.5","120","172","-52","Charles M. ""Doc"" Hollister"
"1900","Northwestern (IL)","7","2","3","0.70833","133","43","90","Charles M. ""Doc"" Hollister"
"1901","Northwestern (IL)","8","2","1","0.77273","156","77","79","Charles M. ""Doc"" Hollister"
"1902","Northwestern (IL)","6","6","0","0.5","83","117","-34","Charles M. ""Doc"" Hollister"
"1903","Northwestern (IL)","10","1","3","0.82143","229","67","162","Walter E. McCornack"
"1904","Northwestern (IL)","8","2","0","0.8","312","55","257","Walter E. McCornack"
"1905","Northwestern (IL)","8","2","1","0.77273","214","122","92","Walter E. McCornack"
"1908","Northwestern (IL)","2","2","0","0.5","72","90","-18","Alton Johnson"
"1909","Northwestern (IL)","1","3","1","0.3","25","95","-70","M. Frank ""Bill"" Horr"
"1910","Northwestern (IL)","1","3","1","0.3","10","45","-35","Charles E. Hammett"
"1911","Northwestern (IL)","3","4","0","0.42857","60","70","-10","Charles E. Hammett"
"1912","Northwestern (IL)","2","3","1","0.41667","32","87","-55","Charles E. Hammett"
"1913","Northwestern (IL)","1","6","0","0.14286","36","242","-206","Dennis H. Grady"
"1914","Northwestern (IL)","1","6","0","0.14286","13","176","-163","Frederick James ""Fred"" Murphy"
"1915","Northwestern (IL)","2","5","0","0.28571","69","112","-43","Frederick James ""Fred"" Murphy"
"1916","Northwestern (IL)","6","1","0","0.85714","144","55","89","Frederick James ""Fred"" Murphy"
"1917","Northwestern (IL)","5","2","0","0.71429","145","85","60","Frederick James ""Fred"" Murphy"
"1918","Northwestern (IL)","2","2","1","0.5","75","61","14","Frederick James ""Fred"" Murphy"
"1919","Northwestern (IL)","2","5","0","0.28571","49","111","-62","Charles W. Bachman"
"1920","Northwestern (IL)","3","4","0","0.42857","66","90","-24","Elmer W. McDevitt"
"1921","Northwestern (IL)","1","6","0","0.14286","34","120","-86","Elmer W. McDevitt"
"1922","Northwestern (IL)","3","3","1","0.5","119","92","27","Glenn F. Thistlethwaite"
"1923","Northwestern (IL)","2","6","0","0.25","90","112","-22","Glenn F. Thistlethwaite"
"1924","Northwestern (IL)","4","4","0","0.5","109","66","43","Glenn F. Thistlethwaite"
"1925","Northwestern (IL)","5","3","0","0.625","81","69","12","Glenn F. Thistlethwaite"
"1926","Northwestern (IL)","7","1","0","0.875","179","22","157","Glenn F. Thistlethwaite"
"1927","Northwestern (IL)","4","4","0","0.5","129","98","31","Richard E. ""Dick"" Hanley"
"1928","Northwestern (IL)","5","3","0","0.625","65","43","22","Richard E. ""Dick"" Hanley"
"1929","Northwestern (IL)","6","3","0","0.66667","172","95","77","Richard E. ""Dick"" Hanley"
"1930","Northwestern (IL)","7","1","0","0.875","182","36","146","Richard E. ""Dick"" Hanley"
"1931","Northwestern (IL)","7","1","1","0.83333","138","40","98","Richard E. ""Dick"" Hanley"
"1932","Northwestern (IL)","3","4","1","0.4375","116","76","40","Richard E. ""Dick"" Hanley"
"1933","Northwestern (IL)","1","5","2","0.25","25","42","-17","Richard E. ""Dick"" Hanley"
"1934","Northwestern (IL)","3","5","0","0.375","64","120","-56","Richard E. ""Dick"" Hanley"
"1935","Northwestern (IL)","4","3","1","0.5625","90","79","11","Lynn O. ""Pappy"" Waldorf"
"1936","Northwestern (IL)","7","1","0","0.875","132","73","59","Lynn O. ""Pappy"" Waldorf"
"1937","Northwestern (IL)","4","4","0","0.5","68","40","28","Lynn O. ""Pappy"" Waldorf"
"1938","Northwestern (IL)","4","2","2","0.625","93","32","61","Lynn O. ""Pappy"" Waldorf"
"1939","Northwestern (IL)","3","4","1","0.4375","47","67","-20","Lynn O. ""Pappy"" Waldorf"
"1940","Northwestern (IL)","6","2","0","0.75","170","64","106","Lynn O. ""Pappy"" Waldorf"
"1941","Northwestern (IL)","5","3","0","0.625","173","67","106","Lynn O. ""Pappy"" Waldorf"
"1942","Northwestern (IL)","1","9","0","0.1","96","209","-113","Lynn O. ""Pappy"" Waldorf"
"1943","Northwestern (IL)","6","2","0","0.75","189","64","125","Lynn O. ""Pappy"" Waldorf"
"1944","Northwestern (IL)","1","7","1","0.16667","102","160","-58","Lynn O. ""Pappy"" Waldorf"
"1945","Northwestern (IL)","4","4","1","0.5","127","148","-21","Lynn O. ""Pappy"" Waldorf"
"1946","Northwestern (IL)","4","4","1","0.5","156","136","20","Lynn O. ""Pappy"" Waldorf"
"1947","Northwestern (IL)","3","6","0","0.33333","129","196","-67","Robert W. ""Bob"" Voigts"
"1948","Northwestern (IL)","8","2","0","0.8","191","91","100","Robert W. ""Bob"" Voigts"
"1949","Northwestern (IL)","4","5","0","0.44444","137","156","-19","Robert W. ""Bob"" Voigts"
"1950","Northwestern (IL)","6","3","0","0.66667","155","143","12","Robert W. ""Bob"" Voigts"
"1951","Northwestern (IL)","5","4","0","0.55556","112","124","-12","Robert W. ""Bob"" Voigts"
"1952","Northwestern (IL)","2","6","1","0.27778","166","252","-86","Robert W. ""Bob"" Voigts"
"1953","Northwestern (IL)","3","6","0","0.33333","166","205","-39","Robert W. ""Bob"" Voigts"
"1954","Northwestern (IL)","2","7","0","0.22222","101","142","-41","Robert W. ""Bob"" Voigts"
"1955","Northwestern (IL)","0","8","1","0.05556","66","241","-175","Louis Henry ""Lou"" Saban"
"1956","Northwestern (IL)","4","4","1","0.5","107","112","-5","Ara R. Parseghian"
"1957","Northwestern (IL)","0","9","0","0","57","271","-214","Ara R. Parseghian"
"1958","Northwestern (IL)","5","4","0","0.55556","199","148","51","Ara R. Parseghian"
"1959","Northwestern (IL)","6","3","0","0.66667","174","134","40","Ara R. Parseghian"
"1960","Northwestern (IL)","5","4","0","0.55556","107","103","4","Ara R. Parseghian"
"1961","Northwestern (IL)","4","5","0","0.44444","131","105","26","Ara R. Parseghian"
"1962","Northwestern (IL)","7","2","0","0.77778","237","158","79","Ara R. Parseghian"
"1963","Northwestern (IL)","5","4","0","0.55556","162","124","38","Ara R. Parseghian"
"1964","Northwestern (IL)","3","6","0","0.33333","95","164","-69","Alex Agase"
"1965","Northwestern (IL)","4","6","0","0.4","141","208","-67","Alex Agase"
"1966","Northwestern (IL)","3","6","1","0.35","137","213","-76","Alex Agase"
"1967","Northwestern (IL)","3","7","0","0.3","149","213","-64","Alex Agase"
"1968","Northwestern (IL)","1","9","0","0.1","109","325","-216","Alex Agase"
"1969","Northwestern (IL)","3","7","0","0.3","137","306","-169","Alex Agase"
"1970","Northwestern (IL)","6","4","0","0.6","233","161","72","Alex Agase"
"1971","Northwestern (IL)","7","4","0","0.63636","211","183","28","Alex Agase"
"1972","Northwestern (IL)","2","9","0","0.18182","146","290","-144","Alex Agase"
"1973","Northwestern (IL)","4","7","0","0.36364","188","299","-111","John Pont"
"1974","Northwestern (IL)","3","8","0","0.27273","140","385","-245","John Pont"
"1975","Northwestern (IL)","3","8","0","0.27273","149","318","-169","John Pont"
"1976","Northwestern (IL)","1","10","0","0.09091","134","311","-177","John Pont"
"1977","Northwestern (IL)","1","10","0","0.09091","102","337","-235","John Pont"
"1978","Northwestern (IL)","0","10","1","0.04545","92","440","-348","Rick Venturi"
"1979","Northwestern (IL)","1","10","0","0.09091","115","386","-271","Rick Venturi"
"1980","Northwestern (IL)","0","11","0","0","151","444","-293","Rick Venturi"
"1981","Northwestern (IL)","0","11","0","0","82","505","-423","Dennis Green"
"1982","Northwestern (IL)","3","8","0","0.27273","206","379","-173","Dennis Green"
"1983","Northwestern (IL)","2","9","0","0.18182","101","398","-297","Dennis Green"
"1984","Northwestern (IL)","2","9","0","0.18182","138","349","-211","Dennis Green"
"1985","Northwestern (IL)","3","8","0","0.27273","170","332","-162","Dennis Green"
"1986","Northwestern (IL)","4","7","0","0.36364","217","251","-34","Francis Peay"
"1987","Northwestern (IL)","2","8","1","0.22727","186","328","-142","Francis Peay"
"1988","Northwestern (IL)","2","8","1","0.22727","192","350","-158","Francis Peay"
"1989","Northwestern (IL)","0","11","0","0","241","497","-256","Francis Peay"
"1990","Northwestern (IL)","2","9","0","0.18182","210","370","-160","Francis Peay"
"1991","Northwestern (IL)","3","8","0","0.27273","160","306","-146","Francis Peay"
"1992","Northwestern (IL)","3","8","0","0.27273","170","373","-203","Gary Barnett"
"1993","Northwestern (IL)","2","9","0","0.18182","185","335","-150","Gary Barnett"
"1994","Northwestern (IL)","4","6","1","0.40909","210","351","-141","Gary Barnett"
"1995","Northwestern (IL)","10","2","0","0.83333","311","181","130","Gary Barnett"
"1996","Northwestern (IL)","9","3","0","0.75","336","278","58","Gary Barnett"
"1997","Northwestern (IL)","5","7","0","0.41667","243","288","-45","Gary Barnett"
"1998","Northwestern (IL)","3","9","0","0.25","214","337","-123","Gary Barnett"
"1999","Northwestern (IL)","3","8","0","0.27273","141","301","-160","Randy Walker"
"2000","Northwestern (IL)","8","4","0","0.66667","441","400","41","Randy Walker"
"2001","Northwestern (IL)","4","7","0","0.36364","320","378","-58","Randy Walker"
"2002","Northwestern (IL)","3","9","0","0.25","272","493","-221","Randy Walker"
"2003","Northwestern (IL)","6","7","0","0.46154","263","326","-63","Randy Walker"
"2004","Northwestern (IL)","6","6","0","0.5","295","342","-47","Randy Walker"
"2005","Northwestern (IL)","7","5","0","0.58333","388","407","-19","Randy Walker"
"2006","Northwestern (IL)","4","8","0","0.33333","198","314","-116","Pat Fitzgerald"
"2007","Northwestern (IL)","6","6","0","0.5","310","372","-62","Pat Fitzgerald"
"2008","Northwestern (IL)","9","4","0","0.69231","317","262","55","Pat Fitzgerald"
"2009","Northwestern (IL)","8","5","0","0.61538","337","318","19","Pat Fitzgerald"
"2010","Northwestern (IL)","7","6","0","0.53846","343","377","-34","Pat Fitzgerald"
"2011","Northwestern (IL)","6","7","0","0.46154","376","360","16","Pat Fitzgerald"
"2012","Northwestern (IL)","10","3","0","0.76923","412","293","119","Pat Fitzgerald"
"2013","Northwestern (IL)","5","7","0","0.41667","314","325","-11","Pat Fitzgerald"
"2014","Northwestern (IL)","5","7","0","0.41667","276","302","-26","Pat Fitzgerald"
"1894","Notre Dame (IN)","3","1","1","0.7","80","31","49","James L. Morison"
"1895","Notre Dame (IN)","3","1","0","0.75","70","20","50","H.G. Hadden"
"1896","Notre Dame (IN)","4","3","0","0.57143","182","50","132","Frank E. Hering"
"1897","Notre Dame (IN)","4","1","1","0.75","165","40","125","Frank E. Hering"
"1898","Notre Dame (IN)","4","2","0","0.66667","155","34","121","Frank E. Hering"
"1899","Notre Dame (IN)","6","3","1","0.65","169","55","114","James McWeeney"
"1900","Notre Dame (IN)","6","3","1","0.65","261","73","188","Pat O'Dea"
"1901","Notre Dame (IN)","8","1","1","0.85","145","19","126","Pat O'Dea"
"1902","Notre Dame (IN)","6","2","1","0.72222","203","51","152","James F. Faragher"
"1903","Notre Dame (IN)","8","0","1","0.94444","291","0","291","James F. Faragher"
"1904","Notre Dame (IN)","5","3","0","0.625","94","127","-33","Louis J. ""Red"" Salmon"
"1905","Notre Dame (IN)","5","4","0","0.55556","312","80","232","Henry J. McGlew"
"1906","Notre Dame (IN)","6","1","0","0.85714","107","12","95","Thomas A. ""Tom"" Barry"
"1907","Notre Dame (IN)","6","0","1","0.92857","137","20","117","Thomas A. ""Tom"" Barry"
"1908","Notre Dame (IN)","8","1","0","0.88889","326","20","306","Victor M. Place"
"1909","Notre Dame (IN)","7","0","1","0.9375","236","14","222","Frank C. ""Shorty"" Longman"
"1910","Notre Dame (IN)","4","1","1","0.75","192","25","167","Frank C. ""Shorty"" Longman"
"1911","Notre Dame (IN)","6","0","2","0.875","222","9","213","John L. ""Jack"" Marks"
"1912","Notre Dame (IN)","7","0","0","1","389","27","362","John L. ""Jack"" Marks"
"1913","Notre Dame (IN)","7","0","0","1","268","41","227","Jesse C. Harper"
"1914","Notre Dame (IN)","6","2","0","0.75","288","61","227","Jesse C. Harper"
"1915","Notre Dame (IN)","7","1","0","0.875","230","29","201","Jesse C. Harper"
"1916","Notre Dame (IN)","8","1","0","0.88889","292","30","262","Jesse C. Harper"
"1917","Notre Dame (IN)","6","1","1","0.8125","145","9","136","Jesse C. Harper"
"1918","Notre Dame (IN)","3","1","2","0.66667","133","39","94","Knute Kenneth Rockne"
"1919","Notre Dame (IN)","9","0","0","1","229","47","182","Knute Kenneth Rockne"
"1920","Notre Dame (IN)","9","0","0","1","251","44","207","Knute Kenneth Rockne"
"1921","Notre Dame (IN)","10","1","0","0.90909","375","41","334","Knute Kenneth Rockne"
"1922","Notre Dame (IN)","8","1","1","0.85","222","27","195","Knute Kenneth Rockne"
"1923","Notre Dame (IN)","9","1","0","0.9","275","37","238","Knute Kenneth Rockne"
"1924","Notre Dame (IN)","10","0","0","1","285","54","231","Knute Kenneth Rockne"
"1925","Notre Dame (IN)","7","2","1","0.75","200","64","136","Knute Kenneth Rockne"
"1926","Notre Dame (IN)","9","1","0","0.9","210","38","172","Knute Kenneth Rockne"
"1927","Notre Dame (IN)","7","1","1","0.83333","158","57","101","Knute Kenneth Rockne"
"1928","Notre Dame (IN)","5","4","0","0.55556","99","107","-8","Knute Kenneth Rockne"
"1929","Notre Dame (IN)","9","0","0","1","145","38","107","Knute Kenneth Rockne"
"1930","Notre Dame (IN)","10","0","0","1","265","74","191","Knute Kenneth Rockne"
"1931","Notre Dame (IN)","6","2","1","0.72222","215","40","175","Heartley W. ""Hunk"" Anderson"
"1932","Notre Dame (IN)","7","2","0","0.77778","255","31","224","Heartley W. ""Hunk"" Anderson"
"1933","Notre Dame (IN)","3","5","1","0.38889","32","80","-48","Heartley W. ""Hunk"" Anderson"
"1934","Notre Dame (IN)","6","3","0","0.66667","108","56","52","Elmer F. Layden"
"1935","Notre Dame (IN)","7","1","1","0.83333","143","62","81","Elmer F. Layden"
"1936","Notre Dame (IN)","6","2","1","0.72222","128","69","59","Elmer F. Layden"
"1937","Notre Dame (IN)","6","2","1","0.72222","77","49","28","Elmer F. Layden"
"1938","Notre Dame (IN)","8","1","0","0.88889","149","39","110","Elmer F. Layden"
"1939","Notre Dame (IN)","7","2","0","0.77778","100","73","27","Elmer F. Layden"
"1940","Notre Dame (IN)","7","2","0","0.77778","168","67","101","Elmer F. Layden"
"1941","Notre Dame (IN)","8","0","1","0.94444","189","64","125","Frank W. Leahy"
"1942","Notre Dame (IN)","7","2","2","0.72727","184","99","85","Frank W. Leahy"
"1943","Notre Dame (IN)","9","1","0","0.9","340","69","271","Frank W. Leahy"
"1946","Notre Dame (IN)","8","0","1","0.94444","271","24","247","Frank W. Leahy"
"1947","Notre Dame (IN)","9","0","0","1","291","52","239","Frank W. Leahy"
"1948","Notre Dame (IN)","9","0","1","0.95","320","93","227","Frank W. Leahy"
"1949","Notre Dame (IN)","10","0","0","1","360","86","274","Frank W. Leahy"
"1950","Notre Dame (IN)","4","4","1","0.5","139","140","-1","Frank W. Leahy"
"1951","Notre Dame (IN)","7","2","1","0.75","241","122","119","Frank W. Leahy"
"1952","Notre Dame (IN)","7","2","1","0.75","183","108","75","Frank W. Leahy"
"1953","Notre Dame (IN)","9","0","1","0.95","317","139","178","Frank W. Leahy"
"1944","Notre Dame (IN)","8","2","0","0.8","272","118","154","Edward C. ""Ed"" McKeever"
"1945","Notre Dame (IN)","7","2","1","0.75","255","122","133","Hugh J. Devore"
"1963","Notre Dame (IN)","2","7","0","0.22222","108","159","-51","Hugh J. Devore"
"1954","Notre Dame (IN)","9","1","0","0.9","261","115","146","Terence P. ""Terry"" Brennan"
"1955","Notre Dame (IN)","8","2","0","0.8","210","112","98","Terence P. ""Terry"" Brennan"
"1956","Notre Dame (IN)","2","8","0","0.2","130","289","-159","Terence P. ""Terry"" Brennan"
"1957","Notre Dame (IN)","7","3","0","0.7","200","136","64","Terence P. ""Terry"" Brennan"
"1958","Notre Dame (IN)","6","4","0","0.6","206","173","33","Terence P. ""Terry"" Brennan"
"1959","Notre Dame (IN)","5","5","0","0.5","171","180","-9","Joseph L. ""Joe"" Kuharich"
"1960","Notre Dame (IN)","2","8","0","0.2","111","188","-77","Joseph L. ""Joe"" Kuharich"
"1961","Notre Dame (IN)","5","5","0","0.5","175","182","-7","Joseph L. ""Joe"" Kuharich"
"1962","Notre Dame (IN)","5","5","0","0.5","159","192","-33","Joseph L. ""Joe"" Kuharich"
"1964","Notre Dame (IN)","9","1","0","0.9","287","77","210","Ara R. Parseghian"
"1965","Notre Dame (IN)","7","2","1","0.75","270","73","197","Ara R. Parseghian"
"1966","Notre Dame (IN)","9","0","1","0.95","362","38","324","Ara R. Parseghian"
"1967","Notre Dame (IN)","8","2","0","0.8","337","124","213","Ara R. Parseghian"
"1968","Notre Dame (IN)","7","2","1","0.75","376","170","206","Ara R. Parseghian"
"1969","Notre Dame (IN)","8","2","1","0.77273","351","134","217","Ara R. Parseghian"
"1970","Notre Dame (IN)","10","1","0","0.90909","354","108","246","Ara R. Parseghian"
"1971","Notre Dame (IN)","8","2","0","0.8","225","86","139","Ara R. Parseghian"
"1972","Notre Dame (IN)","8","3","0","0.72727","289","192","97","Ara R. Parseghian"
"1973","Notre Dame (IN)","11","0","0","1","382","89","293","Ara R. Parseghian"
"1974","Notre Dame (IN)","10","2","0","0.83333","318","147","171","Ara R. Parseghian"
"1975","Notre Dame (IN)","8","3","0","0.72727","244","144","100","Dan Devine"
"1976","Notre Dame (IN)","9","3","0","0.75","294","158","136","Dan Devine"
"1977","Notre Dame (IN)","11","1","0","0.91667","420","139","281","Dan Devine"
"1978","Notre Dame (IN)","9","3","0","0.75","293","197","96","Dan Devine"
"1979","Notre Dame (IN)","7","4","0","0.63636","243","197","46","Dan Devine"
"1980","Notre Dame (IN)","9","2","1","0.79167","248","128","120","Dan Devine"
"1981","Notre Dame (IN)","5","6","0","0.45455","232","160","72","Gerry Faust"
"1982","Notre Dame (IN)","6","4","1","0.59091","206","174","32","Gerry Faust"
"1983","Notre Dame (IN)","7","5","0","0.58333","316","177","139","Gerry Faust"
"1984","Notre Dame (IN)","7","5","0","0.58333","299","239","60","Gerry Faust"
"1985","Notre Dame (IN)","5","6","0","0.45455","230","234","-4","Gerry Faust"
"1986","Notre Dame (IN)","5","6","0","0.45455","299","219","80","Lou Holtz"
"1987","Notre Dame (IN)","8","4","0","0.66667","339","218","121","Lou Holtz"
"1988","Notre Dame (IN)","12","0","0","1","393","156","237","Lou Holtz"
"1989","Notre Dame (IN)","12","1","0","0.92308","427","189","238","Lou Holtz"
"1990","Notre Dame (IN)","9","3","0","0.75","359","259","100","Lou Holtz"
"1991","Notre Dame (IN)","10","3","0","0.76923","465","289","176","Lou Holtz"
"1992","Notre Dame (IN)","10","1","1","0.875","437","181","256","Lou Holtz"
"1993","Notre Dame (IN)","11","1","0","0.91667","427","215","212","Lou Holtz"
"1994","Notre Dame (IN)","6","5","1","0.54167","342","280","62","Lou Holtz"
"1995","Notre Dame (IN)","9","3","0","0.75","392","247","145","Lou Holtz"
"1996","Notre Dame (IN)","8","3","0","0.72727","407","181","226","Lou Holtz"
"1997","Notre Dame (IN)","7","6","0","0.53846","282","265","17","Bob Davie"
"1998","Notre Dame (IN)","9","3","0","0.75","328","248","80","Bob Davie"
"1999","Notre Dame (IN)","5","7","0","0.41667","348","331","17","Bob Davie"
"2000","Notre Dame (IN)","9","3","0","0.75","353","267","86","Bob Davie"
"2001","Notre Dame (IN)","5","6","0","0.45455","214","215","-1","Bob Davie"
"2002","Notre Dame (IN)","10","3","0","0.76923","290","217","73","Tyrone ""Ty"" Willingham"
"2003","Notre Dame (IN)","5","7","0","0.41667","243","315","-72","Tyrone ""Ty"" Willingham"
"2004","Notre Dame (IN)","6","5","0","0.54545","268","251","17","Tyrone ""Ty"" Willingham"
"2004","Notre Dame (IN)","0","1","0","0","21","38","-17","Kent Baer"
"2005","Notre Dame (IN)","9","3","0","0.75","440","294","146","Charlie Weis"
"2006","Notre Dame (IN)","10","3","0","0.76923","403","310","93","Charlie Weis"
"2007","Notre Dame (IN)","3","9","0","0.25","197","345","-148","Charlie Weis"
"2008","Notre Dame (IN)","7","6","0","0.53846","321","288","33","Charlie Weis"
"2009","Notre Dame (IN)","6","6","0","0.5","361","311","50","Charlie Weis"
"2010","Notre Dame (IN)","8","5","0","0.61538","342","263","79","Brian Kelly"
"2011","Notre Dame (IN)","8","5","0","0.61538","380","269","111","Brian Kelly"
"2012","Notre Dame (IN)","12","1","0","0.92308","335","166","169","Brian Kelly"
"2013","Notre Dame (IN)","9","4","0","0.69231","354","291","63","Brian Kelly"
"2014","Notre Dame (IN)","8","5","0","0.61538","427","379","48","Brian Kelly"
"1895","Ohio","2","3","0","0.4","78","128","-50","Harvey Deme"
"1896","Ohio","4","3","1","0.5625","86","122","-36","Frank Remsburg"
"1897","Ohio","6","2","0","0.75","114","20","94","Warwick Ford"
"1897","Ohio","1","0","0","1","36","6","30","Peter McLaren"
"1898","Ohio","1","3","0","0.25","11","45","-34","Peter McLaren"
"1899","Ohio","2","2","0","0.5","78","77","1","Fred Sullivan"
"1903","Ohio","2","5","0","0.28571","45","159","-114","Fred Sullivan"
"1900","Ohio","2","4","1","0.35714","39","85","-46","Karl Core"
"1901","Ohio","6","3","2","0.63636","108","88","20","Art C. Jones"
"1902","Ohio","0","6","1","0.07143","0","165","-165","Harold Monosmith"
"1904","Ohio","2","4","1","0.35714","57","83","-26","Henry Hart"
"1905","Ohio","2","5","2","0.33333","48","141","-93","Joseph Railsback"
"1906","Ohio","7","1","0","0.875","158","28","130","Arthur McFarland"
"1907","Ohio","3","4","1","0.4375","76","139","-63","Arthur McFarland"
"1908","Ohio","3","5","0","0.375","100","65","35","Arthur McFarland"
"1909","Ohio","2","4","2","0.375","26","106","-80","Robert Woods"
"1910","Ohio","0","6","1","0.07143","0","125","-125","Robert Woods"
"1911","Ohio","3","3","2","0.5","88","44","44","Arthur Hinaman"
"1912","Ohio","1","7","1","0.16667","48","168","-120","Arthur Hinaman"
"1913","Ohio","2","5","1","0.3125","55","159","-104","Mark B. Banks"
"1914","Ohio","4","4","0","0.5","119","99","20","Mark B. Banks"
"1915","Ohio","7","2","0","0.77778","168","49","119","Mark B. Banks"
"1916","Ohio","5","2","1","0.6875","154","109","45","Mark B. Banks"
"1917","Ohio","3","5","0","0.375","85","114","-29","Mark B. Banks"
"1918","Ohio","4","0","1","0.9","140","19","121","Frank Gullum"
"1919","Ohio","3","5","0","0.375","147","101","46","Frank Gullum"
"1920","Ohio","4","3","0","0.57143","155","44","111","Russ Finsterwald"
"1921","Ohio","4","4","1","0.5","112","99","13","Russ Finsterwald"
"1922","Ohio","5","3","0","0.625","100","48","52","Russ Finsterwald"
"1923","Ohio","3","5","1","0.38889","64","88","-24","F.B. Heldt"
"1924","Ohio","4","4","0","0.5","64","59","5","Don Peden"
"1925","Ohio","6","2","0","0.75","96","40","56","Don Peden"
"1926","Ohio","5","2","1","0.6875","111","17","94","Don Peden"
"1927","Ohio","4","2","2","0.625","85","69","16","Don Peden"
"1928","Ohio","6","3","0","0.66667","254","66","188","Don Peden"
"1929","Ohio","9","0","0","1","305","7","298","Don Peden"
"1930","Ohio","8","0","1","0.94444","266","26","240","Don Peden"
"1931","Ohio","7","1","0","0.875","172","14","158","Don Peden"
"1932","Ohio","7","2","0","0.77778","172","29","143","Don Peden"
"1933","Ohio","6","2","1","0.72222","277","28","249","Don Peden"
"1934","Ohio","4","4","1","0.5","116","67","49","Don Peden"
"1935","Ohio","8","0","0","1","170","36","134","Don Peden"
"1936","Ohio","5","2","1","0.6875","67","76","-9","Don Peden"
"1937","Ohio","5","3","1","0.61111","168","52","116","Don Peden"
"1938","Ohio","7","2","0","0.77778","161","89","72","Don Peden"
"1939","Ohio","6","3","0","0.66667","116","82","34","Don Peden"
"1940","Ohio","5","2","2","0.66667","89","32","57","Don Peden"
"1941","Ohio","5","2","1","0.6875","108","42","66","Don Peden"
"1942","Ohio","5","3","0","0.625","144","107","37","Don Peden"
"1945","Ohio","3","4","0","0.42857","100","106","-6","Don Peden"
"1946","Ohio","6","3","0","0.66667","206","97","109","Don Peden"
"1947","Ohio","3","5","1","0.38889","80","116","-36","Harold Wise"
"1948","Ohio","3","6","0","0.33333","98","179","-81","Harold Wise"
"1949","Ohio","4","4","1","0.5","114","120","-6","Carroll C. Widdoes"
"1950","Ohio","6","4","0","0.6","165","161","4","Carroll C. Widdoes"
"1951","Ohio","5","4","1","0.55","167","141","26","Carroll C. Widdoes"
"1952","Ohio","6","2","1","0.72222","180","160","20","Carroll C. Widdoes"
"1953","Ohio","6","2","1","0.72222","245","86","159","Carroll C. Widdoes"
"1954","Ohio","6","3","0","0.66667","175","158","17","Carroll C. Widdoes"
"1955","Ohio","5","4","0","0.55556","160","134","26","Carroll C. Widdoes"
"1956","Ohio","2","7","0","0.22222","136","211","-75","Carroll C. Widdoes"
"1957","Ohio","2","6","1","0.27778","134","156","-22","Carroll C. Widdoes"
"1958","Ohio","5","4","0","0.55556","159","102","57","Bill Hess"
"1959","Ohio","7","2","0","0.77778","215","101","114","Bill Hess"
"1960","Ohio","10","0","0","1","269","34","235","Bill Hess"
"1961","Ohio","5","3","1","0.61111","129","116","13","Bill Hess"
"1962","Ohio","8","3","0","0.72727","261","112","149","Bill Hess"
"1963","Ohio","6","4","0","0.6","135","103","32","Bill Hess"
"1964","Ohio","5","4","1","0.55","122","99","23","Bill Hess"
"1965","Ohio","0","10","0","0","77","210","-133","Bill Hess"
"1966","Ohio","5","5","0","0.5","149","183","-34","Bill Hess"
"1967","Ohio","6","4","0","0.6","223","173","50","Bill Hess"
"1968","Ohio","10","1","0","0.90909","418","228","190","Bill Hess"
"1969","Ohio","5","4","1","0.55","256","222","34","Bill Hess"
"1970","Ohio","4","5","0","0.44444","178","261","-83","Bill Hess"
"1971","Ohio","5","5","0","0.5","240","173","67","Bill Hess"
"1972","Ohio","3","8","0","0.27273","185","321","-136","Bill Hess"
"1973","Ohio","5","5","0","0.5","156","231","-75","Bill Hess"
"1974","Ohio","6","5","0","0.54545","249","211","38","Bill Hess"
"1975","Ohio","5","5","1","0.5","164","143","21","Bill Hess"
"1976","Ohio","7","4","0","0.63636","253","175","78","Bill Hess"
"1977","Ohio","1","10","0","0.09091","241","361","-120","Bill Hess"
"1978","Ohio","3","8","0","0.27273","120","246","-126","Bob Kappes"
"1979","Ohio","6","5","0","0.54545","238","174","64","Brian Burke"
"1980","Ohio","6","5","0","0.54545","222","196","26","Brian Burke"
"1981","Ohio","5","6","0","0.45455","228","257","-29","Brian Burke"
"1982","Ohio","6","5","0","0.54545","160","259","-99","Brian Burke"
"1983","Ohio","4","7","0","0.36364","163","270","-107","Brian Burke"
"1984","Ohio","4","6","1","0.40909","134","264","-130","Brian Burke"
"1985","Ohio","2","9","0","0.18182","181","305","-124","Cleve Bryant"
"1986","Ohio","1","10","0","0.09091","196","329","-133","Cleve Bryant"
"1987","Ohio","1","10","0","0.09091","127","271","-144","Cleve Bryant"
"1988","Ohio","4","6","1","0.40909","195","288","-93","Cleve Bryant"
"1989","Ohio","1","9","1","0.13636","191","348","-157","Cleve Bryant"
"1990","Ohio","1","9","1","0.13636","162","342","-180","Tom Lichtenberg"
"1991","Ohio","2","8","1","0.22727","176","308","-132","Tom Lichtenberg"
"1992","Ohio","1","10","0","0.09091","145","253","-108","Tom Lichtenberg"
"1993","Ohio","4","7","0","0.36364","134","282","-148","Tom Lichtenberg"
"1994","Ohio","0","11","0","0","82","259","-177","Tom Lichtenberg"
"1995","Ohio","2","8","1","0.22727","161","320","-159","Jim Grobe"
"1996","Ohio","6","6","0","0.5","302","237","65","Jim Grobe"
"1997","Ohio","8","3","0","0.72727","301","177","124","Jim Grobe"
"1998","Ohio","5","6","0","0.45455","269","303","-34","Jim Grobe"
"1999","Ohio","5","6","0","0.45455","271","287","-16","Jim Grobe"
"2000","Ohio","7","4","0","0.63636","343","208","135","Jim Grobe"
"2001","Ohio","1","10","0","0.09091","198","323","-125","Brian Knorr"
"2002","Ohio","4","8","0","0.33333","299","374","-75","Brian Knorr"
"2003","Ohio","2","10","0","0.16667","263","372","-109","Brian Knorr"
"2004","Ohio","4","7","0","0.36364","221","271","-50","Brian Knorr"
"2005","Ohio","4","7","0","0.36364","192","336","-144","Frank Solich"
"2006","Ohio","9","5","0","0.64286","276","253","23","Frank Solich"
"2007","Ohio","6","6","0","0.5","366","359","7","Frank Solich"
"2008","Ohio","4","8","0","0.33333","289","327","-38","Frank Solich"
"2009","Ohio","9","5","0","0.64286","347","298","49","Frank Solich"
"2010","Ohio","8","5","0","0.61538","357","309","48","Frank Solich"
"2011","Ohio","10","4","0","0.71429","427","310","117","Frank Solich"
"2012","Ohio","9","4","0","0.69231","412","322","90","Frank Solich"
"2013","Ohio","7","6","0","0.53846","356","357","-1","Frank Solich"
"2014","Ohio","6","6","0","0.5","246","298","-52","Frank Solich"
"1889","Ohio St.","1","0","0","1","20","14","6","Alexander S. Lilley"
"1890","Ohio St.","0","3","0","0","10","96","-86","Alexander S. Lilley"
"1891","Ohio St.","2","2","0","0.5","18","80","-62","Alexander S. Lilley"
"1892","Ohio St.","5","3","0","0.625","260","144","116","Jack Ryder"
"1893","Ohio St.","4","5","0","0.44444","196","178","18","Jack Ryder"
"1894","Ohio St.","6","5","0","0.54545","168","114","54","Jack Ryder"
"1895","Ohio St.","4","4","2","0.5","56","102","-46","Jack Ryder"
"1898","Ohio St.","3","5","1","0.38889","80","122","-42","Jack Ryder"
"1896","Ohio St.","5","5","1","0.5","122","104","18","Charles A. Hickey"
"1897","Ohio St.","1","7","1","0.16667","18","168","-150","David F. Edwards"
"1899","Ohio St.","9","0","1","0.95","184","5","179","Dr. John B.C. Eckstorm"
"1900","Ohio St.","8","1","1","0.85","213","26","187","Dr. John B.C. Eckstorm"
"1901","Ohio St.","5","3","1","0.61111","94","56","38","Dr. John B.C. Eckstorm"
"1902","Ohio St.","6","2","2","0.7","172","136","36","Perry Hale"
"1903","Ohio St.","8","3","0","0.72727","265","87","178","Perry Hale"
"1904","Ohio St.","6","5","0","0.54545","219","123","96","Edwin R. Sweetland"
"1905","Ohio St.","8","2","2","0.75","197","63","134","Edwin R. Sweetland"
"1906","Ohio St.","8","1","0","0.88889","153","14","139","Albert E. Herrnstein"
"1907","Ohio St.","7","2","1","0.75","160","49","111","Albert E. Herrnstein"
"1908","Ohio St.","6","4","0","0.6","118","92","26","Albert E. Herrnstein"
"1909","Ohio St.","7","3","0","0.7","219","76","143","Albert E. Herrnstein"
"1910","Ohio St.","6","1","3","0.75","182","27","155","Howard H. Jones"
"1911","Ohio St.","5","3","2","0.6","47","40","7","Harry Vaughan"
"1912","Ohio St.","6","3","0","0.66667","244","122","122","John R. Richards"
"1913","Ohio St.","4","2","1","0.64286","154","27","127","John W. Wilce"
"1914","Ohio St.","5","2","0","0.71429","108","55","53","John W. Wilce"
"1915","Ohio St.","5","1","1","0.78571","105","39","66","John W. Wilce"
"1916","Ohio St.","7","0","0","1","258","29","229","John W. Wilce"
"1917","Ohio St.","8","0","1","0.94444","292","6","286","John W. Wilce"
"1918","Ohio St.","3","3","0","0.5","134","41","93","John W. Wilce"
"1919","Ohio St.","6","1","0","0.85714","176","12","164","John W. Wilce"
"1920","Ohio St.","7","1","0","0.875","150","48","102","John W. Wilce"
"1921","Ohio St.","5","2","0","0.71429","110","14","96","John W. Wilce"
"1922","Ohio St.","3","4","0","0.42857","43","57","-14","John W. Wilce"
"1923","Ohio St.","3","4","1","0.4375","124","99","25","John W. Wilce"
"1924","Ohio St.","2","3","3","0.4375","40","45","-5","John W. Wilce"
"1925","Ohio St.","4","3","1","0.5625","55","45","10","John W. Wilce"
"1926","Ohio St.","7","1","0","0.875","196","43","153","John W. Wilce"
"1927","Ohio St.","4","4","0","0.5","131","92","39","John W. Wilce"
"1928","Ohio St.","5","2","1","0.6875","135","35","100","John W. Wilce"
"1929","Ohio St.","4","3","1","0.5625","95","69","26","Sam S. Willaman"
"1930","Ohio St.","5","2","1","0.6875","139","48","91","Sam S. Willaman"
"1931","Ohio St.","6","3","0","0.66667","194","74","120","Sam S. Willaman"
"1932","Ohio St.","4","1","3","0.6875","90","41","49","Sam S. Willaman"
"1933","Ohio St.","7","1","0","0.875","161","26","135","Sam S. Willaman"
"1934","Ohio St.","7","1","0","0.875","267","34","233","Francis A. Schmidt"
"1935","Ohio St.","7","1","0","0.875","237","57","180","Francis A. Schmidt"
"1936","Ohio St.","5","3","0","0.625","160","27","133","Francis A. Schmidt"
"1937","Ohio St.","6","2","0","0.75","125","23","102","Francis A. Schmidt"
"1938","Ohio St.","4","3","1","0.5625","119","65","54","Francis A. Schmidt"
"1939","Ohio St.","6","2","0","0.75","189","64","125","Francis A. Schmidt"
"1940","Ohio St.","4","4","0","0.5","99","113","-14","Francis A. Schmidt"
"1941","Ohio St.","6","1","1","0.8125","167","110","57","Paul E. Brown"
"1942","Ohio St.","9","1","0","0.9","337","114","223","Paul E. Brown"
"1943","Ohio St.","3","6","0","0.33333","149","187","-38","Paul E. Brown"
"1944","Ohio St.","9","0","0","1","287","79","208","Carroll C. Widdoes"
"1945","Ohio St.","7","2","0","0.77778","194","71","123","Carroll C. Widdoes"
"1946","Ohio St.","4","3","2","0.55556","166","170","-4","Paul O. Bixler"
"1947","Ohio St.","2","6","1","0.27778","60","150","-90","Wesley E. ""Wes"" Fesler"
"1948","Ohio St.","6","3","0","0.66667","184","94","90","Wesley E. ""Wes"" Fesler"
"1949","Ohio St.","7","1","2","0.8","207","136","71","Wesley E. ""Wes"" Fesler"
"1950","Ohio St.","6","3","0","0.66667","286","111","175","Wesley E. ""Wes"" Fesler"
"1951","Ohio St.","4","3","2","0.55556","109","104","5","Wayne ""Woody"" Hayes"
"1952","Ohio St.","6","3","0","0.66667","197","119","78","Wayne ""Woody"" Hayes"
"1953","Ohio St.","6","3","0","0.66667","182","164","18","Wayne ""Woody"" Hayes"
"1954","Ohio St.","10","0","0","1","249","75","174","Wayne ""Woody"" Hayes"
"1955","Ohio St.","7","2","0","0.77778","201","97","104","Wayne ""Woody"" Hayes"
"1956","Ohio St.","6","3","0","0.66667","160","81","79","Wayne ""Woody"" Hayes"
"1957","Ohio St.","9","1","0","0.9","267","92","175","Wayne ""Woody"" Hayes"
"1958","Ohio St.","6","1","2","0.77778","182","132","50","Wayne ""Woody"" Hayes"
"1959","Ohio St.","3","5","1","0.38889","83","114","-31","Wayne ""Woody"" Hayes"
"1960","Ohio St.","7","2","0","0.77778","209","90","119","Wayne ""Woody"" Hayes"
"1961","Ohio St.","8","0","1","0.94444","221","83","138","Wayne ""Woody"" Hayes"
"1962","Ohio St.","6","3","0","0.66667","205","98","107","Wayne ""Woody"" Hayes"
"1963","Ohio St.","5","3","1","0.61111","110","102","8","Wayne ""Woody"" Hayes"
"1964","Ohio St.","7","2","0","0.77778","146","76","70","Wayne ""Woody"" Hayes"
"1965","Ohio St.","7","2","0","0.77778","156","118","38","Wayne ""Woody"" Hayes"
"1966","Ohio St.","4","5","0","0.44444","108","123","-15","Wayne ""Woody"" Hayes"
"1967","Ohio St.","6","3","0","0.66667","145","120","25","Wayne ""Woody"" Hayes"
"1968","Ohio St.","10","0","0","1","323","150","173","Wayne ""Woody"" Hayes"
"1969","Ohio St.","8","1","0","0.88889","383","93","290","Wayne ""Woody"" Hayes"
"1970","Ohio St.","9","1","0","0.9","290","120","170","Wayne ""Woody"" Hayes"
"1971","Ohio St.","6","4","0","0.6","224","120","104","Wayne ""Woody"" Hayes"
"1972","Ohio St.","9","2","0","0.81818","280","171","109","Wayne ""Woody"" Hayes"
"1973","Ohio St.","10","0","1","0.95455","413","64","349","Wayne ""Woody"" Hayes"
"1974","Ohio St.","10","2","0","0.83333","437","129","308","Wayne ""Woody"" Hayes"
"1975","Ohio St.","11","1","0","0.91667","384","102","282","Wayne ""Woody"" Hayes"
"1976","Ohio St.","9","2","1","0.79167","305","149","156","Wayne ""Woody"" Hayes"
"1977","Ohio St.","9","3","0","0.75","343","120","223","Wayne ""Woody"" Hayes"
"1978","Ohio St.","7","4","1","0.625","339","216","123","Wayne ""Woody"" Hayes"
"1979","Ohio St.","11","1","0","0.91667","390","126","264","Earle Bruce"
"1980","Ohio St.","9","3","0","0.75","387","181","206","Earle Bruce"
"1981","Ohio St.","9","3","0","0.75","387","253","134","Earle Bruce"
"1982","Ohio St.","9","3","0","0.75","348","208","140","Earle Bruce"
"1983","Ohio St.","9","3","0","0.75","410","206","204","Earle Bruce"
"1984","Ohio St.","9","3","0","0.75","391","200","191","Earle Bruce"
"1985","Ohio St.","9","3","0","0.75","325","212","113","Earle Bruce"
"1986","Ohio St.","10","3","0","0.76923","347","179","168","Earle Bruce"
"1987","Ohio St.","6","4","1","0.59091","224","181","43","Earle Bruce"
"1988","Ohio St.","4","6","1","0.40909","229","283","-54","John Cooper"
"1989","Ohio St.","8","4","0","0.66667","339","297","42","John Cooper"
"1990","Ohio St.","7","4","1","0.625","349","220","129","John Cooper"
"1991","Ohio St.","8","4","0","0.66667","277","187","90","John Cooper"
"1992","Ohio St.","8","3","1","0.70833","271","158","113","John Cooper"
"1993","Ohio St.","10","1","1","0.875","351","193","158","John Cooper"
"1994","Ohio St.","9","4","0","0.69231","336","211","125","John Cooper"
"1995","Ohio St.","11","2","0","0.84615","475","220","255","John Cooper"
"1996","Ohio St.","11","1","0","0.91667","455","131","324","John Cooper"
"1997","Ohio St.","10","3","0","0.76923","394","170","224","John Cooper"
"1998","Ohio St.","11","1","0","0.91667","430","144","286","John Cooper"
"1999","Ohio St.","6","6","0","0.5","285","287","-2","John Cooper"
"2000","Ohio St.","8","4","0","0.66667","331","222","109","John Cooper"
"2001","Ohio St.","7","5","0","0.58333","312","244","68","Jim Tressel"
"2002","Ohio St.","14","0","0","1","410","183","227","Jim Tressel"
"2003","Ohio St.","11","2","0","0.84615","322","229","93","Jim Tressel"
"2004","Ohio St.","8","4","0","0.66667","290","219","71","Jim Tressel"
"2005","Ohio St.","10","2","0","0.83333","392","183","209","Jim Tressel"
"2006","Ohio St.","12","1","0","0.92308","450","166","284","Jim Tressel"
"2007","Ohio St.","11","2","0","0.84615","408","166","242","Jim Tressel"
"2008","Ohio St.","10","3","0","0.76923","359","181","178","Jim Tressel"
"2009","Ohio St.","11","2","0","0.84615","377","163","214","Jim Tressel"
"2010","Ohio St.","0","1","0","0","504","186","318","Jim Tressel"
"2011","Ohio St.","6","7","0","0.46154","318","273","45","Luke Fickell"
"2012","Ohio St.","12","0","0","1","446","274","172","Urban Meyer"
"2013","Ohio St.","12","2","0","0.85714","637","317","320","Urban Meyer"
"2014","Ohio St.","14","1","0","0.93333","672","330","342","Urban Meyer"
"1895","Oklahoma","0","1","0","0","0","34","-34","John A. ""Jack"" Harts"
"1897","Oklahoma","2","0","0","1","33","8","25","Vernon L. Parrington"
"1898","Oklahoma","2","0","0","1","29","0","29","Vernon L. Parrington"
"1899","Oklahoma","2","1","0","0.66667","61","28","33","Vernon L. Parrington"
"1900","Oklahoma","3","1","1","0.7","118","28","90","Vernon L. Parrington"
"1901","Oklahoma","3","2","0","0.6","93","35","58","Fred Roberts"
"1902","Oklahoma","6","3","0","0.66667","175","60","115","Mark McMahon"
"1903","Oklahoma","5","4","3","0.54167","126","85","41","Mark McMahon"
"1904","Oklahoma","4","3","1","0.5625","204","96","108","Fred Ewing"
"1905","Oklahoma","7","2","0","0.77778","229","55","174","Bennie Owen"
"1906","Oklahoma","5","2","2","0.66667","124","36","88","Bennie Owen"
"1907","Oklahoma","4","4","0","0.5","181","75","106","Bennie Owen"
"1908","Oklahoma","8","1","1","0.85","272","35","237","Bennie Owen"
"1909","Oklahoma","6","4","0","0.6","203","107","96","Bennie Owen"
"1910","Oklahoma","4","2","1","0.64286","163","31","132","Bennie Owen"
"1911","Oklahoma","8","0","0","1","282","15","267","Bennie Owen"
"1912","Oklahoma","5","4","0","0.55556","197","80","117","Bennie Owen"
"1913","Oklahoma","6","2","0","0.75","323","44","279","Bennie Owen"
"1914","Oklahoma","9","1","1","0.86364","440","96","344","Bennie Owen"
"1915","Oklahoma","10","0","0","1","370","54","316","Bennie Owen"
"1916","Oklahoma","6","5","0","0.54545","472","115","357","Bennie Owen"
"1917","Oklahoma","6","4","1","0.59091","451","103","348","Bennie Owen"
"1918","Oklahoma","6","0","0","1","278","7","271","Bennie Owen"
"1919","Oklahoma","5","2","3","0.65","275","63","212","Bennie Owen"
"1920","Oklahoma","6","0","1","0.92857","176","51","125","Bennie Owen"
"1921","Oklahoma","5","3","0","0.625","127","102","25","Bennie Owen"
"1922","Oklahoma","2","3","3","0.4375","66","114","-48","Bennie Owen"
"1923","Oklahoma","3","5","0","0.375","144","111","33","Bennie Owen"
"1924","Oklahoma","2","5","1","0.3125","28","80","-52","Bennie Owen"
"1925","Oklahoma","4","3","1","0.5625","93","44","49","Bennie Owen"
"1926","Oklahoma","5","2","1","0.6875","137","52","85","Bennie Owen"
"1927","Oklahoma","3","3","2","0.5","117","101","16","Adrian H. ""Ad"" Lindsey"
"1928","Oklahoma","5","3","0","0.625","120","88","32","Adrian H. ""Ad"" Lindsey"
"1929","Oklahoma","3","3","2","0.5","81","81","0","Adrian H. ""Ad"" Lindsey"
"1930","Oklahoma","4","3","1","0.5625","100","57","43","Adrian H. ""Ad"" Lindsey"
"1931","Oklahoma","4","7","1","0.375","88","108","-20","Adrian H. ""Ad"" Lindsey"
"1932","Oklahoma","4","4","1","0.5","90","81","9","Lewis Woodford Hardage"
"1933","Oklahoma","4","4","1","0.5","82","70","12","Lewis Woodford Hardage"
"1934","Oklahoma","3","4","2","0.44444","64","43","21","Lewis Woodford Hardage"
"1935","Oklahoma","6","3","0","0.66667","99","44","55","Lawrence M. ""Biff"" Jones"
"1936","Oklahoma","3","3","3","0.5","84","67","17","Lawrence M. ""Biff"" Jones"
"1937","Oklahoma","5","2","2","0.66667","98","39","59","Thomas E. ""Tom"" Stidham"
"1938","Oklahoma","10","1","0","0.90909","185","29","156","Thomas E. ""Tom"" Stidham"
"1939","Oklahoma","6","2","1","0.72222","186","62","124","Thomas E. ""Tom"" Stidham"
"1940","Oklahoma","6","3","0","0.66667","121","105","16","Thomas E. ""Tom"" Stidham"
"1941","Oklahoma","6","3","0","0.66667","218","95","123","Dewey W. ""Snorter"" Luster"
"1942","Oklahoma","3","5","2","0.4","135","78","57","Dewey W. ""Snorter"" Luster"
"1943","Oklahoma","7","2","0","0.77778","187","92","95","Dewey W. ""Snorter"" Luster"
"1944","Oklahoma","6","3","1","0.65","227","149","78","Dewey W. ""Snorter"" Luster"
"1945","Oklahoma","5","5","0","0.5","169","138","31","Dewey W. ""Snorter"" Luster"
"1946","Oklahoma","8","3","0","0.72727","309","120","189","James M. ""Jim"" Tatum"
"1947","Oklahoma","7","2","1","0.75","194","161","33","Charles B. ""Bud"" Wilkinson"
"1948","Oklahoma","10","1","0","0.90909","350","121","229","Charles B. ""Bud"" Wilkinson"
"1949","Oklahoma","11","0","0","1","399","88","311","Charles B. ""Bud"" Wilkinson"
"1950","Oklahoma","10","1","0","0.90909","352","148","204","Charles B. ""Bud"" Wilkinson"
"1951","Oklahoma","8","2","0","0.8","321","97","224","Charles B. ""Bud"" Wilkinson"
"1952","Oklahoma","8","1","1","0.85","407","141","266","Charles B. ""Bud"" Wilkinson"
"1953","Oklahoma","9","1","1","0.86364","293","90","203","Charles B. ""Bud"" Wilkinson"
"1954","Oklahoma","10","0","0","1","304","62","242","Charles B. ""Bud"" Wilkinson"
"1955","Oklahoma","11","0","0","1","385","60","325","Charles B. ""Bud"" Wilkinson"
"1956","Oklahoma","10","0","0","1","466","51","415","Charles B. ""Bud"" Wilkinson"
"1957","Oklahoma","10","1","0","0.90909","333","89","244","Charles B. ""Bud"" Wilkinson"
"1958","Oklahoma","10","1","0","0.90909","300","55","245","Charles B. ""Bud"" Wilkinson"
"1959","Oklahoma","7","3","0","0.7","234","146","88","Charles B. ""Bud"" Wilkinson"
"1960","Oklahoma","3","6","1","0.35","136","158","-22","Charles B. ""Bud"" Wilkinson"
"1961","Oklahoma","5","5","0","0.5","122","141","-19","Charles B. ""Bud"" Wilkinson"
"1962","Oklahoma","8","3","0","0.72727","267","61","206","Charles B. ""Bud"" Wilkinson"
"1963","Oklahoma","8","2","0","0.8","236","137","99","Charles B. ""Bud"" Wilkinson"
"1964","Oklahoma","6","4","1","0.59091","207","170","37","Gomer Jones"
"1965","Oklahoma","3","7","0","0.3","106","150","-44","Gomer Jones"
"1966","Oklahoma","6","4","0","0.6","192","122","70","Jim Mackenzie"
"1967","Oklahoma","10","1","0","0.90909","290","92","198","Chuck Fairbanks"
"1968","Oklahoma","7","4","0","0.63636","343","225","118","Chuck Fairbanks"
"1969","Oklahoma","6","4","0","0.6","285","289","-4","Chuck Fairbanks"
"1970","Oklahoma","7","4","1","0.625","305","239","66","Chuck Fairbanks"
"1971","Oklahoma","11","1","0","0.91667","534","217","317","Chuck Fairbanks"
"1972","Oklahoma","8","4","0","0.66667","399","74","325","Chuck Fairbanks"
"1973","Oklahoma","10","0","1","0.95455","400","133","267","Barry Switzer"
"1974","Oklahoma","11","0","0","1","473","92","381","Barry Switzer"
"1975","Oklahoma","11","1","0","0.91667","344","154","190","Barry Switzer"
"1976","Oklahoma","9","2","1","0.79167","326","192","134","Barry Switzer"
"1977","Oklahoma","10","2","0","0.83333","401","217","184","Barry Switzer"
"1978","Oklahoma","11","1","0","0.91667","471","175","296","Barry Switzer"
"1979","Oklahoma","11","1","0","0.91667","406","145","261","Barry Switzer"
"1980","Oklahoma","10","2","0","0.83333","396","209","187","Barry Switzer"
"1981","Oklahoma","7","4","1","0.625","341","193","148","Barry Switzer"
"1982","Oklahoma","8","4","0","0.66667","317","203","114","Barry Switzer"
"1983","Oklahoma","8","4","0","0.66667","312","222","90","Barry Switzer"
"1984","Oklahoma","9","2","1","0.79167","306","164","142","Barry Switzer"
"1985","Oklahoma","11","1","0","0.91667","371","103","268","Barry Switzer"
"1986","Oklahoma","11","1","0","0.91667","508","81","427","Barry Switzer"
"1987","Oklahoma","11","1","0","0.91667","493","102","391","Barry Switzer"
"1988","Oklahoma","9","3","0","0.75","332","160","172","Barry Switzer"
"1989","Oklahoma","7","4","0","0.63636","380","200","180","Gary Gibbs"
"1990","Oklahoma","8","3","0","0.72727","401","174","227","Gary Gibbs"
"1991","Oklahoma","9","3","0","0.75","383","157","226","Gary Gibbs"
"1992","Oklahoma","5","4","2","0.54545","271","196","75","Gary Gibbs"
"1993","Oklahoma","9","3","0","0.75","358","186","172","Gary Gibbs"
"1994","Oklahoma","6","6","0","0.5","224","269","-45","Gary Gibbs"
"1995","Oklahoma","5","5","1","0.5","233","275","-42","Howard Schnellenberger"
"1996","Oklahoma","3","8","0","0.27273","255","392","-137","John Blake"
"1997","Oklahoma","4","8","0","0.33333","232","379","-147","John Blake"
"1998","Oklahoma","5","6","0","0.45455","184","229","-45","John Blake"
"1999","Oklahoma","7","5","0","0.58333","430","229","201","Bob Stoops"
"2000","Oklahoma","13","0","0","1","481","194","287","Bob Stoops"
"2001","Oklahoma","11","2","0","0.84615","397","169","228","Bob Stoops"
"2002","Oklahoma","12","2","0","0.85714","541","216","325","Bob Stoops"
"2003","Oklahoma","12","2","0","0.85714","601","214","387","Bob Stoops"
"2004","Oklahoma","12","1","0","0.92308","452","219","233","Bob Stoops"
"2005","Oklahoma","8","4","0","0.66667","323","277","46","Bob Stoops"
"2006","Oklahoma","11","3","0","0.78571","424","242","182","Bob Stoops"
"2007","Oklahoma","11","3","0","0.78571","592","284","308","Bob Stoops"
"2008","Oklahoma","12","2","0","0.85714","716","343","373","Bob Stoops"
"2009","Oklahoma","8","5","0","0.61538","404","189","215","Bob Stoops"
"2010","Oklahoma","12","2","0","0.85714","521","305","216","Bob Stoops"
"2011","Oklahoma","10","3","0","0.76923","514","287","227","Bob Stoops"
"2012","Oklahoma","10","3","0","0.76923","496","331","165","Bob Stoops"
"2013","Oklahoma","11","2","0","0.84615","427","287","140","Bob Stoops"
"2014","Oklahoma","8","5","0","0.61538","473","337","136","Bob Stoops"
"1904","Oklahoma St.","12","15","1","0.44643","205","427","-222","No Coach"
"1906","Oklahoma St.","1","4","2","0.28571","24","91","-67","Lt. Boyd A. Hill"
"1907","Oklahoma St.","1","5","1","0.21429","18","111","-93","Edwin Parry"
"1908","Oklahoma St.","4","3","0","0.57143","86","66","20","Edwin Parry"
"1909","Oklahoma St.","5","4","0","0.55556","49","33","16","Paul J. Davis"
"1910","Oklahoma St.","3","4","0","0.42857","129","44","85","Paul J. Davis"
"1911","Oklahoma St.","5","2","0","0.71429","256","59","197","Paul J. Davis"
"1912","Oklahoma St.","6","2","0","0.75","335","56","279","Paul J. Davis"
"1913","Oklahoma St.","4","3","0","0.57143","165","27","138","Paul J. Davis"
"1914","Oklahoma St.","6","2","1","0.72222","327","71","256","Paul J. Davis"
"1915","Oklahoma St.","4","5","1","0.45","161","93","68","John G. ""Pinky"" Griffith"
"1916","Oklahoma St.","4","4","0","0.5","290","95","195","John G. ""Pinky"" Griffith"
"1917","Oklahoma St.","4","5","0","0.44444","93","94","-1","E.A. Pritchard"
"1918","Oklahoma St.","4","2","0","0.66667","103","73","30","E.A. Pritchard"
"1919","Oklahoma St.","3","3","2","0.5","126","94","32","James E. ""Jim"" Pixlee"
"1920","Oklahoma St.","0","7","1","0.0625","35","199","-164","James E. ""Jim"" Pixlee"
"1921","Oklahoma St.","5","4","1","0.55","135","125","10","Johnny F. ""John"" Maulbetsch"
"1922","Oklahoma St.","5","4","1","0.55","130","86","44","Johnny F. ""John"" Maulbetsch"
"1923","Oklahoma St.","2","9","0","0.18182","40","97","-57","Johnny F. ""John"" Maulbetsch"
"1924","Oklahoma St.","6","1","2","0.77778","117","50","67","Johnny F. ""John"" Maulbetsch"
"1925","Oklahoma St.","2","5","1","0.3125","41","115","-74","Johnny F. ""John"" Maulbetsch"
"1926","Oklahoma St.","3","4","1","0.4375","79","114","-35","Johnny F. ""John"" Maulbetsch"
"1927","Oklahoma St.","4","4","0","0.5","110","138","-28","Johnny F. ""John"" Maulbetsch"
"1928","Oklahoma St.","1","7","0","0.125","25","200","-175","Johnny F. ""John"" Maulbetsch"
"1929","Oklahoma St.","4","3","2","0.55556","107","79","28","Lynn O. ""Pappy"" Waldorf"
"1930","Oklahoma St.","7","2","1","0.75","124","40","84","Lynn O. ""Pappy"" Waldorf"
"1931","Oklahoma St.","8","2","1","0.77273","183","52","131","Lynn O. ""Pappy"" Waldorf"
"1932","Oklahoma St.","9","1","2","0.83333","178","48","130","Lynn O. ""Pappy"" Waldorf"
"1933","Oklahoma St.","6","2","1","0.72222","132","57","75","Lynn O. ""Pappy"" Waldorf"
"1934","Oklahoma St.","4","5","1","0.45","54","130","-76","Albert A. ""Al"" Exendine"
"1935","Oklahoma St.","3","7","0","0.3","59","152","-93","Albert A. ""Al"" Exendine"
"1936","Oklahoma St.","1","9","0","0.1","43","205","-162","Theodore J. ""Ted"" Cox"
"1937","Oklahoma St.","4","6","0","0.4","101","141","-40","Theodore J. ""Ted"" Cox"
"1938","Oklahoma St.","2","8","0","0.2","75","178","-103","Theodore J. ""Ted"" Cox"
"1939","Oklahoma St.","5","4","1","0.55","128","115","13","Edwin M. ""Jim"" Lookabaugh"
"1940","Oklahoma St.","6","3","1","0.65","210","137","73","Edwin M. ""Jim"" Lookabaugh"
"1941","Oklahoma St.","5","4","0","0.55556","161","123","38","Edwin M. ""Jim"" Lookabaugh"
"1942","Oklahoma St.","6","3","1","0.65","235","116","119","Edwin M. ""Jim"" Lookabaugh"
"1943","Oklahoma St.","3","4","0","0.42857","66","154","-88","Edwin M. ""Jim"" Lookabaugh"
"1944","Oklahoma St.","8","1","0","0.88889","228","103","125","Edwin M. ""Jim"" Lookabaugh"
"1945","Oklahoma St.","9","0","0","1","285","76","209","Edwin M. ""Jim"" Lookabaugh"
"1946","Oklahoma St.","3","7","1","0.31818","202","264","-62","Edwin M. ""Jim"" Lookabaugh"
"1947","Oklahoma St.","3","7","0","0.3","116","134","-18","Edwin M. ""Jim"" Lookabaugh"
"1948","Oklahoma St.","6","4","0","0.6","219","127","92","Edwin M. ""Jim"" Lookabaugh"
"1949","Oklahoma St.","4","4","2","0.5","223","212","11","Edwin M. ""Jim"" Lookabaugh"
"1950","Oklahoma St.","4","6","1","0.40909","159","259","-100","Jennings B. ""Ears"" Whitworth"
"1951","Oklahoma St.","3","7","0","0.3","168","251","-83","Jennings B. ""Ears"" Whitworth"
"1952","Oklahoma St.","3","7","0","0.3","146","178","-32","Jennings B. ""Ears"" Whitworth"
"1953","Oklahoma St.","7","3","0","0.7","178","149","29","Jennings B. ""Ears"" Whitworth"
"1954","Oklahoma St.","5","4","1","0.55","161","119","42","Jennings B. ""Ears"" Whitworth"
"1955","Oklahoma St.","2","8","0","0.2","88","172","-84","Clifton ""Cliff"" Speegle"
"1956","Oklahoma St.","3","5","2","0.4","131","166","-35","Clifton ""Cliff"" Speegle"
"1957","Oklahoma St.","6","3","1","0.65","182","129","53","Clifton ""Cliff"" Speegle"
"1958","Oklahoma St.","8","3","0","0.72727","201","134","67","Clifton ""Cliff"" Speegle"
"1959","Oklahoma St.","6","4","0","0.6","181","151","30","Clifton ""Cliff"" Speegle"
"1960","Oklahoma St.","3","7","0","0.3","102","126","-24","Clifton ""Cliff"" Speegle"
"1961","Oklahoma St.","4","6","0","0.4","154","166","-12","Clifton ""Cliff"" Speegle"
"1962","Oklahoma St.","4","6","0","0.4","138","214","-76","Clifton ""Cliff"" Speegle"
"1963","Oklahoma St.","1","8","0","0.11111","107","260","-153","Phil Cutchin"
"1964","Oklahoma St.","4","6","0","0.4","165","192","-27","Phil Cutchin"
"1965","Oklahoma St.","3","7","0","0.3","131","173","-42","Phil Cutchin"
"1966","Oklahoma St.","4","5","1","0.45","103","138","-35","Phil Cutchin"
"1967","Oklahoma St.","4","5","1","0.45","123","140","-17","Phil Cutchin"
"1968","Oklahoma St.","3","7","0","0.3","161","288","-127","Phil Cutchin"
"1969","Oklahoma St.","5","5","0","0.5","197","200","-3","Floyd Gass"
"1970","Oklahoma St.","4","7","0","0.36364","213","337","-124","Floyd Gass"
"1971","Oklahoma St.","4","6","1","0.40909","184","322","-138","Floyd Gass"
"1972","Oklahoma St.","7","4","0","0.63636","259","203","56","Dave Smith (1)"
"1973","Oklahoma St.","5","4","2","0.54545","303","186","117","Jim Stanley"
"1974","Oklahoma St.","7","5","0","0.58333","262","183","79","Jim Stanley"
"1975","Oklahoma St.","7","4","0","0.63636","285","178","107","Jim Stanley"
"1976","Oklahoma St.","9","3","0","0.75","329","214","115","Jim Stanley"
"1977","Oklahoma St.","4","7","0","0.36364","235","267","-32","Jim Stanley"
"1978","Oklahoma St.","3","8","0","0.27273","167","266","-99","Jim Stanley"
"1979","Oklahoma St.","7","4","0","0.63636","191","212","-21","Jimmy Johnson"
"1980","Oklahoma St.","3","7","1","0.31818","187","268","-81","Jimmy Johnson"
"1981","Oklahoma St.","7","5","0","0.58333","197","216","-19","Jimmy Johnson"
"1982","Oklahoma St.","4","5","2","0.45455","241","267","-26","Jimmy Johnson"
"1983","Oklahoma St.","8","4","0","0.66667","271","162","109","Jimmy Johnson"
"1984","Oklahoma St.","10","2","0","0.83333","312","148","164","Pat Jones"
"1985","Oklahoma St.","8","4","0","0.66667","255","188","67","Pat Jones"
"1986","Oklahoma St.","6","5","0","0.54545","181","191","-10","Pat Jones"
"1987","Oklahoma St.","10","2","0","0.83333","409","242","167","Pat Jones"
"1988","Oklahoma St.","10","2","0","0.83333","584","341","243","Pat Jones"
"1989","Oklahoma St.","4","7","0","0.36364","226","319","-93","Pat Jones"
"1990","Oklahoma St.","4","7","0","0.36364","233","309","-76","Pat Jones"
"1991","Oklahoma St.","0","10","1","0.04545","106","307","-201","Pat Jones"
"1992","Oklahoma St.","4","6","1","0.40909","161","251","-90","Pat Jones"
"1993","Oklahoma St.","3","8","0","0.27273","174","236","-62","Pat Jones"
"1994","Oklahoma St.","3","7","1","0.31818","180","256","-76","Pat Jones"
"1995","Oklahoma St.","4","8","0","0.33333","250","345","-95","Bob Simmons"
"1996","Oklahoma St.","5","6","0","0.45455","243","327","-84","Bob Simmons"
"1997","Oklahoma St.","8","4","0","0.66667","352","233","119","Bob Simmons"
"1998","Oklahoma St.","5","6","0","0.45455","303","296","7","Bob Simmons"
"1999","Oklahoma St.","5","6","0","0.45455","267","274","-7","Bob Simmons"
"2000","Oklahoma St.","3","8","0","0.27273","202","303","-101","Bob Simmons"
"2001","Oklahoma St.","4","7","0","0.36364","242","281","-39","Les Miles"
"2002","Oklahoma St.","8","5","0","0.61538","446","356","90","Les Miles"
"2003","Oklahoma St.","9","4","0","0.69231","467","326","141","Les Miles"
"2004","Oklahoma St.","7","5","0","0.58333","387","301","86","Les Miles"
"2005","Oklahoma St.","4","7","0","0.36364","222","344","-122","Mike Gundy"
"2006","Oklahoma St.","7","6","0","0.53846","458","333","125","Mike Gundy"
"2007","Oklahoma St.","7","6","0","0.53846","450","384","66","Mike Gundy"
"2008","Oklahoma St.","9","4","0","0.69231","530","365","165","Mike Gundy"
"2009","Oklahoma St.","9","4","0","0.69231","369","282","87","Mike Gundy"
"2010","Oklahoma St.","11","2","0","0.84615","575","343","232","Mike Gundy"
"2011","Oklahoma St.","12","1","0","0.92308","633","348","285","Mike Gundy"
"2012","Oklahoma St.","8","5","0","0.61538","594","367","227","Mike Gundy"
"2013","Oklahoma St.","10","3","0","0.76923","508","281","227","Mike Gundy"
"2014","Oklahoma St.","7","6","0","0.53846","359","406","-47","Mike Gundy"
"1930","Old Dominion (VA)","3","1","0","0.75","66","14","52","Tommy L Scott"
"1931","Old Dominion (VA)","1","0","1","0.75","7","0","7","Tommy L Scott"
"1932","Old Dominion (VA)","6","3","1","0.65","133","31","102","Tommy L Scott"
"1933","Old Dominion (VA)","5","3","0","0.625","68","58","10","Tommy L Scott"
"1934","Old Dominion (VA)","3","5","1","0.38889","64","128","-64","Tommy L Scott"
"1935","Old Dominion (VA)","8","1","0","0.88889","173","38","135","Tommy L Scott"
"1936","Old Dominion (VA)","4","4","0","0.5","57","102","-45","Tommy L Scott"
"1937","Old Dominion (VA)","5","3","0","0.625","144","53","91","Tommy L Scott"
"1938","Old Dominion (VA)","3","5","1","0.38889","49","54","-5","Tommy L Scott"
"1939","Old Dominion (VA)","4","5","0","0.44444","110","106","4","Tommy L Scott"
"1940","Old Dominion (VA)","0","6","0","0","0","166","-166","Tommy L Scott"
"2009","Old Dominion (VA)","9","2","0","0.81818","385","253","132","Bobby Wilder"
"2010","Old Dominion (VA)","8","3","0","0.72727","369","239","130","Bobby Wilder"
"2011","Old Dominion (VA)","10","3","0","0.76923","477","361","116","Bobby Wilder"
"2012","Old Dominion (VA)","11","2","0","0.84615","587","396","191","Bobby Wilder"
"2013","Old Dominion (VA)","8","4","0","0.66667","508","408","100","Bobby Wilder"
"2014","Old Dominion (VA)","6","6","0","0.5","392","456","-64","Bobby Wilder"
"1894","Oregon St.","2","1","0","0.66667","52","28","24","Guy Kennedy"
"1895","Oregon St.","0","2","1","0.16667","6","80","-74","Paul Downing"
"1896","Oregon St.","1","2","0","0.33333","26","14","12","Tommy Code"
"1899","Oregon St.","3","2","0","0.6","75","60","15","Highland Stickney"
"1902","Oregon St.","4","1","1","0.75","157","16","141","Frank D. Herbold"
"1903","Oregon St.","2","4","1","0.35714","21","32","-11","Coach McFadden"
"1904","Oregon St.","4","2","0","0.66667","119","22","97","Dr. Allen C. Steckle"
"1905","Oregon St.","6","3","0","0.66667","164","28","136","Dr. Allen C. Steckle"
"1906","Oregon St.","4","1","2","0.71429","77","4","73","Fred S. Norcross"
"1907","Oregon St.","6","0","0","1","137","0","137","Fred S. Norcross"
"1908","Oregon St.","4","3","1","0.5625","83","51","32","Fred S. Norcross"
"1909","Oregon St.","4","2","1","0.64286","54","41","13","Sol S. Metzger"
"1910","Oregon St.","3","3","1","0.5","27","49","-22","George H. Schildmiller"
"1911","Oregon St.","5","2","0","0.71429","119","49","70","Sam Dolan"
"1912","Oregon St.","3","4","0","0.42857","57","40","17","Sam Dolan"
"1913","Oregon St.","3","2","3","0.5625","59","75","-16","Edward J. ""Doc"" Stewart"
"1914","Oregon St.","7","0","2","0.88889","172","15","157","Edward J. ""Doc"" Stewart"
"1915","Oregon St.","5","3","0","0.625","166","73","93","Edward J. ""Doc"" Stewart"
"1916","Oregon St.","4","5","0","0.44444","92","112","-20","Joseph A. Pipal"
"1917","Oregon St.","4","2","1","0.64286","83","33","50","Joseph A. Pipal"
"1918","Oregon St.","2","4","0","0.33333","33","46","-13","William H. ""Bill"" Hargiss"
"1919","Oregon St.","4","4","1","0.5","143","64","79","William H. ""Bill"" Hargiss"
"1920","Oregon St.","2","2","2","0.5","20","52","-32","R.B. Rutherford"
"1921","Oregon St.","4","3","2","0.55556","231","42","189","R.B. Rutherford"
"1922","Oregon St.","3","4","0","0.42857","44","42","2","R.B. Rutherford"
"1923","Oregon St.","4","5","2","0.45455","55","71","-16","R.B. Rutherford"
"1924","Oregon St.","3","5","0","0.375","71","85","-14","Paul J. Schissler"
"1925","Oregon St.","7","2","0","0.77778","268","81","187","Paul J. Schissler"
"1926","Oregon St.","7","1","0","0.875","221","30","191","Paul J. Schissler"
"1927","Oregon St.","3","3","1","0.5","98","78","20","Paul J. Schissler"
"1928","Oregon St.","6","3","0","0.66667","206","53","153","Paul J. Schissler"
"1929","Oregon St.","5","4","0","0.55556","182","106","76","Paul J. Schissler"
"1930","Oregon St.","7","3","0","0.7","208","60","148","Paul J. Schissler"
"1931","Oregon St.","6","3","1","0.65","198","62","136","Paul J. Schissler"
"1932","Oregon St.","4","6","0","0.4","130","109","21","Paul J. Schissler"
"1933","Oregon St.","6","2","2","0.7","88","48","40","Alonaz L. ""Lon"" Stiner"
"1934","Oregon St.","3","6","2","0.36364","104","131","-27","Alonaz L. ""Lon"" Stiner"
"1935","Oregon St.","6","4","1","0.59091","175","100","75","Alonaz L. ""Lon"" Stiner"
"1936","Oregon St.","4","6","0","0.4","116","151","-35","Alonaz L. ""Lon"" Stiner"
"1937","Oregon St.","3","3","3","0.5","71","60","11","Alonaz L. ""Lon"" Stiner"
"1938","Oregon St.","5","3","1","0.61111","72","51","21","Alonaz L. ""Lon"" Stiner"
"1939","Oregon St.","9","1","1","0.86364","186","77","109","Alonaz L. ""Lon"" Stiner"
"1940","Oregon St.","5","3","1","0.61111","128","80","48","Alonaz L. ""Lon"" Stiner"
"1941","Oregon St.","8","2","0","0.8","143","49","94","Alonaz L. ""Lon"" Stiner"
"1942","Oregon St.","4","5","1","0.45","157","142","15","Alonaz L. ""Lon"" Stiner"
"1945","Oregon St.","4","4","1","0.5","100","131","-31","Alonaz L. ""Lon"" Stiner"
"1946","Oregon St.","7","1","1","0.83333","157","81","76","Alonaz L. ""Lon"" Stiner"
"1947","Oregon St.","5","5","0","0.5","171","136","35","Alonaz L. ""Lon"" Stiner"
"1948","Oregon St.","5","4","3","0.54167","249","236","13","Alonaz L. ""Lon"" Stiner"
"1949","Oregon St.","7","3","0","0.7","232","188","44","LeVerne H. ""Kip"" Taylor"
"1950","Oregon St.","3","6","0","0.33333","114","183","-69","LeVerne H. ""Kip"" Taylor"
"1951","Oregon St.","4","6","0","0.4","204","180","24","LeVerne H. ""Kip"" Taylor"
"1952","Oregon St.","2","7","0","0.22222","123","267","-144","LeVerne H. ""Kip"" Taylor"
"1953","Oregon St.","3","6","0","0.33333","39","187","-148","LeVerne H. ""Kip"" Taylor"
"1954","Oregon St.","1","8","0","0.11111","60","296","-236","LeVerne H. ""Kip"" Taylor"
"1955","Oregon St.","6","3","0","0.66667","126","120","6","J. Thompson ""Tommy"" Prothro"
"1956","Oregon St.","7","3","1","0.68182","203","166","37","J. Thompson ""Tommy"" Prothro"
"1957","Oregon St.","8","2","0","0.8","203","129","74","J. Thompson ""Tommy"" Prothro"
"1958","Oregon St.","6","4","0","0.6","98","118","-20","J. Thompson ""Tommy"" Prothro"
"1959","Oregon St.","3","7","0","0.3","166","178","-12","J. Thompson ""Tommy"" Prothro"
"1960","Oregon St.","6","3","1","0.65","197","145","52","J. Thompson ""Tommy"" Prothro"
"1961","Oregon St.","5","5","0","0.5","165","137","28","J. Thompson ""Tommy"" Prothro"
"1962","Oregon St.","9","2","0","0.81818","279","148","131","J. Thompson ""Tommy"" Prothro"
"1963","Oregon St.","5","5","0","0.5","198","192","6","J. Thompson ""Tommy"" Prothro"
"1964","Oregon St.","8","3","0","0.72727","149","124","25","J. Thompson ""Tommy"" Prothro"
"1965","Oregon St.","5","5","0","0.5","125","162","-37","Dee Andros"
"1966","Oregon St.","7","3","0","0.7","171","156","15","Dee Andros"
"1967","Oregon St.","7","2","1","0.75","187","137","50","Dee Andros"
"1968","Oregon St.","7","3","0","0.7","285","179","106","Dee Andros"
"1969","Oregon St.","6","4","0","0.6","175","148","27","Dee Andros"
"1970","Oregon St.","6","5","0","0.54545","211","239","-28","Dee Andros"
"1971","Oregon St.","5","6","0","0.45455","268","317","-49","Dee Andros"
"1972","Oregon St.","2","9","0","0.18182","131","295","-164","Dee Andros"
"1973","Oregon St.","2","9","0","0.18182","166","293","-127","Dee Andros"
"1974","Oregon St.","3","8","0","0.27273","216","285","-69","Dee Andros"
"1975","Oregon St.","1","10","0","0.09091","103","264","-161","Dee Andros"
"1976","Oregon St.","2","10","0","0.16667","179","325","-146","Craig Fertig"
"1977","Oregon St.","3","8","0","0.27273","173","303","-130","Craig Fertig"
"1978","Oregon St.","3","7","1","0.31818","128","266","-138","Craig Fertig"
"1979","Oregon St.","2","9","0","0.18182","147","396","-249","Craig Fertig"
"1980","Oregon St.","0","11","0","0","108","386","-278","Joe Avezzano"
"1981","Oregon St.","1","10","0","0.09091","145","469","-324","Joe Avezzano"
"1982","Oregon St.","1","9","1","0.13636","134","306","-172","Joe Avezzano"
"1983","Oregon St.","2","8","1","0.22727","171","332","-161","Joe Avezzano"
"1984","Oregon St.","2","9","0","0.18182","158","279","-121","Joe Avezzano"
"1985","Oregon St.","3","8","0","0.27273","160","362","-202","Dave Kragthorpe"
"1986","Oregon St.","3","8","0","0.27273","143","270","-127","Dave Kragthorpe"
"1987","Oregon St.","2","9","0","0.18182","189","433","-244","Dave Kragthorpe"
"1988","Oregon St.","4","6","1","0.40909","246","280","-34","Dave Kragthorpe"
"1989","Oregon St.","4","7","1","0.375","207","357","-150","Dave Kragthorpe"
"1990","Oregon St.","1","10","0","0.09091","152","371","-219","Dave Kragthorpe"
"1991","Oregon St.","1","10","0","0.09091","125","365","-240","Jerry Pettibone"
"1992","Oregon St.","1","9","1","0.13636","163","363","-200","Jerry Pettibone"
"1993","Oregon St.","4","7","0","0.36364","224","294","-70","Jerry Pettibone"
"1994","Oregon St.","4","7","0","0.36364","223","239","-16","Jerry Pettibone"
"1995","Oregon St.","1","10","0","0.09091","136","237","-101","Jerry Pettibone"
"1996","Oregon St.","2","9","0","0.18182","216","388","-172","Jerry Pettibone"
"1999","Oregon St.","7","5","0","0.58333","347","277","70","Dennis Erickson"
"2000","Oregon St.","11","1","0","0.91667","400","212","188","Dennis Erickson"
"2001","Oregon St.","5","6","0","0.45455","287","259","28","Dennis Erickson"
"2002","Oregon St.","8","5","0","0.61538","414","267","147","Dennis Erickson"
"1997","Oregon St.","3","8","0","0.27273","195","285","-90","Mike Riley"
"1998","Oregon St.","5","6","0","0.45455","286","291","-5","Mike Riley"
"2003","Oregon St.","8","5","0","0.61538","433","301","132","Mike Riley"
"2004","Oregon St.","7","5","0","0.58333","320","294","26","Mike Riley"
"2005","Oregon St.","5","6","0","0.45455","293","365","-72","Mike Riley"
"2006","Oregon St.","10","4","0","0.71429","389","311","78","Mike Riley"
"2007","Oregon St.","9","4","0","0.69231","362","294","68","Mike Riley"
"2008","Oregon St.","9","4","0","0.69231","397","300","97","Mike Riley"
"2009","Oregon St.","8","5","0","0.61538","409","325","84","Mike Riley"
"2010","Oregon St.","5","7","0","0.41667","293","322","-29","Mike Riley"
"2011","Oregon St.","3","9","0","0.25","262","370","-108","Mike Riley"
"2012","Oregon St.","9","4","0","0.69231","423","268","155","Mike Riley"
"2013","Oregon St.","7","6","0","0.53846","452","408","44","Mike Riley"
"2014","Oregon St.","5","7","0","0.41667","308","379","-71","Mike Riley"
"1892","Penn St.","6","1","0","0.85714","164","20","144","George W. Hoskins"
"1893","Penn St.","6","2","0","0.75","110","52","58","George W. Hoskins"
"1894","Penn St.","6","0","1","0.92857","179","18","161","George W. Hoskins"
"1895","Penn St.","2","2","3","0.5","92","60","32","George W. Hoskins"
"1896","Penn St.","3","4","0","0.42857","63","128","-65","Dr. Samuel B. Newton"
"1897","Penn St.","3","6","0","0.33333","69","141","-72","Dr. Samuel B. Newton"
"1898","Penn St.","6","4","0","0.6","174","91","83","Dr. Samuel B. Newton"
"1899","Penn St.","5","6","1","0.45833","143","176","-33","Samuel Alexander Boyle"
"1900","Penn St.","4","6","1","0.40909","83","156","-73","William N. ""Pop"" Golden"
"1901","Penn St.","5","3","0","0.625","111","90","21","William N. ""Pop"" Golden"
"1902","Penn St.","7","3","0","0.7","212","34","178","William N. ""Pop"" Golden"
"1903","Penn St.","5","3","0","0.625","182","77","105","Daniel A. ""Dan"" Reed"
"1904","Penn St.","6","4","0","0.6","195","72","123","Thomas F. ""Tom"" Fennell"
"1905","Penn St.","8","3","0","0.72727","195","34","161","Thomas F. ""Tom"" Fennell"
"1906","Penn St.","8","1","1","0.85","94","10","84","Thomas F. ""Tom"" Fennell"
"1907","Penn St.","6","4","0","0.6","251","64","187","Thomas F. ""Tom"" Fennell"
"1908","Penn St.","5","5","0","0.5","153","51","102","Thomas F. ""Tom"" Fennell"
"1909","Penn St.","5","0","2","0.85714","166","11","155","William M. ""Bill"" Hollenback"
"1911","Penn St.","8","0","1","0.94444","199","15","184","William M. ""Bill"" Hollenback"
"1912","Penn St.","8","0","0","1","285","6","279","William M. ""Bill"" Hollenback"
"1913","Penn St.","2","6","0","0.25","78","94","-16","William M. ""Bill"" Hollenback"
"1914","Penn St.","5","3","1","0.61111","121","52","69","William M. ""Bill"" Hollenback"
"1910","Penn St.","5","2","1","0.6875","243","24","219","Jack Hollenback"
"1915","Penn St.","7","2","0","0.77778","147","51","96","Richard C. ""Dick"" Harlow"
"1916","Penn St.","8","2","0","0.8","348","62","286","Richard C. ""Dick"" Harlow"
"1917","Penn St.","5","4","0","0.55556","267","61","206","Richard C. ""Dick"" Harlow"
"1918","Penn St.","1","2","1","0.375","22","66","-44","Hugo F. Bezdek"
"1919","Penn St.","7","1","0","0.875","173","33","140","Hugo F. Bezdek"
"1920","Penn St.","7","0","2","0.88889","259","35","224","Hugo F. Bezdek"
"1921","Penn St.","8","0","2","0.9","251","56","195","Hugo F. Bezdek"
"1922","Penn St.","6","4","1","0.59091","185","62","123","Hugo F. Bezdek"
"1923","Penn St.","6","2","1","0.72222","159","46","113","Hugo F. Bezdek"
"1924","Penn St.","6","3","1","0.65","202","65","137","Hugo F. Bezdek"
"1925","Penn St.","4","4","1","0.5","67","66","1","Hugo F. Bezdek"
"1926","Penn St.","5","4","0","0.55556","200","83","117","Hugo F. Bezdek"
"1927","Penn St.","6","2","1","0.72222","163","81","82","Hugo F. Bezdek"
"1928","Penn St.","3","5","1","0.38889","93","68","25","Hugo F. Bezdek"
"1929","Penn St.","6","3","0","0.66667","101","75","26","Hugo F. Bezdek"
"1930","Penn St.","3","4","2","0.44444","142","111","31","Robert A. ""Bob"" Higgins"
"1931","Penn St.","2","8","0","0.2","69","167","-98","Robert A. ""Bob"" Higgins"
"1932","Penn St.","2","5","0","0.28571","82","115","-33","Robert A. ""Bob"" Higgins"
"1933","Penn St.","3","3","1","0.5","117","66","51","Robert A. ""Bob"" Higgins"
"1934","Penn St.","4","4","0","0.5","115","58","57","Robert A. ""Bob"" Higgins"
"1935","Penn St.","4","4","0","0.5","76","70","6","Robert A. ""Bob"" Higgins"
"1936","Penn St.","3","5","0","0.375","109","86","23","Robert A. ""Bob"" Higgins"
"1937","Penn St.","5","3","0","0.625","143","114","29","Robert A. ""Bob"" Higgins"
"1938","Penn St.","3","4","1","0.4375","138","87","51","Robert A. ""Bob"" Higgins"
"1939","Penn St.","5","1","2","0.75","114","77","37","Robert A. ""Bob"" Higgins"
"1940","Penn St.","6","1","1","0.8125","135","46","89","Robert A. ""Bob"" Higgins"
"1941","Penn St.","7","2","0","0.77778","200","78","122","Robert A. ""Bob"" Higgins"
"1942","Penn St.","6","1","1","0.8125","91","70","21","Robert A. ""Bob"" Higgins"
"1943","Penn St.","5","3","1","0.61111","124","53","71","Robert A. ""Bob"" Higgins"
"1944","Penn St.","6","3","0","0.66667","207","141","66","Robert A. ""Bob"" Higgins"
"1945","Penn St.","5","3","0","0.625","173","89","84","Robert A. ""Bob"" Higgins"
"1946","Penn St.","6","2","0","0.75","192","48","144","Robert A. ""Bob"" Higgins"
"1947","Penn St.","9","0","1","0.95","332","40","292","Robert A. ""Bob"" Higgins"
"1948","Penn St.","7","1","1","0.83333","219","55","164","Robert A. ""Bob"" Higgins"
"1949","Penn St.","5","4","0","0.55556","162","175","-13","F. Joseph ""Joe"" Bedenk"
"1950","Penn St.","5","3","1","0.61111","141","155","-14","Charles A. ""Rip"" Engle"
"1951","Penn St.","5","4","0","0.55556","155","161","-6","Charles A. ""Rip"" Engle"
"1952","Penn St.","7","2","1","0.75","172","149","23","Charles A. ""Rip"" Engle"
"1953","Penn St.","6","3","0","0.66667","207","148","59","Charles A. ""Rip"" Engle"
"1954","Penn St.","7","2","0","0.77778","206","92","114","Charles A. ""Rip"" Engle"
"1955","Penn St.","5","4","0","0.55556","163","150","13","Charles A. ""Rip"" Engle"
"1956","Penn St.","6","2","1","0.72222","177","60","117","Charles A. ""Rip"" Engle"
"1957","Penn St.","6","3","0","0.66667","167","135","32","Charles A. ""Rip"" Engle"
"1958","Penn St.","6","3","1","0.65","237","97","140","Charles A. ""Rip"" Engle"
"1959","Penn St.","9","2","0","0.81818","262","112","150","Charles A. ""Rip"" Engle"
"1960","Penn St.","7","3","0","0.7","228","113","115","Charles A. ""Rip"" Engle"
"1961","Penn St.","8","3","0","0.72727","261","143","118","Charles A. ""Rip"" Engle"
"1962","Penn St.","9","2","0","0.81818","256","119","137","Charles A. ""Rip"" Engle"
"1963","Penn St.","7","3","0","0.7","165","114","51","Charles A. ""Rip"" Engle"
"1964","Penn St.","6","4","0","0.6","189","111","78","Charles A. ""Rip"" Engle"
"1965","Penn St.","5","5","0","0.5","202","151","51","Charles A. ""Rip"" Engle"
"1966","Penn St.","5","5","0","0.5","193","208","-15","Joe Paterno"
"1967","Penn St.","8","2","1","0.77273","299","158","141","Joe Paterno"
"1968","Penn St.","11","0","0","1","354","120","234","Joe Paterno"
"1969","Penn St.","11","0","0","1","322","90","232","Joe Paterno"
"1970","Penn St.","7","3","0","0.7","300","163","137","Joe Paterno"
"1971","Penn St.","11","1","0","0.91667","484","137","347","Joe Paterno"
"1972","Penn St.","10","2","0","0.83333","358","189","169","Joe Paterno"
"1973","Penn St.","12","0","0","1","447","129","318","Joe Paterno"
"1974","Penn St.","10","2","0","0.83333","322","142","180","Joe Paterno"
"1975","Penn St.","9","3","0","0.75","240","123","117","Joe Paterno"
"1976","Penn St.","7","5","0","0.58333","241","173","68","Joe Paterno"
"1977","Penn St.","11","1","0","0.91667","390","187","203","Joe Paterno"
"1978","Penn St.","11","1","0","0.91667","333","111","222","Joe Paterno"
"1979","Penn St.","8","4","0","0.66667","257","177","80","Joe Paterno"
"1980","Penn St.","10","2","0","0.83333","321","158","163","Joe Paterno"
"1981","Penn St.","10","2","0","0.83333","371","162","209","Joe Paterno"
"1982","Penn St.","11","1","0","0.91667","395","196","199","Joe Paterno"
"1983","Penn St.","8","4","1","0.65385","320","312","8","Joe Paterno"
"1984","Penn St.","6","5","0","0.54545","209","230","-21","Joe Paterno"
"1985","Penn St.","11","1","0","0.91667","275","153","122","Joe Paterno"
"1986","Penn St.","12","0","0","1","340","133","207","Joe Paterno"
"1987","Penn St.","8","4","0","0.66667","286","244","42","Joe Paterno"
"1988","Penn St.","5","6","0","0.45455","231","201","30","Joe Paterno"
"1989","Penn St.","8","3","1","0.70833","259","169","90","Joe Paterno"
"1990","Penn St.","9","3","0","0.75","297","179","118","Joe Paterno"
"1991","Penn St.","11","2","0","0.84615","474","184","290","Joe Paterno"
"1992","Penn St.","7","5","0","0.58333","391","234","157","Joe Paterno"
"1993","Penn St.","10","2","0","0.83333","388","215","173","Joe Paterno"
"1994","Penn St.","12","0","0","1","564","252","312","Joe Paterno"
"1995","Penn St.","9","3","0","0.75","399","259","140","Joe Paterno"
"1996","Penn St.","11","2","0","0.84615","400","203","197","Joe Paterno"
"1997","Penn St.","9","3","0","0.75","366","254","112","Joe Paterno"
"1998","Penn St.","9","3","0","0.75","317","183","134","Joe Paterno"
"1999","Penn St.","10","3","0","0.76923","417","234","183","Joe Paterno"
"2000","Penn St.","5","7","0","0.41667","264","293","-29","Joe Paterno"
"2001","Penn St.","5","6","0","0.45455","248","281","-33","Joe Paterno"
"2002","Penn St.","9","4","0","0.69231","446","227","219","Joe Paterno"
"2003","Penn St.","3","9","0","0.25","233","255","-22","Joe Paterno"
"2004","Penn St.","4","7","0","0.36364","195","168","27","Joe Paterno"
"2005","Penn St.","11","1","0","0.91667","413","204","209","Joe Paterno"
"2006","Penn St.","9","4","0","0.69231","290","187","103","Joe Paterno"
"2007","Penn St.","9","4","0","0.69231","394","228","166","Joe Paterno"
"2008","Penn St.","11","2","0","0.84615","506","187","319","Joe Paterno"
"2009","Penn St.","11","2","0","0.84615","375","159","216","Joe Paterno"
"2010","Penn St.","7","6","0","0.53846","319","308","11","Joe Paterno"
"2011","Penn St.","8","1","0","0.88889","196","112","84","Joe Paterno"
"2011","Penn St.","1","3","0","0.25","55","106","-51","Tom Bradley"
"2012","Penn St.","8","4","0","0.66667","349","229","120","Bill O'Brien"
"2013","Penn St.","7","5","0","0.58333","344","314","30","Bill O'Brien"
"2014","Penn St.","7","6","0","0.53846","268","242","26","James Franklin"
"1893","Pittsburgh (PA)","0","5","0","0","14","78","-64","Anson F. Harrold"
"1895","Pittsburgh (PA)","1","6","0","0.14286","30","136","-106","J.P. Linn"
"1896","Pittsburgh (PA)","3","6","0","0.33333","42","69","-27","George W. Hoskins"
"1897","Pittsburgh (PA)","1","3","0","0.25","13","91","-78","Thomas Gawthrop ""Doggie"" Trenchard"
"1898","Pittsburgh (PA)","5","3","4","0.58333","85","57","28","Dr. Frederick A. Robinson"
"1899","Pittsburgh (PA)","3","2","0","0.6","43","23","20","Dr. Frederick A. Robinson"
"1900","Pittsburgh (PA)","5","4","0","0.55556","110","33","77","Dr. M. Roy Jackson"
"1901","Pittsburgh (PA)","7","2","1","0.75","96","47","49","Wilbur D. Hockensmith"
"1902","Pittsburgh (PA)","5","6","1","0.45833","128","129","-1","Frederick J. Crolius"
"1903","Pittsburgh (PA)","0","9","1","0.05","26","271","-245","Arthur St. L. ""Texas"" Mosse"
"1904","Pittsburgh (PA)","10","0","0","1","406","5","401","Arthur St. L. ""Texas"" Mosse"
"1905","Pittsburgh (PA)","10","2","0","0.83333","405","36","369","Arthur St. L. ""Texas"" Mosse"
"1906","Pittsburgh (PA)","6","4","0","0.6","229","55","174","Edgar R. Wingard"
"1907","Pittsburgh (PA)","8","2","0","0.8","147","27","120","James A. Moorhead"
"1908","Pittsburgh (PA)","8","3","0","0.72727","140","36","104","Joseph H. Thompson"
"1909","Pittsburgh (PA)","6","2","1","0.72222","94","26","68","Joseph H. Thompson"
"1910","Pittsburgh (PA)","9","0","0","1","282","0","282","Joseph H. Thompson"
"1911","Pittsburgh (PA)","4","3","1","0.5625","72","29","43","Joseph H. Thompson"
"1912","Pittsburgh (PA)","3","6","0","0.33333","113","118","-5","Joseph H. Thompson"
"1913","Pittsburgh (PA)","6","2","1","0.72222","165","46","119","Joseph M. Duff, Jr."
"1914","Pittsburgh (PA)","8","1","0","0.88889","207","38","169","Joseph M. Duff, Jr."
"1915","Pittsburgh (PA)","8","0","0","1","247","19","228","Glenn Scobey ""Pop"" Warner"
"1916","Pittsburgh (PA)","8","0","0","1","255","25","230","Glenn Scobey ""Pop"" Warner"
"1917","Pittsburgh (PA)","10","0","0","1","260","21","239","Glenn Scobey ""Pop"" Warner"
"1918","Pittsburgh (PA)","4","1","0","0.8","140","16","124","Glenn Scobey ""Pop"" Warner"
"1919","Pittsburgh (PA)","6","2","1","0.72222","119","66","53","Glenn Scobey ""Pop"" Warner"
"1920","Pittsburgh (PA)","6","0","2","0.875","146","44","102","Glenn Scobey ""Pop"" Warner"
"1921","Pittsburgh (PA)","5","3","1","0.61111","133","51","82","Glenn Scobey ""Pop"" Warner"
"1922","Pittsburgh (PA)","8","2","0","0.8","190","43","147","Glenn Scobey ""Pop"" Warner"
"1923","Pittsburgh (PA)","5","4","0","0.55556","83","39","44","Glenn Scobey ""Pop"" Warner"
"1924","Pittsburgh (PA)","5","3","1","0.61111","98","43","55","Dr. John B. ""Jock"" Sutherland"
"1925","Pittsburgh (PA)","8","1","0","0.88889","151","34","117","Dr. John B. ""Jock"" Sutherland"
"1926","Pittsburgh (PA)","5","2","2","0.66667","170","73","97","Dr. John B. ""Jock"" Sutherland"
"1927","Pittsburgh (PA)","8","1","1","0.85","279","27","252","Dr. John B. ""Jock"" Sutherland"
"1928","Pittsburgh (PA)","6","2","1","0.72222","177","15","162","Dr. John B. ""Jock"" Sutherland"
"1929","Pittsburgh (PA)","9","1","0","0.9","291","90","201","Dr. John B. ""Jock"" Sutherland"
"1930","Pittsburgh (PA)","6","2","1","0.72222","186","69","117","Dr. John B. ""Jock"" Sutherland"
"1931","Pittsburgh (PA)","8","1","0","0.88889","280","37","243","Dr. John B. ""Jock"" Sutherland"
"1932","Pittsburgh (PA)","8","1","2","0.81818","182","60","122","Dr. John B. ""Jock"" Sutherland"
"1933","Pittsburgh (PA)","8","1","0","0.88889","147","13","134","Dr. John B. ""Jock"" Sutherland"
"1934","Pittsburgh (PA)","8","1","0","0.88889","205","44","161","Dr. John B. ""Jock"" Sutherland"
"1935","Pittsburgh (PA)","7","1","2","0.8","135","28","107","Dr. John B. ""Jock"" Sutherland"
"1936","Pittsburgh (PA)","8","1","1","0.85","224","34","190","Dr. John B. ""Jock"" Sutherland"
"1937","Pittsburgh (PA)","9","0","1","0.95","203","34","169","Dr. John B. ""Jock"" Sutherland"
"1938","Pittsburgh (PA)","8","2","0","0.8","213","59","154","Dr. John B. ""Jock"" Sutherland"
"1939","Pittsburgh (PA)","5","4","0","0.55556","119","98","21","Charles W. Bowser"
"1940","Pittsburgh (PA)","3","4","1","0.4375","85","102","-17","Charles W. Bowser"
"1941","Pittsburgh (PA)","3","6","0","0.33333","82","171","-89","Charles W. Bowser"
"1942","Pittsburgh (PA)","3","6","0","0.33333","90","190","-100","Charles W. Bowser"
"1943","Pittsburgh (PA)","3","5","0","0.375","114","180","-66","Clark D. Shaughnessy"
"1944","Pittsburgh (PA)","4","5","0","0.44444","147","293","-146","Clark D. Shaughnessy"
"1945","Pittsburgh (PA)","3","7","0","0.3","87","141","-54","Clark D. Shaughnessy"
"1946","Pittsburgh (PA)","3","5","1","0.38889","88","136","-48","Wesley E. ""Wes"" Fesler"
"1947","Pittsburgh (PA)","1","8","0","0.11111","26","267","-241","Walter S. ""Mike"" Milligan"
"1948","Pittsburgh (PA)","6","3","0","0.66667","119","154","-35","Walter S. ""Mike"" Milligan"
"1949","Pittsburgh (PA)","6","3","0","0.66667","156","154","2","Walter S. ""Mike"" Milligan"
"1950","Pittsburgh (PA)","1","8","0","0.11111","99","204","-105","Leonard J. ""Len"" Casanova"
"1951","Pittsburgh (PA)","3","7","0","0.3","156","215","-59","Lt. Thomas J. ""Tom"" Hamilton"
"1954","Pittsburgh (PA)","4","2","0","0.66667","69","82","-13","Lt. Thomas J. ""Tom"" Hamilton"
"1952","Pittsburgh (PA)","6","3","0","0.66667","187","156","31","Lowell P. ""Red"" Dawson"
"1953","Pittsburgh (PA)","3","5","1","0.38889","143","138","5","Lowell P. ""Red"" Dawson"
"1954","Pittsburgh (PA)","0","3","0","0","14","106","-92","Lowell P. ""Red"" Dawson"
"1955","Pittsburgh (PA)","7","4","0","0.63636","181","122","59","John P. Michelosen"
"1956","Pittsburgh (PA)","7","3","1","0.68182","156","119","37","John P. Michelosen"
"1957","Pittsburgh (PA)","4","6","0","0.4","134","157","-23","John P. Michelosen"
"1958","Pittsburgh (PA)","5","4","1","0.55","163","138","25","John P. Michelosen"
"1959","Pittsburgh (PA)","6","4","0","0.6","148","164","-16","John P. Michelosen"
"1960","Pittsburgh (PA)","4","3","3","0.55","134","77","57","John P. Michelosen"
"1961","Pittsburgh (PA)","3","7","0","0.3","145","209","-64","John P. Michelosen"
"1962","Pittsburgh (PA)","5","5","0","0.5","142","185","-43","John P. Michelosen"
"1963","Pittsburgh (PA)","9","1","0","0.9","236","130","106","John P. Michelosen"
"1964","Pittsburgh (PA)","3","5","2","0.4","152","154","-2","John P. Michelosen"
"1965","Pittsburgh (PA)","3","7","0","0.3","173","311","-138","John P. Michelosen"
"1966","Pittsburgh (PA)","1","9","0","0.1","105","326","-221","David R. Hart"
"1967","Pittsburgh (PA)","1","9","0","0.1","73","295","-222","David R. Hart"
"1968","Pittsburgh (PA)","1","9","0","0.1","99","393","-294","David R. Hart"
"1969","Pittsburgh (PA)","4","6","0","0.4","166","287","-121","Carl A. DePasqua"
"1970","Pittsburgh (PA)","5","5","0","0.5","179","245","-66","Carl A. DePasqua"
"1971","Pittsburgh (PA)","3","8","0","0.27273","216","388","-172","Carl A. DePasqua"
"1972","Pittsburgh (PA)","1","10","0","0.09091","193","350","-157","Carl A. DePasqua"
"1973","Pittsburgh (PA)","6","5","1","0.54167","225","211","14","Johnny Majors"
"1974","Pittsburgh (PA)","7","4","0","0.63636","227","202","25","Johnny Majors"
"1975","Pittsburgh (PA)","8","4","0","0.66667","322","161","161","Johnny Majors"
"1976","Pittsburgh (PA)","12","0","0","1","381","133","248","Johnny Majors"
"1993","Pittsburgh (PA)","3","8","0","0.27273","168","371","-203","Johnny Majors"
"1994","Pittsburgh (PA)","3","8","0","0.27273","246","307","-61","Johnny Majors"
"1995","Pittsburgh (PA)","2","9","0","0.18182","217","329","-112","Johnny Majors"
"1996","Pittsburgh (PA)","4","7","0","0.36364","214","430","-216","Johnny Majors"
"1977","Pittsburgh (PA)","9","2","1","0.79167","428","134","294","Jackie Sherrill"
"1978","Pittsburgh (PA)","8","4","0","0.66667","263","187","76","Jackie Sherrill"
"1979","Pittsburgh (PA)","11","1","0","0.91667","291","116","175","Jackie Sherrill"
"1980","Pittsburgh (PA)","11","1","0","0.91667","380","130","250","Jackie Sherrill"
"1981","Pittsburgh (PA)","11","1","0","0.91667","385","160","225","Jackie Sherrill"
"1982","Pittsburgh (PA)","9","3","0","0.75","300","129","171","Serafino ""Foge"" Fazio"
"1983","Pittsburgh (PA)","8","3","1","0.70833","288","165","123","Serafino ""Foge"" Fazio"
"1984","Pittsburgh (PA)","3","7","1","0.31818","178","247","-69","Serafino ""Foge"" Fazio"
"1985","Pittsburgh (PA)","5","5","1","0.5","202","187","15","Serafino ""Foge"" Fazio"
"1986","Pittsburgh (PA)","6","4","1","0.59091","253","209","44","Mike Gottfried"
"1987","Pittsburgh (PA)","8","4","0","0.66667","230","146","84","Mike Gottfried"
"1988","Pittsburgh (PA)","6","5","0","0.54545","300","183","117","Mike Gottfried"
"1989","Pittsburgh (PA)","7","3","1","0.68182","302","240","62","Mike Gottfried"
"1989","Pittsburgh (PA)","1","0","0","1","31","28","3","Paul Hackett"
"1990","Pittsburgh (PA)","3","7","1","0.31818","240","293","-53","Paul Hackett"
"1991","Pittsburgh (PA)","6","5","0","0.54545","244","241","3","Paul Hackett"
"1992","Pittsburgh (PA)","3","8","0","0.27273","266","393","-127","Paul Hackett"
"1992","Pittsburgh (PA)","0","1","0","0","23","36","-13","Sal Sunseri"
"1997","Pittsburgh (PA)","6","6","0","0.5","333","354","-21","Walt Harris"
"1998","Pittsburgh (PA)","2","9","0","0.18182","234","334","-100","Walt Harris"
"1999","Pittsburgh (PA)","5","6","0","0.45455","281","278","3","Walt Harris"
"2000","Pittsburgh (PA)","7","5","0","0.58333","296","247","49","Walt Harris"
"2001","Pittsburgh (PA)","7","5","0","0.58333","296","245","51","Walt Harris"
"2002","Pittsburgh (PA)","9","4","0","0.69231","331","232","99","Walt Harris"
"2003","Pittsburgh (PA)","8","5","0","0.61538","389","311","78","Walt Harris"
"2004","Pittsburgh (PA)","8","4","0","0.66667","325","288","37","Walt Harris"
"2005","Pittsburgh (PA)","5","6","0","0.45455","267","243","24","Dave Wannstedt"
"2006","Pittsburgh (PA)","6","6","0","0.5","381","274","107","Dave Wannstedt"
"2007","Pittsburgh (PA)","5","7","0","0.41667","274","291","-17","Dave Wannstedt"
"2008","Pittsburgh (PA)","9","4","0","0.69231","352","279","73","Dave Wannstedt"
"2009","Pittsburgh (PA)","10","3","0","0.76923","417","257","160","Dave Wannstedt"
"2010","Pittsburgh (PA)","7","5","0","0.58333","315","237","78","Dave Wannstedt"
"2010","Pittsburgh (PA)","1","0","0","1","27","10","17","Phil Bennett"
"2011","Pittsburgh (PA)","0","1","0","0","6","28","-22","Keith Patterson"
"2011","Pittsburgh (PA)","6","6","0","0.5","309","269","40","Todd Graham"
"2012","Pittsburgh (PA)","6","7","0","0.46154","346","274","72","Paul Chryst"
"2013","Pittsburgh (PA)","7","6","0","0.53846","342","353","-11","Paul Chryst"
"2014","Pittsburgh (PA)","6","7","0","0.46154","414","342","72","Paul Chryst"
"1887","Purdue (IN)","0","1","0","0","6","48","-42","Albert Berg"
"1889","Purdue (IN)","2","1","0","0.66667","52","28","24","G.A. Reisner"
"1890","Purdue (IN)","6","3","1","0.65","222","72","150","Clinton L. ""Clint"" Hare"
"1891","Purdue (IN)","4","0","0","1","192","0","192","Knowlton L. ""Snake"" Ames"
"1892","Purdue (IN)","8","0","0","1","318","22","296","Knowlton L. ""Snake"" Ames"
"1893","Purdue (IN)","5","2","1","0.6875","334","144","190","D.M. Balliet"
"1894","Purdue (IN)","9","1","0","0.9","177","42","135","D.M. Balliet"
"1895","Purdue (IN)","4","3","0","0.57143","77","58","19","D.M. Balliet"
"1901","Purdue (IN)","4","4","1","0.5","138","66","72","D.M. Balliet"
"1896","Purdue (IN)","4","2","1","0.64286","122","60","62","S.M. Hammond"
"1897","Purdue (IN)","5","3","1","0.61111","106","108","-2","William Wells ""Bill"" Church"
"1898","Purdue (IN)","3","3","0","0.5","37","33","4","Alpha P. Jamison"
"1899","Purdue (IN)","4","4","1","0.5","100","122","-22","Alpha P. Jamison"
"1900","Purdue (IN)","4","4","0","0.5","172","79","93","Alpha P. Jamison"
"1902","Purdue (IN)","7","2","1","0.75","316","68","248","Charles M. Best"
"1903","Purdue (IN)","4","2","0","0.66667","87","48","39","Oliver F. Cutts"
"1904","Purdue (IN)","9","3","0","0.75","176","66","110","Oliver F. Cutts"
"1905","Purdue (IN)","6","1","1","0.8125","177","30","147","Albert E. Hernstein"
"1906","Purdue (IN)","0","5","0","0","5","86","-81","Myron E. Witham"
"1907","Purdue (IN)","0","5","0","0","10","108","-98","Leigh C. Turner"
"1908","Purdue (IN)","4","3","0","0.57143","124","78","46","Dr. Frederick A. Speik"
"1909","Purdue (IN)","2","5","0","0.28571","72","147","-75","Dr. Frederick A. Speik"
"1910","Purdue (IN)","1","5","0","0.16667","19","65","-46","M. Frank ""Bill"" Horr"
"1911","Purdue (IN)","3","4","0","0.42857","58","48","10","M. Frank ""Bill"" Horr"
"1912","Purdue (IN)","4","2","1","0.64286","176","70","106","M. Frank ""Bill"" Horr"
"1913","Purdue (IN)","4","1","2","0.71429","171","20","151","Andrew L. ""Andy"" Smith"
"1914","Purdue (IN)","5","2","0","0.71429","157","63","94","Andrew L. ""Andy"" Smith"
"1915","Purdue (IN)","3","3","1","0.5","62","62","0","Andrew L. ""Andy"" Smith"
"1916","Purdue (IN)","2","4","1","0.35714","67","99","-32","Cleo A. O'Donnell"
"1917","Purdue (IN)","3","4","0","0.42857","95","109","-14","Cleo A. O'Donnell"
"1918","Purdue (IN)","3","3","0","0.5","87","78","9","A.G. ""Butch"" Scanlon"
"1919","Purdue (IN)","2","4","1","0.35714","71","104","-33","A.G. ""Butch"" Scanlon"
"1920","Purdue (IN)","2","5","0","0.28571","36","103","-67","A.G. ""Butch"" Scanlon"
"1921","Purdue (IN)","1","6","0","0.14286","9","95","-86","William H. ""Lone Star"" Dietz"
"1922","Purdue (IN)","1","5","1","0.21429","36","126","-90","James M. ""Jimmy"" Phelan"
"1923","Purdue (IN)","2","5","1","0.3125","65","106","-41","James M. ""Jimmy"" Phelan"
"1924","Purdue (IN)","5","2","0","0.71429","137","46","91","James M. ""Jimmy"" Phelan"
"1925","Purdue (IN)","3","4","1","0.4375","119","39","80","James M. ""Jimmy"" Phelan"
"1926","Purdue (IN)","5","2","1","0.6875","146","67","79","James M. ""Jimmy"" Phelan"
"1927","Purdue (IN)","6","2","0","0.75","170","38","132","James M. ""Jimmy"" Phelan"
"1928","Purdue (IN)","5","2","1","0.6875","143","41","102","James M. ""Jimmy"" Phelan"
"1929","Purdue (IN)","8","0","0","1","187","44","143","James M. ""Jimmy"" Phelan"
"1930","Purdue (IN)","6","2","0","0.75","150","41","109","Noble E. Kizer"
"1931","Purdue (IN)","9","1","0","0.9","192","39","153","Noble E. Kizer"
"1932","Purdue (IN)","7","0","1","0.9375","164","42","122","Noble E. Kizer"
"1933","Purdue (IN)","6","1","1","0.8125","109","37","72","Noble E. Kizer"
"1934","Purdue (IN)","5","3","0","0.625","93","75","18","Noble E. Kizer"
"1935","Purdue (IN)","4","4","0","0.5","65","57","8","Noble E. Kizer"
"1936","Purdue (IN)","5","2","1","0.6875","157","95","62","Noble E. Kizer"
"1937","Purdue (IN)","4","3","1","0.5625","83","69","14","Allen H. ""Mal"" Elward"
"1938","Purdue (IN)","5","1","2","0.75","84","38","46","Allen H. ""Mal"" Elward"
"1939","Purdue (IN)","3","3","2","0.5","56","53","3","Allen H. ""Mal"" Elward"
"1940","Purdue (IN)","2","6","0","0.25","96","106","-10","Allen H. ""Mal"" Elward"
"1941","Purdue (IN)","2","5","1","0.3125","27","62","-35","Allen H. ""Mal"" Elward"
"1942","Purdue (IN)","1","8","0","0.11111","27","179","-152","Elmer H. Burnham"
"1943","Purdue (IN)","9","0","0","1","214","55","159","Elmer H. Burnham"
"1944","Purdue (IN)","5","5","0","0.5","207","166","41","Cecil Isbell"
"1945","Purdue (IN)","7","3","0","0.7","198","125","73","Cecil Isbell"
"1946","Purdue (IN)","2","6","1","0.27778","97","208","-111","Cecil Isbell"
"1947","Purdue (IN)","5","4","0","0.55556","205","130","75","Stuart K. ""Stu"" Holcomb"
"1948","Purdue (IN)","3","6","0","0.33333","126","175","-49","Stuart K. ""Stu"" Holcomb"
"1949","Purdue (IN)","4","5","0","0.44444","119","135","-16","Stuart K. ""Stu"" Holcomb"
"1950","Purdue (IN)","2","7","0","0.22222","143","200","-57","Stuart K. ""Stu"" Holcomb"
"1951","Purdue (IN)","5","4","0","0.55556","153","152","1","Stuart K. ""Stu"" Holcomb"
"1952","Purdue (IN)","4","3","2","0.55556","188","151","37","Stuart K. ""Stu"" Holcomb"
"1953","Purdue (IN)","2","7","0","0.22222","89","167","-78","Stuart K. ""Stu"" Holcomb"
"1954","Purdue (IN)","5","3","1","0.61111","165","134","31","Stuart K. ""Stu"" Holcomb"
"1955","Purdue (IN)","5","3","1","0.61111","113","103","10","Stuart K. ""Stu"" Holcomb"
"1956","Purdue (IN)","3","4","2","0.44444","139","122","17","Kenneth ""Jack"" Mollenkopf"
"1957","Purdue (IN)","5","4","0","0.55556","178","114","64","Kenneth ""Jack"" Mollenkopf"
"1958","Purdue (IN)","6","1","2","0.77778","184","102","82","Kenneth ""Jack"" Mollenkopf"
"1959","Purdue (IN)","5","2","2","0.66667","109","81","28","Kenneth ""Jack"" Mollenkopf"
"1960","Purdue (IN)","4","4","1","0.5","212","163","49","Kenneth ""Jack"" Mollenkopf"
"1961","Purdue (IN)","6","3","0","0.66667","146","87","59","Kenneth ""Jack"" Mollenkopf"
"1962","Purdue (IN)","4","4","1","0.5","141","68","73","Kenneth ""Jack"" Mollenkopf"
"1963","Purdue (IN)","5","4","0","0.55556","119","149","-30","Kenneth ""Jack"" Mollenkopf"
"1964","Purdue (IN)","6","3","0","0.66667","168","146","22","Kenneth ""Jack"" Mollenkopf"
"1965","Purdue (IN)","7","2","1","0.75","227","127","100","Kenneth ""Jack"" Mollenkopf"
"1966","Purdue (IN)","9","2","0","0.81818","297","154","143","Kenneth ""Jack"" Mollenkopf"
"1967","Purdue (IN)","8","2","0","0.8","291","154","137","Kenneth ""Jack"" Mollenkopf"
"1968","Purdue (IN)","8","2","0","0.8","291","167","124","Kenneth ""Jack"" Mollenkopf"
"1969","Purdue (IN)","8","2","0","0.8","354","264","90","Kenneth ""Jack"" Mollenkopf"
"1970","Purdue (IN)","4","6","0","0.4","161","189","-28","Bob DeMoss"
"1971","Purdue (IN)","3","7","0","0.3","210","228","-18","Bob DeMoss"
"1972","Purdue (IN)","6","5","0","0.54545","245","135","110","Bob DeMoss"
"1973","Purdue (IN)","5","6","0","0.45455","200","213","-13","Alex Agase"
"1974","Purdue (IN)","4","6","1","0.40909","223","261","-38","Alex Agase"
"1975","Purdue (IN)","4","7","0","0.36364","128","220","-92","Alex Agase"
"1976","Purdue (IN)","5","6","0","0.45455","188","233","-45","Alex Agase"
"1977","Purdue (IN)","5","6","0","0.45455","231","247","-16","Jim Young"
"1978","Purdue (IN)","9","2","1","0.79167","261","130","131","Jim Young"
"1979","Purdue (IN)","10","2","0","0.83333","287","226","61","Jim Young"
"1980","Purdue (IN)","9","3","0","0.75","328","233","95","Jim Young"
"1981","Purdue (IN)","5","6","0","0.45455","242","241","1","Jim Young"
"1982","Purdue (IN)","3","8","0","0.27273","211","324","-113","Leon Burtnett"
"1983","Purdue (IN)","3","7","1","0.31818","251","366","-115","Leon Burtnett"
"1984","Purdue (IN)","7","5","0","0.58333","286","283","3","Leon Burtnett"
"1985","Purdue (IN)","5","6","0","0.45455","287","306","-19","Leon Burtnett"
"1986","Purdue (IN)","3","8","0","0.27273","160","335","-175","Leon Burtnett"
"1987","Purdue (IN)","3","7","1","0.31818","197","285","-88","Fred Akers"
"1988","Purdue (IN)","4","7","0","0.36364","124","303","-179","Fred Akers"
"1989","Purdue (IN)","3","8","0","0.27273","172","281","-109","Fred Akers"
"1990","Purdue (IN)","2","9","0","0.18182","177","337","-160","Fred Akers"
"1991","Purdue (IN)","4","7","0","0.36364","219","272","-53","Jim Colletto"
"1992","Purdue (IN)","4","7","0","0.36364","211","267","-56","Jim Colletto"
"1993","Purdue (IN)","1","10","0","0.09091","221","326","-105","Jim Colletto"
"1994","Purdue (IN)","5","4","2","0.54545","336","346","-10","Jim Colletto"
"1995","Purdue (IN)","4","6","1","0.40909","282","269","13","Jim Colletto"
"1996","Purdue (IN)","3","8","0","0.27273","194","324","-130","Jim Colletto"
"1997","Purdue (IN)","9","3","0","0.75","396","267","129","Joe Tiller"
"1998","Purdue (IN)","9","4","0","0.69231","444","276","168","Joe Tiller"
"1999","Purdue (IN)","7","5","0","0.58333","384","305","79","Joe Tiller"
"2000","Purdue (IN)","8","4","0","0.66667","381","266","115","Joe Tiller"
"2001","Purdue (IN)","6","6","0","0.5","250","278","-28","Joe Tiller"
"2002","Purdue (IN)","7","6","0","0.53846","386","288","98","Joe Tiller"
"2003","Purdue (IN)","9","4","0","0.69231","349","226","123","Joe Tiller"
"2004","Purdue (IN)","7","5","0","0.58333","381","206","175","Joe Tiller"
"2005","Purdue (IN)","5","6","0","0.45455","330","309","21","Joe Tiller"
"2006","Purdue (IN)","8","6","0","0.57143","364","374","-10","Joe Tiller"
"2007","Purdue (IN)","8","5","0","0.61538","446","345","101","Joe Tiller"
"2008","Purdue (IN)","4","8","0","0.33333","296","301","-5","Joe Tiller"
"2009","Purdue (IN)","5","7","0","0.41667","334","349","-15","Danny Hope"
"2010","Purdue (IN)","4","8","0","0.33333","236","345","-109","Danny Hope"
"2011","Purdue (IN)","7","6","0","0.53846","350","349","1","Danny Hope"
"2012","Purdue (IN)","6","6","0","0.5","359","348","11","Danny Hope"
"2012","Purdue (IN)","0","1","0","0","14","58","-44","Patrick Higgins"
"2013","Purdue (IN)","1","11","0","0.08333","179","456","-277","Darrell Hazell"
"2014","Purdue (IN)","3","9","0","0.25","286","380","-94","Darrell Hazell"
"1912","Rice (TX)","3","2","0","0.6","40","125","-85","Phillip H. ""Phil"" Arbuckle"
"1913","Rice (TX)","4","0","0","1","81","14","67","Phillip H. ""Phil"" Arbuckle"
"1914","Rice (TX)","3","2","3","0.5625","59","113","-54","Phillip H. ""Phil"" Arbuckle"
"1915","Rice (TX)","5","3","0","0.625","122","143","-21","Phillip H. ""Phil"" Arbuckle"
"1916","Rice (TX)","6","1","2","0.77778","346","62","284","Phillip H. ""Phil"" Arbuckle"
"1917","Rice (TX)","8","1","0","0.88889","251","55","196","Phillip H. ""Phil"" Arbuckle"
"1919","Rice (TX)","8","1","0","0.88889","190","60","130","Phillip H. ""Phil"" Arbuckle"
"1920","Rice (TX)","4","2","2","0.625","105","28","77","Phillip H. ""Phil"" Arbuckle"
"1921","Rice (TX)","4","4","1","0.5","143","128","15","Phillip H. ""Phil"" Arbuckle"
"1922","Rice (TX)","4","4","0","0.5","74","122","-48","Phillip H. ""Phil"" Arbuckle"
"1923","Rice (TX)","3","5","0","0.375","35","94","-59","Phillip H. ""Phil"" Arbuckle"
"1918","Rice (TX)","1","6","1","0.1875","13","68","-55","John Anderson"
"1924","Rice (TX)","4","4","0","0.5","85","70","15","John W. Heisman"
"1925","Rice (TX)","4","4","1","0.5","85","79","6","John W. Heisman"
"1926","Rice (TX)","4","4","1","0.5","84","81","3","John W. Heisman"
"1927","Rice (TX)","2","6","1","0.27778","64","160","-96","John W. Heisman"
"1928","Rice (TX)","2","7","0","0.22222","83","174","-91","Claude J. Rothgeb"
"1929","Rice (TX)","2","7","0","0.22222","34","208","-174","John F. ""Jack"" Meagher"
"1930","Rice (TX)","8","4","0","0.66667","135","91","44","John F. ""Jack"" Meagher"
"1931","Rice (TX)","6","4","0","0.6","178","66","112","John F. ""Jack"" Meagher"
"1932","Rice (TX)","7","3","0","0.7","141","77","64","John F. ""Jack"" Meagher"
"1933","Rice (TX)","3","8","0","0.27273","56","137","-81","John F. ""Jack"" Meagher"
"1934","Rice (TX)","9","1","1","0.86364","204","44","160","James R. ""Jimmy"" Kitts"
"1935","Rice (TX)","8","3","0","0.72727","201","95","106","James R. ""Jimmy"" Kitts"
"1936","Rice (TX)","5","7","0","0.41667","127","108","19","James R. ""Jimmy"" Kitts"
"1937","Rice (TX)","6","3","2","0.63636","117","94","23","James R. ""Jimmy"" Kitts"
"1938","Rice (TX)","4","6","0","0.4","91","133","-42","James R. ""Jimmy"" Kitts"
"1939","Rice (TX)","1","9","1","0.13636","77","143","-66","James R. ""Jimmy"" Kitts"
"1940","Rice (TX)","7","3","0","0.7","131","78","53","Jess C. Neely"
"1941","Rice (TX)","6","3","1","0.65","167","121","46","Jess C. Neely"
"1942","Rice (TX)","7","2","1","0.75","177","74","103","Jess C. Neely"
"1943","Rice (TX)","3","7","0","0.3","60","183","-123","Jess C. Neely"
"1944","Rice (TX)","5","6","0","0.45455","143","163","-20","Jess C. Neely"
"1945","Rice (TX)","5","6","0","0.45455","130","153","-23","Jess C. Neely"
"1946","Rice (TX)","9","2","0","0.81818","245","62","183","Jess C. Neely"
"1947","Rice (TX)","6","3","1","0.65","202","74","128","Jess C. Neely"
"1948","Rice (TX)","5","4","1","0.55","168","119","49","Jess C. Neely"
"1949","Rice (TX)","10","1","0","0.90909","276","97","179","Jess C. Neely"
"1950","Rice (TX)","6","4","0","0.6","168","196","-28","Jess C. Neely"
"1951","Rice (TX)","5","5","0","0.5","149","144","5","Jess C. Neely"
"1952","Rice (TX)","5","5","0","0.5","152","175","-23","Jess C. Neely"
"1953","Rice (TX)","9","2","0","0.81818","295","105","190","Jess C. Neely"
"1954","Rice (TX)","7","3","0","0.7","205","148","57","Jess C. Neely"
"1955","Rice (TX)","2","7","1","0.25","110","179","-69","Jess C. Neely"
"1956","Rice (TX)","4","6","0","0.4","160","169","-9","Jess C. Neely"
"1957","Rice (TX)","7","4","0","0.63636","175","121","54","Jess C. Neely"
"1958","Rice (TX)","5","5","0","0.5","178","156","22","Jess C. Neely"
"1959","Rice (TX)","1","7","2","0.2","86","197","-111","Jess C. Neely"
"1960","Rice (TX)","7","4","0","0.63636","174","72","102","Jess C. Neely"
"1961","Rice (TX)","7","4","0","0.63636","183","158","25","Jess C. Neely"
"1962","Rice (TX)","2","6","2","0.3","119","173","-54","Jess C. Neely"
"1963","Rice (TX)","6","4","0","0.6","145","114","31","Jess C. Neely"
"1964","Rice (TX)","4","5","1","0.45","117","111","6","Jess C. Neely"
"1965","Rice (TX)","2","8","0","0.2","123","248","-125","Jess C. Neely"
"1966","Rice (TX)","2","8","0","0.2","154","211","-57","Jess C. Neely"
"1967","Rice (TX)","4","6","0","0.4","164","175","-11","Harold ""Bo"" Hagan"
"1968","Rice (TX)","0","9","1","0.05","151","326","-175","Harold ""Bo"" Hagan"
"1969","Rice (TX)","3","7","0","0.3","168","225","-57","Harold ""Bo"" Hagan"
"1970","Rice (TX)","5","5","0","0.5","168","175","-7","Harold ""Bo"" Hagan"
"1971","Rice (TX)","3","7","1","0.31818","146","220","-74","Bill Peterson"
"1972","Rice (TX)","5","5","1","0.5","196","238","-42","Al Conover"
"1973","Rice (TX)","5","6","0","0.45455","153","223","-70","Al Conover"
"1974","Rice (TX)","2","8","1","0.22727","117","222","-105","Al Conover"
"1975","Rice (TX)","3","8","0","0.27273","176","252","-76","Al Conover"
"1976","Rice (TX)","3","8","0","0.27273","236","417","-181","Homer Rice"
"1977","Rice (TX)","1","10","0","0.09091","151","458","-307","Homer Rice"
"1978","Rice (TX)","2","9","0","0.18182","159","408","-249","Ray Alborn"
"1979","Rice (TX)","1","10","0","0.09091","121","418","-297","Ray Alborn"
"1980","Rice (TX)","5","6","0","0.45455","175","215","-40","Ray Alborn"
"1981","Rice (TX)","4","7","0","0.36364","183","347","-164","Ray Alborn"
"1982","Rice (TX)","0","11","0","0","138","361","-223","Ray Alborn"
"1983","Rice (TX)","1","10","0","0.09091","105","333","-228","Ray Alborn"
"1984","Rice (TX)","1","10","0","0.09091","213","382","-169","Watson Brown"
"1985","Rice (TX)","3","8","0","0.27273","233","404","-171","Watson Brown"
"1986","Rice (TX)","4","7","0","0.36364","185","330","-145","Jerry Berndt"
"1987","Rice (TX)","2","9","0","0.18182","237","427","-190","Jerry Berndt"
"1988","Rice (TX)","0","11","0","0","165","358","-193","Jerry Berndt"
"1989","Rice (TX)","2","8","1","0.22727","175","313","-138","Fred Goldsmith"
"1990","Rice (TX)","5","6","0","0.45455","256","258","-2","Fred Goldsmith"
"1991","Rice (TX)","4","7","0","0.36364","239","287","-48","Fred Goldsmith"
"1992","Rice (TX)","6","5","0","0.54545","294","261","33","Fred Goldsmith"
"1993","Rice (TX)","6","5","0","0.54545","284","294","-10","Fred Goldsmith"
"1994","Rice (TX)","5","6","0","0.45455","206","203","3","Ken Hatfield"
"1995","Rice (TX)","2","8","1","0.22727","215","284","-69","Ken Hatfield"
"1996","Rice (TX)","7","4","0","0.63636","296","312","-16","Ken Hatfield"
"1997","Rice (TX)","7","4","0","0.63636","306","285","21","Ken Hatfield"
"1998","Rice (TX)","5","6","0","0.45455","235","257","-22","Ken Hatfield"
"1999","Rice (TX)","5","6","0","0.45455","237","261","-24","Ken Hatfield"
"2000","Rice (TX)","3","8","0","0.27273","237","322","-85","Ken Hatfield"
"2001","Rice (TX)","8","4","0","0.66667","333","335","-2","Ken Hatfield"
"2002","Rice (TX)","4","7","0","0.36364","253","296","-43","Ken Hatfield"
"2003","Rice (TX)","5","7","0","0.41667","343","378","-35","Ken Hatfield"
"2004","Rice (TX)","3","8","0","0.27273","279","377","-98","Ken Hatfield"
"2005","Rice (TX)","1","10","0","0.09091","241","447","-206","Ken Hatfield"
"2006","Rice (TX)","7","6","0","0.53846","350","432","-82","Todd Graham"
"2007","Rice (TX)","3","9","0","0.25","377","515","-138","David Bailiff"
"2008","Rice (TX)","10","3","0","0.76923","537","433","104","David Bailiff"
"2009","Rice (TX)","2","10","0","0.16667","219","517","-298","David Bailiff"
"2010","Rice (TX)","4","8","0","0.33333","344","462","-118","David Bailiff"
"2011","Rice (TX)","4","8","0","0.33333","280","400","-120","David Bailiff"
"2012","Rice (TX)","7","6","0","0.53846","414","390","24","David Bailiff"
"2013","Rice (TX)","10","4","0","0.71429","415","342","73","David Bailiff"
"2014","Rice (TX)","8","5","0","0.61538","374","370","4","David Bailiff"
"1869","Rutgers (NJ)","2","2","0","0.5","18","18","0","No Coach"
"1870","Rutgers (NJ)","2","2","0","0.5","17","17","0","No Coach"
"1873","Rutgers (NJ)","7","4","1","0.625","31","26","5","No Coach"
"1881","Rutgers (NJ)","22","17","8","0.55319","70","38","32","No Coach"
"1882","Rutgers (NJ)","41","28","2","0.59155","176","111","65","No Coach"
"1883","Rutgers (NJ)","38","32","1","0.54225","1288","965","323","No Coach"
"1891","Rutgers (NJ)","8","6","0","0.57143","265","137","128","William A. ""Billy"" Reynolds"
"1895","Rutgers (NJ)","4","4","0","0.5","98","131","-33","H.W. Ambruster"
"1896","Rutgers (NJ)","0","1","0","0","0","22","-22","H.W. Ambruster"
"1896","Rutgers (NJ)","6","6","0","0.5","74","204","-130","John C.B. Pendleton"
"1897","Rutgers (NJ)","2","7","0","0.22222","38","128","-90","John C.B. Pendleton"
"1898","Rutgers (NJ)","1","6","1","0.1875","16","114","-98","William V.B. Van Dyck, Jr."
"1899","Rutgers (NJ)","2","9","0","0.18182","114","245","-131","William V.B. Van Dyck, Jr."
"1900","Rutgers (NJ)","4","4","0","0.5","50","66","-16","Michael F. Daly"
"1901","Rutgers (NJ)","0","7","0","0","5","133","-128","Arthur P. Robinson"
"1902","Rutgers (NJ)","3","7","0","0.3","42","188","-146","Henry W. van Hoevenberg"
"1903","Rutgers (NJ)","4","4","1","0.5","94","110","-16","Oliver D. Mann"
"1905","Rutgers (NJ)","3","6","0","0.33333","44","99","-55","Oliver D. Mann"
"1904","Rutgers (NJ)","1","6","2","0.22222","16","202","-186","A. Ellet Hitchner"
"1906","Rutgers (NJ)","5","2","2","0.66667","123","30","93","Frank H. Gorton"
"1907","Rutgers (NJ)","3","5","1","0.38889","76","99","-23","Frank H. Gorton"
"1908","Rutgers (NJ)","3","5","1","0.38889","53","104","-51","Joseph Smith"
"1909","Rutgers (NJ)","3","5","1","0.38889","62","74","-12","Herman Pritchard"
"1910","Rutgers (NJ)","3","2","3","0.5625","59","33","26","Howard Gargan"
"1911","Rutgers (NJ)","4","4","1","0.5","25","99","-74","Howard Gargan"
"1912","Rutgers (NJ)","5","4","0","0.55556","112","102","10","Howard Gargan"
"1913","Rutgers (NJ)","6","3","0","0.66667","247","76","171","George Foster Sanford"
"1914","Rutgers (NJ)","5","3","1","0.61111","208","73","135","George Foster Sanford"
"1915","Rutgers (NJ)","7","1","0","0.875","351","33","318","George Foster Sanford"
"1916","Rutgers (NJ)","3","2","2","0.57143","106","52","54","George Foster Sanford"
"1917","Rutgers (NJ)","7","1","1","0.83333","295","28","267","George Foster Sanford"
"1918","Rutgers (NJ)","5","2","0","0.71429","192","78","114","George Foster Sanford"
"1919","Rutgers (NJ)","5","3","0","0.625","115","70","45","George Foster Sanford"
"1920","Rutgers (NJ)","2","7","0","0.22222","32","132","-100","George Foster Sanford"
"1921","Rutgers (NJ)","4","5","0","0.44444","99","168","-69","George Foster Sanford"
"1922","Rutgers (NJ)","5","4","0","0.55556","133","117","16","George Foster Sanford"
"1923","Rutgers (NJ)","7","1","1","0.83333","260","36","224","George Foster Sanford"
"1924","Rutgers (NJ)","7","1","1","0.83333","249","48","201","John H. Wallace"
"1925","Rutgers (NJ)","2","7","0","0.22222","38","146","-108","John H. Wallace"
"1926","Rutgers (NJ)","3","6","0","0.33333","49","134","-85","John H. Wallace"
"1927","Rutgers (NJ)","4","4","0","0.5","103","179","-76","Harry J. Rockafeller"
"1928","Rutgers (NJ)","6","3","0","0.66667","97","116","-19","Harry J. Rockafeller"
"1929","Rutgers (NJ)","5","4","0","0.55556","109","94","15","Harry J. Rockafeller"
"1930","Rutgers (NJ)","4","5","0","0.44444","159","154","5","Harry J. Rockafeller"
"1942","Rutgers (NJ)","3","4","1","0.4375","100","113","-13","Harry J. Rockafeller"
"1943","Rutgers (NJ)","3","2","0","0.6","61","21","40","Harry J. Rockafeller"
"1944","Rutgers (NJ)","3","2","0","0.6","58","82","-24","Harry J. Rockafeller"
"1945","Rutgers (NJ)","5","2","0","0.71429","140","61","79","Harry J. Rockafeller"
"1931","Rutgers (NJ)","4","3","1","0.5625","111","100","11","J. Wilder Tasker"
"1932","Rutgers (NJ)","6","3","1","0.65","159","58","101","J. Wilder Tasker"
"1933","Rutgers (NJ)","6","3","1","0.65","146","94","52","J. Wilder Tasker"
"1934","Rutgers (NJ)","5","3","1","0.61111","184","68","116","J. Wilder Tasker"
"1935","Rutgers (NJ)","4","5","0","0.44444","115","170","-55","J. Wilder Tasker"
"1936","Rutgers (NJ)","1","6","1","0.1875","20","133","-113","J. Wilder Tasker"
"1937","Rutgers (NJ)","5","4","0","0.55556","128","39","89","J. Wilder Tasker"
"1938","Rutgers (NJ)","7","1","0","0.875","118","57","61","Harvey J. Harman"
"1939","Rutgers (NJ)","7","1","1","0.83333","146","70","76","Harvey J. Harman"
"1940","Rutgers (NJ)","5","3","0","0.625","211","56","155","Harvey J. Harman"
"1941","Rutgers (NJ)","7","2","0","0.77778","174","85","89","Harvey J. Harman"
"1946","Rutgers (NJ)","7","2","0","0.77778","252","48","204","Harvey J. Harman"
"1947","Rutgers (NJ)","8","1","0","0.88889","262","99","163","Harvey J. Harman"
"1948","Rutgers (NJ)","7","2","0","0.77778","224","130","94","Harvey J. Harman"
"1949","Rutgers (NJ)","6","3","0","0.66667","266","138","128","Harvey J. Harman"
"1950","Rutgers (NJ)","4","4","0","0.5","186","154","32","Harvey J. Harman"
"1951","Rutgers (NJ)","4","4","0","0.5","184","114","70","Harvey J. Harman"
"1952","Rutgers (NJ)","4","4","1","0.5","178","184","-6","Harvey J. Harman"
"1953","Rutgers (NJ)","2","6","0","0.25","126","216","-90","Harvey J. Harman"
"1954","Rutgers (NJ)","3","6","0","0.33333","140","145","-5","Harvey J. Harman"
"1955","Rutgers (NJ)","3","5","0","0.375","95","163","-68","Harvey J. Harman"
"1956","Rutgers (NJ)","3","7","0","0.3","117","240","-123","John R. Stiegman"
"1957","Rutgers (NJ)","5","4","0","0.55556","181","133","48","John R. Stiegman"
"1958","Rutgers (NJ)","8","1","0","0.88889","301","77","224","John R. Stiegman"
"1959","Rutgers (NJ)","6","3","0","0.66667","132","121","11","John R. Stiegman"
"1960","Rutgers (NJ)","8","1","0","0.88889","225","69","156","John F. Bateman"
"1961","Rutgers (NJ)","9","0","0","1","246","102","144","John F. Bateman"
"1962","Rutgers (NJ)","5","5","0","0.5","164","169","-5","John F. Bateman"
"1963","Rutgers (NJ)","3","6","0","0.33333","145","148","-3","John F. Bateman"
"1964","Rutgers (NJ)","6","3","0","0.66667","149","115","34","John F. Bateman"
"1965","Rutgers (NJ)","3","6","0","0.33333","84","152","-68","John F. Bateman"
"1966","Rutgers (NJ)","5","4","0","0.55556","184","177","7","John F. Bateman"
"1967","Rutgers (NJ)","4","5","0","0.44444","155","170","-15","John F. Bateman"
"1968","Rutgers (NJ)","8","2","0","0.8","276","182","94","John F. Bateman"
"1969","Rutgers (NJ)","6","3","0","0.66667","212","150","62","John F. Bateman"
"1970","Rutgers (NJ)","5","5","0","0.5","193","215","-22","John F. Bateman"
"1971","Rutgers (NJ)","4","7","0","0.36364","193","243","-50","John F. Bateman"
"1972","Rutgers (NJ)","7","4","0","0.63636","290","172","118","John F. Bateman"
"1973","Rutgers (NJ)","6","5","0","0.54545","245","208","37","Frank R. Burns"
"1974","Rutgers (NJ)","7","3","1","0.68182","244","146","98","Frank R. Burns"
"1975","Rutgers (NJ)","9","2","0","0.81818","347","91","256","Frank R. Burns"
"1976","Rutgers (NJ)","11","0","0","1","287","81","206","Frank R. Burns"
"1977","Rutgers (NJ)","8","3","0","0.72727","291","181","110","Frank R. Burns"
"1978","Rutgers (NJ)","9","3","0","0.75","284","165","119","Frank R. Burns"
"1979","Rutgers (NJ)","8","3","0","0.72727","243","174","69","Frank R. Burns"
"1980","Rutgers (NJ)","7","4","0","0.63636","279","156","123","Frank R. Burns"
"1981","Rutgers (NJ)","5","6","0","0.45455","139","208","-69","Frank R. Burns"
"1982","Rutgers (NJ)","5","6","0","0.45455","180","278","-98","Frank R. Burns"
"1983","Rutgers (NJ)","3","8","0","0.27273","195","258","-63","Frank R. Burns"
"1984","Rutgers (NJ)","7","3","0","0.7","213","155","58","Dick Anderson"
"1985","Rutgers (NJ)","2","8","1","0.22727","149","266","-117","Dick Anderson"
"1986","Rutgers (NJ)","6","4","1","0.59091","221","189","32","Dick Anderson"
"1987","Rutgers (NJ)","6","5","0","0.54545","168","213","-45","Dick Anderson"
"1988","Rutgers (NJ)","5","6","0","0.45455","273","255","18","Dick Anderson"
"1989","Rutgers (NJ)","2","7","2","0.27273","245","319","-74","Dick Anderson"
"1990","Rutgers (NJ)","3","8","0","0.27273","173","302","-129","Doug Graber"
"1991","Rutgers (NJ)","6","5","0","0.54545","217","217","0","Doug Graber"
"1992","Rutgers (NJ)","7","4","0","0.63636","341","245","96","Doug Graber"
"1993","Rutgers (NJ)","4","7","0","0.36364","351","334","17","Doug Graber"
"1994","Rutgers (NJ)","5","5","1","0.5","241","261","-20","Doug Graber"
"1995","Rutgers (NJ)","4","7","0","0.36364","304","412","-108","Doug Graber"
"1996","Rutgers (NJ)","2","9","0","0.18182","143","380","-237","Terry Shea"
"1997","Rutgers (NJ)","0","11","0","0","191","496","-305","Terry Shea"
"1998","Rutgers (NJ)","5","6","0","0.45455","206","376","-170","Terry Shea"
"1999","Rutgers (NJ)","2","9","0","0.18182","155","427","-272","Terry Shea"
"2000","Rutgers (NJ)","3","8","0","0.27273","233","399","-166","Terry Shea"
"2001","Rutgers (NJ)","2","9","0","0.18182","119","397","-278","Greg Schiano"
"2002","Rutgers (NJ)","1","11","0","0.08333","167","397","-230","Greg Schiano"
"2003","Rutgers (NJ)","5","7","0","0.41667","329","354","-25","Greg Schiano"
"2004","Rutgers (NJ)","4","7","0","0.36364","269","343","-74","Greg Schiano"
"2005","Rutgers (NJ)","7","5","0","0.58333","344","307","37","Greg Schiano"
"2006","Rutgers (NJ)","11","2","0","0.84615","387","186","201","Greg Schiano"
"2007","Rutgers (NJ)","8","5","0","0.61538","426","292","134","Greg Schiano"
"2008","Rutgers (NJ)","8","5","0","0.61538","377","245","132","Greg Schiano"
"2009","Rutgers (NJ)","9","4","0","0.69231","375","233","142","Greg Schiano"
"2010","Rutgers (NJ)","4","8","0","0.33333","250","318","-68","Greg Schiano"
"2011","Rutgers (NJ)","9","4","0","0.69231","343","238","105","Greg Schiano"
"2012","Rutgers (NJ)","9","4","0","0.69231","279","184","95","Kyle Flood"
"2013","Rutgers (NJ)","6","7","0","0.46154","345","387","-42","Kyle Flood"
"2014","Rutgers (NJ)","8","5","0","0.61538","347","392","-45","Kyle Flood"
"1990","San Jose St. (CA)","9","2","1","0.79167","435","228","207","Terry Shea"
"1991","San Jose St. (CA)","6","4","1","0.59091","372","298","74","Terry Shea"
"1992","San Jose St. (CA)","7","4","0","0.63636","330","309","21","Ron Turner"
"1993","San Jose St. (CA)","2","9","0","0.18182","282","337","-55","John Ralston"
"1994","San Jose St. (CA)","3","8","0","0.27273","200","377","-177","John Ralston"
"1995","San Jose St. (CA)","3","8","0","0.27273","271","378","-107","John Ralston"
"1996","San Jose St. (CA)","3","9","0","0.25","221","448","-227","John Ralston"
"1997","San Jose St. (CA)","4","7","0","0.36364","225","387","-162","Dave Baldwin"
"1998","San Jose St. (CA)","4","8","0","0.33333","274","385","-111","Dave Baldwin"
"1999","San Jose St. (CA)","3","7","0","0.3","258","402","-144","Dave Baldwin"
"2000","San Jose St. (CA)","7","5","0","0.58333","374","357","17","Dave Baldwin"
"2001","San Jose St. (CA)","3","9","0","0.25","295","461","-166","Fitz Hill"
"2002","San Jose St. (CA)","6","7","0","0.46154","376","467","-91","Fitz Hill"
"2003","San Jose St. (CA)","3","8","0","0.27273","259","386","-127","Fitz Hill"
"2004","San Jose St. (CA)","2","9","0","0.18182","312","469","-157","Fitz Hill"
"2005","San Jose St. (CA)","3","8","0","0.27273","248","357","-109","Dick Tomey"
"2006","San Jose St. (CA)","9","4","0","0.69231","324","270","54","Dick Tomey"
"2007","San Jose St. (CA)","5","7","0","0.41667","245","352","-107","Dick Tomey"
"2008","San Jose St. (CA)","6","6","0","0.5","224","259","-35","Dick Tomey"
"2009","San Jose St. (CA)","2","10","0","0.16667","165","414","-249","Dick Tomey"
"2010","San Jose St. (CA)","1","12","0","0.07692","209","451","-242","Mike MacIntyre"
"2011","San Jose St. (CA)","5","7","0","0.41667","294","364","-70","Mike MacIntyre"
"2012","San Jose St. (CA)","10","2","0","0.83333","423","257","166","Mike MacIntyre"
"2012","San Jose St. (CA)","1","0","0","1","29","20","9","Kent Baer"
"2013","San Jose St. (CA)","6","6","0","0.5","389","421","-32","Ron Caragher"
"2014","San Jose St. (CA)","3","9","0","0.25","232","353","-121","Ron Caragher"
"2009","South Alabama","7","0","0","1","321","41","280","Joey Jones"
"2010","South Alabama","10","0","0","1","413","130","283","Joey Jones"
"2011","South Alabama","6","4","0","0.6","244","217","27","Joey Jones"
"2012","South Alabama","2","11","0","0.15385","240","383","-143","Joey Jones"
"2013","South Alabama","6","6","0","0.5","353","302","51","Joey Jones"
"2014","South Alabama","6","7","0","0.46154","293","343","-50","Joey Jones"
"1896","South Carolina","1","3","0","0.25","20","30","-10","W.H. ""Dixie"" Whaley"
"1897","South Carolina","0","3","0","0","6","30","-24","W.P. Murphy"
"1898","South Carolina","1","2","0","0.33333","16","35","-19","William ""Bill"" Wertenbaker"
"1899","South Carolina","2","3","0","0.4","22","62","-40","I.O. Hunt"
"1900","South Carolina","4","3","0","0.57143","66","66","0","I.O. Hunt"
"1901","South Carolina","3","4","0","0.42857","85","52","33","Byron W. ""By"" Dickson"
"1902","South Carolina","6","1","0","0.85714","198","16","182","Charles Robert ""Bob"" Williams"
"1903","South Carolina","8","2","0","0.8","239","35","204","Charles Robert ""Bob"" Williams"
"1904","South Carolina","4","3","1","0.5625","100","43","57","Christie Benet"
"1905","South Carolina","4","2","1","0.64286","91","78","13","Christie Benet"
"1908","South Carolina","3","5","1","0.38889","64","103","-39","Christie Benet"
"1909","South Carolina","2","6","0","0.25","36","128","-92","Christie Benet"
"1907","South Carolina","3","0","0","1","30","4","26","Douglas McKay"
"1910","South Carolina","4","4","0","0.5","67","109","-42","John H. Neff"
"1911","South Carolina","1","4","2","0.28571","22","102","-80","John H. Neff"
"1912","South Carolina","5","2","1","0.6875","204","47","157","N.B. ""Red"" Edgerton"
"1913","South Carolina","4","3","0","0.57143","95","122","-27","N.B. ""Red"" Edgerton"
"1914","South Carolina","5","5","1","0.5","168","191","-23","N.B. ""Red"" Edgerton"
"1915","South Carolina","5","3","1","0.61111","190","93","97","N.B. ""Red"" Edgerton"
"1916","South Carolina","2","7","0","0.22222","85","168","-83","Rice Warren"
"1918","South Carolina","2","1","1","0.625","33","51","-18","Frank M. Dobson"
"1917","South Carolina","3","5","0","0.375","137","96","41","Dixon Foster"
"1919","South Carolina","1","7","1","0.16667","25","105","-80","Dixon Foster"
"1920","South Carolina","5","4","0","0.55556","82","140","-58","Sol S. Metzger"
"1921","South Carolina","5","1","2","0.75","116","28","88","Sol S. Metzger"
"1922","South Carolina","5","4","0","0.55556","93","69","24","Sol S. Metzger"
"1923","South Carolina","4","6","0","0.4","104","77","27","Sol S. Metzger"
"1924","South Carolina","7","3","0","0.7","120","48","72","Sol S. Metzger"
"1925","South Carolina","7","3","0","0.7","150","27","123","Branch Bocock"
"1926","South Carolina","6","4","0","0.6","159","62","97","Branch Bocock"
"1927","South Carolina","4","5","0","0.44444","46","172","-126","Harry Lightsey"
"1928","South Carolina","6","2","2","0.7","96","70","26","W.L. ""Billy"" Laval"
"1929","South Carolina","6","5","0","0.54545","163","174","-11","W.L. ""Billy"" Laval"
"1930","South Carolina","6","4","0","0.6","108","123","-15","W.L. ""Billy"" Laval"
"1931","South Carolina","5","4","1","0.55","146","79","67","W.L. ""Billy"" Laval"
"1932","South Carolina","5","4","2","0.54545","93","68","25","W.L. ""Billy"" Laval"
"1933","South Carolina","6","3","1","0.65","111","91","20","W.L. ""Billy"" Laval"
"1934","South Carolina","5","4","0","0.55556","96","71","25","W.L. ""Billy"" Laval"
"1935","South Carolina","3","7","0","0.3","73","187","-114","Don McCallister"
"1936","South Carolina","5","7","0","0.41667","100","139","-39","Don McCallister"
"1937","South Carolina","5","6","1","0.45833","192","166","26","Don McCallister"
"1938","South Carolina","6","4","1","0.59091","168","86","82","Rex Enright"
"1939","South Carolina","3","6","1","0.35","40","163","-123","Rex Enright"
"1940","South Carolina","3","6","0","0.33333","107","146","-39","Rex Enright"
"1941","South Carolina","4","4","1","0.5","100","103","-3","Rex Enright"
"1942","South Carolina","1","7","1","0.16667","46","130","-84","Rex Enright"
"1946","South Carolina","5","3","0","0.625","107","133","-26","Rex Enright"
"1947","South Carolina","6","2","1","0.72222","113","85","28","Rex Enright"
"1948","South Carolina","3","5","0","0.375","106","126","-20","Rex Enright"
"1949","South Carolina","4","6","0","0.4","145","168","-23","Rex Enright"
"1950","South Carolina","3","4","2","0.44444","110","114","-4","Rex Enright"
"1951","South Carolina","5","4","0","0.55556","175","135","40","Rex Enright"
"1952","South Carolina","5","5","0","0.5","175","161","14","Rex Enright"
"1953","South Carolina","7","3","0","0.7","198","97","101","Rex Enright"
"1954","South Carolina","6","4","0","0.6","172","153","19","Rex Enright"
"1955","South Carolina","3","6","0","0.33333","120","209","-89","Rex Enright"
"1943","South Carolina","5","2","0","0.71429","118","56","62","Lt. James P. Moran"
"1944","South Carolina","3","4","2","0.44444","135","106","29","Williams ""Doc"" Newton"
"1945","South Carolina","2","4","3","0.38889","113","192","-79","John D. McMillan"
"1956","South Carolina","7","3","0","0.7","126","67","59","Warren Giese"
"1957","South Carolina","5","5","0","0.5","202","147","55","Warren Giese"
"1958","South Carolina","7","3","0","0.7","168","116","52","Warren Giese"
"1959","South Carolina","6","4","0","0.6","170","169","1","Warren Giese"
"1960","South Carolina","3","6","1","0.35","117","186","-69","Warren Giese"
"1961","South Carolina","4","6","0","0.4","128","187","-59","Marvin Bass"
"1962","South Carolina","4","5","1","0.45","187","148","39","Marvin Bass"
"1963","South Carolina","1","8","1","0.15","104","170","-66","Marvin Bass"
"1964","South Carolina","3","5","2","0.4","95","176","-81","Marvin Bass"
"1965","South Carolina","5","5","0","0.5","151","167","-16","Marvin Bass"
"1966","South Carolina","1","9","0","0.1","95","216","-121","Paul Dietzel"
"1967","South Carolina","5","5","0","0.5","159","166","-7","Paul Dietzel"
"1968","South Carolina","4","6","0","0.4","214","223","-9","Paul Dietzel"
"1969","South Carolina","7","4","0","0.63636","189","195","-6","Paul Dietzel"
"1970","South Carolina","4","6","1","0.40909","285","253","32","Paul Dietzel"
"1971","South Carolina","6","5","0","0.54545","191","196","-5","Paul Dietzel"
"1972","South Carolina","4","7","0","0.36364","214","232","-18","Paul Dietzel"
"1973","South Carolina","7","4","0","0.63636","347","261","86","Paul Dietzel"
"1974","South Carolina","4","7","0","0.36364","223","312","-89","Paul Dietzel"
"1975","South Carolina","7","5","0","0.58333","328","274","54","Jim Carlen"
"1976","South Carolina","6","5","0","0.54545","195","143","52","Jim Carlen"
"1977","South Carolina","5","7","0","0.41667","215","202","13","Jim Carlen"
"1978","South Carolina","5","5","1","0.5","238","181","57","Jim Carlen"
"1979","South Carolina","8","4","0","0.66667","246","205","41","Jim Carlen"
"1980","South Carolina","8","4","0","0.66667","348","200","148","Jim Carlen"
"1981","South Carolina","6","6","0","0.5","225","222","3","Jim Carlen"
"1982","South Carolina","4","7","0","0.36364","224","259","-35","Richard Bell"
"1983","South Carolina","5","6","0","0.45455","231","237","-6","Joe Morrison"
"1984","South Carolina","10","2","0","0.83333","371","258","113","Joe Morrison"
"1985","South Carolina","5","6","0","0.45455","269","290","-21","Joe Morrison"
"1986","South Carolina","3","6","2","0.36364","313","286","27","Joe Morrison"
"1987","South Carolina","8","4","0","0.66667","341","141","200","Joe Morrison"
"1988","South Carolina","8","4","0","0.66667","232","224","8","Joe Morrison"
"1989","South Carolina","6","4","1","0.59091","228","250","-22","Sparky Woods"
"1990","South Carolina","6","5","0","0.54545","282","237","45","Sparky Woods"
"1991","South Carolina","3","6","2","0.36364","250","268","-18","Sparky Woods"
"1992","South Carolina","5","6","0","0.45455","160","240","-80","Sparky Woods"
"1993","South Carolina","5","6","0","0.45455","188","214","-26","Sparky Woods"
"1994","South Carolina","7","5","0","0.58333","300","276","24","Brad Scott"
"1995","South Carolina","4","6","1","0.40909","401","393","8","Brad Scott"
"1996","South Carolina","6","5","0","0.54545","245","238","7","Brad Scott"
"1997","South Carolina","5","6","0","0.45455","258","279","-21","Brad Scott"
"1998","South Carolina","1","10","0","0.09091","207","330","-123","Brad Scott"
"1999","South Carolina","0","11","0","0","87","278","-191","Lou Holtz"
"2000","South Carolina","8","4","0","0.66667","283","181","102","Lou Holtz"
"2001","South Carolina","9","3","0","0.75","310","230","80","Lou Holtz"
"2002","South Carolina","5","7","0","0.41667","225","262","-37","Lou Holtz"
"2003","South Carolina","5","7","0","0.41667","268","314","-46","Lou Holtz"
"2004","South Carolina","6","5","0","0.54545","243","229","14","Lou Holtz"
"2005","South Carolina","7","5","0","0.58333","284","279","5","Steve Spurrier"
"2006","South Carolina","8","5","0","0.61538","346","243","103","Steve Spurrier"
"2007","South Carolina","6","6","0","0.5","313","282","31","Steve Spurrier"
"2008","South Carolina","7","6","0","0.53846","270","274","-4","Steve Spurrier"
"2009","South Carolina","7","6","0","0.53846","268","265","3","Steve Spurrier"
"2010","South Carolina","9","5","0","0.64286","433","324","109","Steve Spurrier"
"2011","South Carolina","11","2","0","0.84615","391","239","152","Steve Spurrier"
"2012","South Carolina","11","2","0","0.84615","410","237","173","Steve Spurrier"
"2013","South Carolina","11","2","0","0.84615","443","264","179","Steve Spurrier"
"2014","South Carolina","7","6","0","0.53846","424","395","29","Steve Spurrier"
"1997","South Florida","5","6","0","0.45455","307","181","126","Jim Leavitt"
"1998","South Florida","8","3","0","0.72727","402","178","224","Jim Leavitt"
"1999","South Florida","7","4","0","0.63636","246","248","-2","Jim Leavitt"
"2000","South Florida","7","4","0","0.63636","278","201","77","Jim Leavitt"
"2001","South Florida","8","3","0","0.72727","387","231","156","Jim Leavitt"
"2002","South Florida","9","2","0","0.81818","339","204","135","Jim Leavitt"
"2003","South Florida","7","4","0","0.63636","276","224","52","Jim Leavitt"
"2004","South Florida","4","7","0","0.36364","271","351","-80","Jim Leavitt"
"2005","South Florida","6","6","0","0.5","276","216","60","Jim Leavitt"
"2006","South Florida","9","4","0","0.69231","299","220","79","Jim Leavitt"
"2007","South Florida","9","4","0","0.69231","451","304","147","Jim Leavitt"
"2008","South Florida","8","5","0","0.61538","359","260","99","Jim Leavitt"
"2009","South Florida","8","5","0","0.61538","344","257","87","Jim Leavitt"
"2010","South Florida","8","5","0","0.61538","313","260","53","Skip Holtz"
"2011","South Florida","5","7","0","0.41667","351","272","79","Skip Holtz"
"2012","South Florida","3","9","0","0.25","247","329","-82","Skip Holtz"
"2013","South Florida","2","10","0","0.16667","165","343","-178","Willie Taggart"
"2014","South Florida","4","8","0","0.33333","206","324","-118","Willie Taggart"
"1888","Southern California","2","0","0","1","20","0","20","Henry H. Goddard & Frank H. Suffel"
"1897","Southern California","5","1","0","0.83333","100","18","82","Lewis R. Freeman"
"1901","Southern California","0","1","0","0","0","6","-6","Clair S. Tappaan"
"1903","Southern California","5","2","0","0.71429","63","27","36","John Walker"
"1904","Southern California","6","1","0","0.85714","199","27","172","Harvey R. Holmes"
"1905","Southern California","6","3","1","0.65","211","45","166","Harvey R. Holmes"
"1906","Southern California","2","0","2","0.75","36","0","36","Harvey R. Holmes"
"1907","Southern California","5","1","0","0.83333","182","20","162","Harvey R. Holmes"
"1908","Southern California","6","1","1","0.8125","183","18","165","William I. ""Bill"" Traeger"
"1909","Southern California","3","1","2","0.66667","133","13","120","Dean B. Cromwell"
"1910","Southern California","7","0","1","0.9375","189","24","165","Dean B. Cromwell"
"1916","Southern California","5","3","0","0.625","129","80","49","Dean B. Cromwell"
"1917","Southern California","4","2","1","0.64286","127","47","80","Dean B. Cromwell"
"1918","Southern California","2","2","2","0.5","61","61","0","Dean B. Cromwell"
"1914","Southern California","4","3","0","0.57143","116","88","28","Ralph Glaze"
"1915","Southern California","3","4","0","0.42857","132","119","13","Ralph Glaze"
"1919","Southern California","4","1","0","0.8","87","21","66","Elmer C. ""Gus"" Henderson"
"1920","Southern California","6","0","0","1","170","21","149","Elmer C. ""Gus"" Henderson"
"1921","Southern California","10","1","0","0.90909","362","52","310","Elmer C. ""Gus"" Henderson"
"1922","Southern California","10","1","0","0.90909","236","31","205","Elmer C. ""Gus"" Henderson"
"1923","Southern California","6","2","0","0.75","173","62","111","Elmer C. ""Gus"" Henderson"
"1924","Southern California","9","2","0","0.81818","269","44","225","Elmer C. ""Gus"" Henderson"
"1925","Southern California","11","2","0","0.84615","456","55","401","Howard H. Jones"
"1926","Southern California","8","2","0","0.8","317","52","265","Howard H. Jones"
"1927","Southern California","8","1","1","0.85","287","64","223","Howard H. Jones"
"1928","Southern California","9","0","1","0.95","267","59","208","Howard H. Jones"
"1929","Southern California","10","2","0","0.83333","492","69","423","Howard H. Jones"
"1930","Southern California","8","2","0","0.8","382","66","316","Howard H. Jones"
"1931","Southern California","10","1","0","0.90909","363","52","311","Howard H. Jones"
"1932","Southern California","10","0","0","1","201","13","188","Howard H. Jones"
"1933","Southern California","10","1","1","0.875","257","30","227","Howard H. Jones"
"1934","Southern California","4","6","1","0.40909","120","110","10","Howard H. Jones"
"1935","Southern California","5","7","0","0.41667","155","124","31","Howard H. Jones"
"1936","Southern California","4","2","3","0.61111","129","65","64","Howard H. Jones"
"1937","Southern California","4","4","2","0.5","136","98","38","Howard H. Jones"
"1938","Southern California","9","2","0","0.81818","172","65","107","Howard H. Jones"
"1939","Southern California","8","0","2","0.9","181","33","148","Howard H. Jones"
"1940","Southern California","3","4","2","0.44444","88","98","-10","Howard H. Jones"
"1941","Southern California","2","6","1","0.27778","64","134","-70","Justin M. ""Sam"" Barry"
"1942","Southern California","5","5","1","0.5","184","128","56","Newell J. ""Jeff"" Cravath"
"1943","Southern California","8","2","0","0.8","155","58","97","Newell J. ""Jeff"" Cravath"
"1944","Southern California","8","0","2","0.9","240","73","167","Newell J. ""Jeff"" Cravath"
"1945","Southern California","7","4","0","0.63636","205","150","55","Newell J. ""Jeff"" Cravath"
"1946","Southern California","6","4","0","0.6","158","106","52","Newell J. ""Jeff"" Cravath"
"1947","Southern California","7","2","1","0.75","193","114","79","Newell J. ""Jeff"" Cravath"
"1948","Southern California","6","3","1","0.65","142","87","55","Newell J. ""Jeff"" Cravath"
"1949","Southern California","5","3","1","0.61111","214","170","44","Newell J. ""Jeff"" Cravath"
"1950","Southern California","2","5","2","0.33333","114","182","-68","Newell J. ""Jeff"" Cravath"
"1951","Southern California","7","3","0","0.7","224","168","56","Jesse T. ""Jess"" Hill"
"1952","Southern California","10","1","0","0.90909","254","47","207","Jesse T. ""Jess"" Hill"
"1953","Southern California","6","3","1","0.65","199","161","38","Jesse T. ""Jess"" Hill"
"1954","Southern California","8","4","0","0.66667","258","159","99","Jesse T. ""Jess"" Hill"
"1955","Southern California","6","4","0","0.6","265","158","107","Jesse T. ""Jess"" Hill"
"1956","Southern California","8","2","0","0.8","218","126","92","Jesse T. ""Jess"" Hill"
"1957","Southern California","1","9","0","0.1","86","204","-118","Don R. Clark"
"1958","Southern California","4","5","1","0.45","151","120","31","Don R. Clark"
"1959","Southern California","8","2","0","0.8","195","90","105","Don R. Clark"
"1960","Southern California","4","6","0","0.4","95","152","-57","John McKay"
"1961","Southern California","4","5","1","0.45","150","167","-17","John McKay"
"1962","Southern California","11","0","0","1","261","92","169","John McKay"
"1963","Southern California","7","3","0","0.7","207","114","93","John McKay"
"1964","Southern California","7","3","0","0.7","207","130","77","John McKay"
"1965","Southern California","7","2","1","0.75","262","92","170","John McKay"
"1966","Southern California","7","4","0","0.63636","199","128","71","John McKay"
"1967","Southern California","10","1","0","0.90909","258","87","171","John McKay"
"1968","Southern California","9","1","1","0.86364","259","168","91","John McKay"
"1969","Southern California","10","0","1","0.95455","261","128","133","John McKay"
"1970","Southern California","6","4","1","0.59091","343","233","110","John McKay"
"1971","Southern California","6","4","1","0.59091","229","164","65","John McKay"
"1972","Southern California","12","0","0","1","467","134","333","John McKay"
"1973","Southern California","9","2","1","0.79167","322","202","120","John McKay"
"1974","Southern California","10","1","1","0.875","363","142","221","John McKay"
"1975","Southern California","8","4","0","0.66667","247","140","107","John McKay"
"1976","Southern California","11","1","0","0.91667","386","139","247","John Robinson (1)"
"1977","Southern California","8","4","0","0.66667","357","212","145","John Robinson (1)"
"1978","Southern California","12","1","0","0.92308","318","153","165","John Robinson (1)"
"1979","Southern California","11","0","1","0.95833","389","171","218","John Robinson (1)"
"1980","Southern California","8","2","1","0.77273","265","134","131","John Robinson (1)"
"1981","Southern California","9","3","0","0.75","294","170","124","John Robinson (1)"
"1982","Southern California","8","3","0","0.72727","302","143","159","John Robinson (1)"
"1993","Southern California","8","5","0","0.61538","348","252","96","John Robinson (1)"
"1994","Southern California","8","3","1","0.70833","356","243","113","John Robinson (1)"
"1995","Southern California","9","2","1","0.79167","355","212","143","John Robinson (1)"
"1996","Southern California","6","6","0","0.5","325","267","58","John Robinson (1)"
"1997","Southern California","6","5","0","0.54545","233","233","0","John Robinson (1)"
"1983","Southern California","4","6","1","0.40909","210","238","-28","Ted Tollner"
"1984","Southern California","9","3","0","0.75","220","173","47","Ted Tollner"
"1985","Southern California","6","6","0","0.5","223","187","36","Ted Tollner"
"1986","Southern California","7","5","0","0.58333","264","239","25","Ted Tollner"
"1987","Southern California","8","4","0","0.66667","321","229","92","Larry Smith"
"1988","Southern California","10","2","0","0.83333","370","184","186","Larry Smith"
"1989","Southern California","9","2","1","0.79167","336","132","204","Larry Smith"
"1990","Southern California","8","4","1","0.65385","348","274","74","Larry Smith"
"1991","Southern California","3","8","0","0.27273","229","276","-47","Larry Smith"
"1992","Southern California","6","5","1","0.54167","264","249","15","Larry Smith"
"1998","Southern California","8","5","0","0.61538","346","241","105","Paul Hackett"
"1999","Southern California","7","5","0","0.58333","348","278","70","Paul Hackett"
"2000","Southern California","5","7","0","0.41667","309","337","-28","Paul Hackett"
"2001","Southern California","6","6","0","0.5","298","207","91","Pete Carroll"
"2002","Southern California","11","2","0","0.84615","465","240","225","Pete Carroll"
"2003","Southern California","12","1","0","0.92308","534","239","295","Pete Carroll"
"2004","Southern California","11","0","0","1","496","169","327","Pete Carroll"
"2005","Southern California","0","1","0","0","638","297","341","Pete Carroll"
"2006","Southern California","11","2","0","0.84615","396","197","199","Pete Carroll"
"2007","Southern California","11","2","0","0.84615","424","208","216","Pete Carroll"
"2008","Southern California","12","1","0","0.92308","488","117","371","Pete Carroll"
"2009","Southern California","9","4","0","0.69231","344","258","86","Pete Carroll"
"2010","Southern California","8","5","0","0.61538","403","347","56","Lane Kiffin"
"2011","Southern California","10","2","0","0.83333","429","283","146","Lane Kiffin"
"2012","Southern California","7","6","0","0.53846","417","316","101","Lane Kiffin"
"2013","Southern California","3","2","0","0.6","130","106","24","Lane Kiffin"
"2013","Southern California","1","0","0","1","45","20","25","Clay Helton"
"2013","Southern California","6","2","0","0.75","241","171","70","Ed Orgeron"
"2014","Southern California","9","4","0","0.69231","466","327","139","Steve Sarkisian"
"1917","Southern Methodist (TX)","3","2","3","0.5625","74","49","25","J. Burton Rix"
"1918","Southern Methodist (TX)","4","3","0","0.57143","40","46","-6","J. Burton Rix"
"1919","Southern Methodist (TX)","5","4","1","0.55","162","86","76","J. Burton Rix"
"1920","Southern Methodist (TX)","3","5","2","0.4","125","90","35","J. Burton Rix"
"1921","Southern Methodist (TX)","1","6","1","0.1875","15","92","-77","William A. ""Bill"" Cunningham, Victor M. ""Choctaw"" Kelly, & J. Burton Rix"
"1922","Southern Methodist (TX)","6","3","1","0.65","235","68","167","Ewing Y. Freeland & J. Ray Morrison"
"1923","Southern Methodist (TX)","9","0","0","1","207","9","198","Ewing Y. Freeland & J. Ray Morrison"
"1915","Southern Methodist (TX)","2","5","0","0.28571","20","131","-111","J. Ray Morrison"
"1916","Southern Methodist (TX)","0","8","2","0.1","27","455","-428","J. Ray Morrison"
"1924","Southern Methodist (TX)","5","1","4","0.7","92","62","30","J. Ray Morrison"
"1925","Southern Methodist (TX)","5","2","2","0.66667","148","41","107","J. Ray Morrison"
"1926","Southern Methodist (TX)","8","0","1","0.94444","229","47","182","J. Ray Morrison"
"1927","Southern Methodist (TX)","7","2","0","0.77778","267","81","186","J. Ray Morrison"
"1928","Southern Methodist (TX)","6","3","1","0.65","254","78","176","J. Ray Morrison"
"1929","Southern Methodist (TX)","6","0","4","0.8","172","36","136","J. Ray Morrison"
"1930","Southern Methodist (TX)","6","3","1","0.65","187","93","94","J. Ray Morrison"
"1931","Southern Methodist (TX)","9","1","1","0.86364","160","48","112","J. Ray Morrison"
"1932","Southern Methodist (TX)","3","7","2","0.33333","82","112","-30","J. Ray Morrison"
"1933","Southern Methodist (TX)","4","7","1","0.375","99","104","-5","J. Ray Morrison"
"1934","Southern Methodist (TX)","8","2","2","0.75","224","63","161","J. Ray Morrison"
"1935","Southern Methodist (TX)","12","1","0","0.92308","288","39","249","Madison A. ""Matty"" Bell"
"1936","Southern Methodist (TX)","5","4","1","0.55","119","66","53","Madison A. ""Matty"" Bell"
"1937","Southern Methodist (TX)","5","6","0","0.45455","93","83","10","Madison A. ""Matty"" Bell"
"1938","Southern Methodist (TX)","6","4","0","0.6","148","125","23","Madison A. ""Matty"" Bell"
"1939","Southern Methodist (TX)","6","3","1","0.65","118","60","58","Madison A. ""Matty"" Bell"
"1940","Southern Methodist (TX)","8","1","1","0.85","142","75","67","Madison A. ""Matty"" Bell"
"1941","Southern Methodist (TX)","5","5","0","0.5","169","106","63","Madison A. ""Matty"" Bell"
"1945","Southern Methodist (TX)","5","6","0","0.45455","201","110","91","Madison A. ""Matty"" Bell"
"1946","Southern Methodist (TX)","4","5","1","0.45","114","100","14","Madison A. ""Matty"" Bell"
"1947","Southern Methodist (TX)","9","0","2","0.90909","182","90","92","Madison A. ""Matty"" Bell"
"1948","Southern Methodist (TX)","9","1","1","0.86364","250","105","145","Madison A. ""Matty"" Bell"
"1949","Southern Methodist (TX)","5","4","1","0.55","215","204","11","Madison A. ""Matty"" Bell"
"1942","Southern Methodist (TX)","3","6","2","0.36364","126","133","-7","James H. ""Jimmy"" Stewart"
"1943","Southern Methodist (TX)","2","7","0","0.22222","69","115","-46","James H. ""Jimmy"" Stewart"
"1944","Southern Methodist (TX)","5","5","0","0.5","131","201","-70","James H. ""Jimmy"" Stewart"
"1950","Southern Methodist (TX)","6","4","0","0.6","251","146","105","Harvey N. ""Rusty"" Russell"
"1951","Southern Methodist (TX)","3","6","1","0.35","164","144","20","Harvey N. ""Rusty"" Russell"
"1952","Southern Methodist (TX)","4","5","1","0.45","136","163","-27","Harvey N. ""Rusty"" Russell"
"1953","Southern Methodist (TX)","5","5","0","0.5","128","129","-1","Chalmer E. ""Woody"" Woodard"
"1954","Southern Methodist (TX)","6","3","1","0.65","184","135","49","Chalmer E. ""Woody"" Woodard"
"1955","Southern Methodist (TX)","4","6","0","0.4","118","115","3","Chalmer E. ""Woody"" Woodard"
"1956","Southern Methodist (TX)","4","6","0","0.4","125","202","-77","Chalmer E. ""Woody"" Woodard"
"1957","Southern Methodist (TX)","4","5","1","0.45","127","175","-48","William M. ""Bill"" Meek"
"1958","Southern Methodist (TX)","6","4","0","0.6","203","134","69","William M. ""Bill"" Meek"
"1959","Southern Methodist (TX)","5","4","1","0.55","147","133","14","William M. ""Bill"" Meek"
"1960","Southern Methodist (TX)","0","9","1","0.05","31","221","-190","William M. ""Bill"" Meek"
"1961","Southern Methodist (TX)","2","7","1","0.25","92","191","-99","William M. ""Bill"" Meek"
"1962","Southern Methodist (TX)","2","8","0","0.2","88","130","-42","Hayden Fry"
"1963","Southern Methodist (TX)","4","7","0","0.36364","141","175","-34","Hayden Fry"
"1964","Southern Methodist (TX)","1","9","0","0.1","55","177","-122","Hayden Fry"
"1965","Southern Methodist (TX)","4","5","1","0.45","123","167","-44","Hayden Fry"
"1966","Southern Methodist (TX)","8","3","0","0.72727","210","170","40","Hayden Fry"
"1967","Southern Methodist (TX)","3","7","0","0.3","135","214","-79","Hayden Fry"
"1968","Southern Methodist (TX)","8","3","0","0.72727","311","273","38","Hayden Fry"
"1969","Southern Methodist (TX)","3","7","0","0.3","186","230","-44","Hayden Fry"
"1970","Southern Methodist (TX)","5","6","0","0.45455","153","228","-75","Hayden Fry"
"1971","Southern Methodist (TX)","4","7","0","0.36364","151","227","-76","Hayden Fry"
"1972","Southern Methodist (TX)","7","4","0","0.63636","269","154","115","Hayden Fry"
"1973","Southern Methodist (TX)","6","4","1","0.59091","259","228","31","Dave Smith (1)"
"1974","Southern Methodist (TX)","6","4","1","0.59091","221","240","-19","Dave Smith (1)"
"1975","Southern Methodist (TX)","4","7","0","0.36364","208","301","-93","Dave Smith (1)"
"1976","Southern Methodist (TX)","3","8","0","0.27273","202","339","-137","Ron Meyer"
"1977","Southern Methodist (TX)","4","7","0","0.36364","226","319","-93","Ron Meyer"
"1978","Southern Methodist (TX)","4","6","1","0.40909","300","251","49","Ron Meyer"
"1979","Southern Methodist (TX)","5","6","0","0.45455","226","236","-10","Ron Meyer"
"1980","Southern Methodist (TX)","8","4","0","0.66667","324","192","132","Ron Meyer"
"1981","Southern Methodist (TX)","10","1","0","0.90909","365","137","228","Ron Meyer"
"1982","Southern Methodist (TX)","11","0","1","0.95833","354","160","194","Bobby Collins"
"1983","Southern Methodist (TX)","10","2","0","0.83333","274","137","137","Bobby Collins"
"1984","Southern Methodist (TX)","10","2","0","0.83333","328","198","130","Bobby Collins"
"1985","Southern Methodist (TX)","6","5","0","0.54545","280","211","69","Bobby Collins"
"1986","Southern Methodist (TX)","6","5","0","0.54545","245","282","-37","Bobby Collins"
"1989","Southern Methodist (TX)","2","9","0","0.18182","187","499","-312","Forrest Gregg"
"1990","Southern Methodist (TX)","1","10","0","0.09091","197","426","-229","Forrest Gregg"
"1991","Southern Methodist (TX)","1","10","0","0.09091","141","359","-218","Tom Rossley"
"1992","Southern Methodist (TX)","5","6","0","0.45455","212","276","-64","Tom Rossley"
"1993","Southern Methodist (TX)","2","7","2","0.27273","206","277","-71","Tom Rossley"
"1994","Southern Methodist (TX)","1","9","1","0.13636","197","343","-146","Tom Rossley"
"1995","Southern Methodist (TX)","1","10","0","0.09091","132","352","-220","Tom Rossley"
"1996","Southern Methodist (TX)","5","6","0","0.45455","246","267","-21","Tom Rossley"
"1997","Southern Methodist (TX)","6","5","0","0.54545","247","237","10","Mike Cavan"
"1998","Southern Methodist (TX)","5","7","0","0.41667","225","248","-23","Mike Cavan"
"1999","Southern Methodist (TX)","4","6","0","0.4","193","235","-42","Mike Cavan"
"2000","Southern Methodist (TX)","3","9","0","0.25","181","352","-171","Mike Cavan"
"2001","Southern Methodist (TX)","4","7","0","0.36364","226","295","-69","Mike Cavan"
"2002","Southern Methodist (TX)","3","9","0","0.25","207","378","-171","Phil Bennett"
"2003","Southern Methodist (TX)","0","12","0","0","134","386","-252","Phil Bennett"
"2004","Southern Methodist (TX)","3","8","0","0.27273","202","420","-218","Phil Bennett"
"2005","Southern Methodist (TX)","5","6","0","0.45455","229","280","-51","Phil Bennett"
"2006","Southern Methodist (TX)","6","6","0","0.5","325","294","31","Phil Bennett"
"2007","Southern Methodist (TX)","1","11","0","0.08333","340","477","-137","Phil Bennett"
"2008","Southern Methodist (TX)","1","11","0","0.08333","256","458","-202","June Jones"
"2009","Southern Methodist (TX)","8","5","0","0.61538","380","359","21","June Jones"
"2010","Southern Methodist (TX)","7","7","0","0.5","360","359","1","June Jones"
"2011","Southern Methodist (TX)","8","5","0","0.61538","336","300","36","June Jones"
"2012","Southern Methodist (TX)","7","6","0","0.53846","397","334","63","June Jones"
"2013","Southern Methodist (TX)","5","7","0","0.41667","321","400","-79","June Jones"
"2014","Southern Methodist (TX)","0","2","0","0","6","88","-82","June Jones"
"2014","Southern Methodist (TX)","1","9","0","0.1","127","408","-281","Tom Mason"
"1912","Southern Mississippi","2","1","0","0.66667","36","6","30","Ronald J. Slay"
"1913","Southern Mississippi","1","5","1","0.21429","24","82","-58","M.J. ""Blondie"" Williams"
"1914","Southern Mississippi","2","3","1","0.41667","46","86","-40","A.B. Dillie"
"1915","Southern Mississippi","4","4","0","0.5","114","103","11","A.B. Dillie"
"1916","Southern Mississippi","0","3","0","0","0","193","-193","A.B. Dillie"
"1919","Southern Mississippi","4","1","2","0.71429","100","31","69","Cephus Allen Anderson"
"1920","Southern Mississippi","5","2","1","0.6875","182","82","100","B.B. O'Mara"
"1921","Southern Mississippi","3","4","0","0.42857","183","141","42","O.V. ""Spout"" Austin"
"1922","Southern Mississippi","2","6","0","0.25","63","122","-59","O.V. ""Spout"" Austin"
"1923","Southern Mississippi","3","3","0","0.5","90","104","-14","O.V. ""Spout"" Austin"
"1924","Southern Mississippi","3","3","2","0.5","94","152","-58","William Herschel Bobo"
"1925","Southern Mississippi","0","7","0","0","19","207","-188","William Herschel Bobo"
"1926","Southern Mississippi","3","4","1","0.4375","77","129","-52","William Herschel Bobo"
"1927","Southern Mississippi","3","4","1","0.4375","52","98","-46","William Herschel Bobo"
"1928","Southern Mississippi","4","5","0","0.44444","62","234","-172","William B. Saunders"
"1929","Southern Mississippi","2","6","1","0.27778","74","104","-30","William B. Saunders"
"1930","Southern Mississippi","3","5","1","0.38889","162","117","45","John Lumpkin"
"1931","Southern Mississippi","2","5","0","0.28571","67","124","-57","Allison T.S. ""Pooley"" Hubert"
"1932","Southern Mississippi","5","4","0","0.55556","80","158","-78","Allison T.S. ""Pooley"" Hubert"
"1933","Southern Mississippi","3","5","2","0.4","67","180","-113","Allison T.S. ""Pooley"" Hubert"
"1934","Southern Mississippi","3","4","2","0.44444","63","109","-46","Allison T.S. ""Pooley"" Hubert"
"1935","Southern Mississippi","6","4","0","0.6","101","112","-11","Allison T.S. ""Pooley"" Hubert"
"1936","Southern Mississippi","7","2","1","0.75","137","54","83","Allison T.S. ""Pooley"" Hubert"
"1937","Southern Mississippi","7","3","0","0.7","222","24","198","Reed Green"
"1938","Southern Mississippi","7","2","0","0.77778","203","26","177","Reed Green"
"1939","Southern Mississippi","4","2","3","0.61111","77","67","10","Reed Green"
"1940","Southern Mississippi","7","4","0","0.63636","220","80","140","Reed Green"
"1941","Southern Mississippi","9","0","1","0.95","246","40","206","Reed Green"
"1942","Southern Mississippi","4","0","0","1","142","7","135","Reed Green"
"1946","Southern Mississippi","7","3","0","0.7","243","52","191","Reed Green"
"1947","Southern Mississippi","7","3","0","0.7","154","102","52","Reed Green"
"1948","Southern Mississippi","7","3","0","0.7","277","127","150","Reed Green"
"1949","Southern Mississippi","7","3","0","0.7","299","274","25","Thad ""Pie"" Vann"
"1950","Southern Mississippi","5","5","0","0.5","134","233","-99","Thad ""Pie"" Vann"
"1951","Southern Mississippi","6","5","0","0.54545","306","132","174","Thad ""Pie"" Vann"
"1952","Southern Mississippi","10","2","0","0.83333","409","189","220","Thad ""Pie"" Vann"
"1953","Southern Mississippi","9","2","0","0.81818","280","122","158","Thad ""Pie"" Vann"
"1954","Southern Mississippi","6","4","0","0.6","172","103","69","Thad ""Pie"" Vann"
"1955","Southern Mississippi","9","1","0","0.9","277","49","228","Thad ""Pie"" Vann"
"1956","Southern Mississippi","7","2","1","0.75","219","92","127","Thad ""Pie"" Vann"
"1957","Southern Mississippi","8","3","0","0.72727","152","72","80","Thad ""Pie"" Vann"
"1958","Southern Mississippi","9","0","0","1","210","55","155","Thad ""Pie"" Vann"
"1959","Southern Mississippi","6","4","0","0.6","171","122","49","Thad ""Pie"" Vann"
"1960","Southern Mississippi","6","4","0","0.6","189","96","93","Thad ""Pie"" Vann"
"1961","Southern Mississippi","8","2","0","0.8","183","68","115","Thad ""Pie"" Vann"
"1962","Southern Mississippi","9","1","0","0.9","265","67","198","Thad ""Pie"" Vann"
"1963","Southern Mississippi","5","3","1","0.61111","128","64","64","Thad ""Pie"" Vann"
"1964","Southern Mississippi","6","3","0","0.66667","143","144","-1","Thad ""Pie"" Vann"
"1965","Southern Mississippi","7","2","0","0.77778","127","60","67","Thad ""Pie"" Vann"
"1966","Southern Mississippi","6","4","0","0.6","156","103","53","Thad ""Pie"" Vann"
"1967","Southern Mississippi","6","3","0","0.66667","201","114","87","Thad ""Pie"" Vann"
"1968","Southern Mississippi","4","6","0","0.4","228","231","-3","Thad ""Pie"" Vann"
"1969","Southern Mississippi","5","5","0","0.5","162","307","-145","P.W. ""Bear"" Underwood"
"1970","Southern Mississippi","5","6","0","0.45455","228","299","-71","P.W. ""Bear"" Underwood"
"1971","Southern Mississippi","6","5","0","0.54545","202","192","10","P.W. ""Bear"" Underwood"
"1972","Southern Mississippi","3","7","1","0.31818","182","231","-49","P.W. ""Bear"" Underwood"
"1973","Southern Mississippi","6","4","1","0.59091","227","166","61","P.W. ""Bear"" Underwood"
"1974","Southern Mississippi","6","5","0","0.54545","160","195","-35","P.W. ""Bear"" Underwood"
"1975","Southern Mississippi","8","3","0","0.72727","279","129","150","Bobby Collins"
"1976","Southern Mississippi","3","8","0","0.27273","145","296","-151","Bobby Collins"
"1977","Southern Mississippi","6","6","0","0.5","215","250","-35","Bobby Collins"
"1978","Southern Mississippi","7","4","0","0.63636","213","185","28","Bobby Collins"
"1979","Southern Mississippi","6","4","1","0.59091","228","146","82","Bobby Collins"
"1980","Southern Mississippi","9","3","0","0.75","290","183","107","Bobby Collins"
"1981","Southern Mississippi","9","2","1","0.79167","305","108","197","Bobby Collins"
"1982","Southern Mississippi","7","4","0","0.63636","304","180","124","Jim Carmody"
"1983","Southern Mississippi","7","4","0","0.63636","235","128","107","Jim Carmody"
"1984","Southern Mississippi","4","7","0","0.36364","188","243","-55","Jim Carmody"
"1985","Southern Mississippi","7","4","0","0.63636","255","159","96","Jim Carmody"
"1986","Southern Mississippi","6","5","0","0.54545","198","252","-54","Jim Carmody"
"1987","Southern Mississippi","6","5","0","0.54545","270","296","-26","Jim Carmody"
"1988","Southern Mississippi","10","2","0","0.83333","353","284","69","Curley Hallman"
"1989","Southern Mississippi","5","6","0","0.45455","240","252","-12","Curley Hallman"
"1990","Southern Mississippi","8","3","0","0.72727","193","141","52","Curley Hallman"
"1990","Southern Mississippi","0","1","0","0","27","31","-4","Jeff Bower"
"1991","Southern Mississippi","4","7","0","0.36364","212","225","-13","Jeff Bower"
"1992","Southern Mississippi","7","4","0","0.63636","219","195","24","Jeff Bower"
"1993","Southern Mississippi","3","7","1","0.31818","214","311","-97","Jeff Bower"
"1994","Southern Mississippi","6","5","0","0.54545","278","261","17","Jeff Bower"
"1995","Southern Mississippi","6","5","0","0.54545","284","241","43","Jeff Bower"
"1996","Southern Mississippi","8","3","0","0.72727","287","247","40","Jeff Bower"
"1997","Southern Mississippi","9","3","0","0.75","337","210","127","Jeff Bower"
"1998","Southern Mississippi","7","5","0","0.58333","384","238","146","Jeff Bower"
"1999","Southern Mississippi","9","3","0","0.75","333","189","144","Jeff Bower"
"2000","Southern Mississippi","8","4","0","0.66667","314","203","111","Jeff Bower"
"2001","Southern Mississippi","6","5","0","0.54545","278","186","92","Jeff Bower"
"2002","Southern Mississippi","7","6","0","0.53846","282","238","44","Jeff Bower"
"2003","Southern Mississippi","9","4","0","0.69231","293","226","67","Jeff Bower"
"2004","Southern Mississippi","7","5","0","0.58333","309","298","11","Jeff Bower"
"2005","Southern Mississippi","7","5","0","0.58333","355","272","83","Jeff Bower"
"2006","Southern Mississippi","9","5","0","0.64286","356","260","96","Jeff Bower"
"2007","Southern Mississippi","7","6","0","0.53846","361","314","47","Jeff Bower"
"2008","Southern Mississippi","7","6","0","0.53846","398","313","85","Larry Fedora"
"2009","Southern Mississippi","7","6","0","0.53846","428","336","92","Larry Fedora"
"2010","Southern Mississippi","8","5","0","0.61538","479","384","95","Larry Fedora"
"2011","Southern Mississippi","12","2","0","0.85714","516","291","225","Larry Fedora"
"2012","Southern Mississippi","0","12","0","0","236","454","-218","Ellis Johnson"
"2013","Southern Mississippi","1","11","0","0.08333","205","503","-298","Todd Monken"
"2014","Southern Mississippi","3","9","0","0.25","228","425","-197","Todd Monken"
"1893","Stanford (CA)","9","0","1","0.95","290","17","273","Clifford Douglas ""Pop"" Bliss"
"1894","Stanford (CA)","6","3","0","0.66667","100","58","42","Walter C. Camp"
"1895","Stanford (CA)","4","0","1","0.9","34","8","26","Walter C. Camp"
"1897","Stanford (CA)","4","1","0","0.8","54","26","28","George H. Brooke"
"1896","Stanford (CA)","2","1","1","0.625","40","4","36","Harry P. Cross"
"1898","Stanford (CA)","5","3","1","0.61111","93","62","31","Harry P. Cross"
"1899","Stanford (CA)","2","5","2","0.33333","61","78","-17","B.C. ""Burr"" Chamberlain"
"1900","Stanford (CA)","7","2","1","0.75","154","20","134","Fielding H. ""Hurry Up"" Yost"
"1901","Stanford (CA)","3","2","2","0.57143","34","57","-23","C.M. Fickert"
"1902","Stanford (CA)","6","1","0","0.85714","111","37","74","Carl L. Clemans"
"1903","Stanford (CA)","8","0","3","0.86364","199","6","193","James F. Lanagan"
"1904","Stanford (CA)","7","2","1","0.75","206","10","196","James F. Lanagan"
"1905","Stanford (CA)","8","0","0","1","138","13","125","James F. Lanagan"
"1919","Stanford (CA)","4","3","0","0.57143","130","46","84","Melbourne ""Bob"" Evans"
"1920","Stanford (CA)","4","3","0","0.57143","82","65","17","Walter D. Powell"
"1921","Stanford (CA)","4","2","2","0.625","100","97","3","Conrad Eugene Van Gent"
"1922","Stanford (CA)","4","5","0","0.44444","63","96","-33","Andrew ""Andy"" Kerr"
"1923","Stanford (CA)","7","2","0","0.77778","284","46","238","Andrew ""Andy"" Kerr"
"1924","Stanford (CA)","7","1","1","0.83333","179","69","110","Glenn Scobey ""Pop"" Warner"
"1925","Stanford (CA)","7","2","0","0.77778","231","71","160","Glenn Scobey ""Pop"" Warner"
"1926","Stanford (CA)","10","0","1","0.95455","268","86","182","Glenn Scobey ""Pop"" Warner"
"1927","Stanford (CA)","8","2","1","0.77273","151","75","76","Glenn Scobey ""Pop"" Warner"
"1928","Stanford (CA)","8","3","1","0.70833","274","69","205","Glenn Scobey ""Pop"" Warner"
"1929","Stanford (CA)","9","2","0","0.81818","288","53","235","Glenn Scobey ""Pop"" Warner"
"1930","Stanford (CA)","9","1","1","0.86364","252","69","183","Glenn Scobey ""Pop"" Warner"
"1931","Stanford (CA)","7","2","2","0.72727","160","44","116","Glenn Scobey ""Pop"" Warner"
"1932","Stanford (CA)","6","4","1","0.59091","171","58","113","Glenn Scobey ""Pop"" Warner"
"1933","Stanford (CA)","8","2","1","0.77273","131","43","88","Claude E. ""Tiny"" Thornhill"
"1934","Stanford (CA)","9","1","1","0.86364","224","43","181","Claude E. ""Tiny"" Thornhill"
"1935","Stanford (CA)","8","1","0","0.88889","121","13","108","Claude E. ""Tiny"" Thornhill"
"1936","Stanford (CA)","2","5","2","0.33333","80","109","-29","Claude E. ""Tiny"" Thornhill"
"1937","Stanford (CA)","4","3","2","0.55556","68","53","15","Claude E. ""Tiny"" Thornhill"
"1938","Stanford (CA)","3","6","0","0.33333","67","92","-25","Claude E. ""Tiny"" Thornhill"
"1939","Stanford (CA)","1","7","1","0.16667","54","146","-92","Claude E. ""Tiny"" Thornhill"
"1940","Stanford (CA)","10","0","0","1","196","85","111","Clark D. Shaughnessy"
"1941","Stanford (CA)","6","3","0","0.66667","160","95","65","Clark D. Shaughnessy"
"1942","Stanford (CA)","6","4","0","0.6","204","121","83","Marchmont H. ""Marchy"" Schwartz"
"1946","Stanford (CA)","6","3","1","0.65","222","147","75","Marchmont H. ""Marchy"" Schwartz"
"1947","Stanford (CA)","0","9","0","0","73","214","-141","Marchmont H. ""Marchy"" Schwartz"
"1948","Stanford (CA)","4","6","0","0.4","164","159","5","Marchmont H. ""Marchy"" Schwartz"
"1949","Stanford (CA)","7","3","1","0.68182","366","121","245","Marchmont H. ""Marchy"" Schwartz"
"1950","Stanford (CA)","5","3","2","0.6","188","124","64","Marchmont H. ""Marchy"" Schwartz"
"1951","Stanford (CA)","9","2","0","0.81818","229","181","48","Charles A. ""Chuck"" Taylor"
"1952","Stanford (CA)","5","5","0","0.5","187","226","-39","Charles A. ""Chuck"" Taylor"
"1953","Stanford (CA)","6","3","1","0.65","246","148","98","Charles A. ""Chuck"" Taylor"
"1954","Stanford (CA)","4","6","0","0.4","123","229","-106","Charles A. ""Chuck"" Taylor"
"1955","Stanford (CA)","6","3","1","0.65","198","135","63","Charles A. ""Chuck"" Taylor"
"1956","Stanford (CA)","4","6","0","0.4","218","213","5","Charles A. ""Chuck"" Taylor"
"1957","Stanford (CA)","6","4","0","0.6","227","158","69","Charles A. ""Chuck"" Taylor"
"1958","Stanford (CA)","2","8","0","0.2","93","226","-133","Jack C. Curtice"
"1959","Stanford (CA)","3","7","0","0.3","232","261","-29","Jack C. Curtice"
"1960","Stanford (CA)","0","10","0","0","111","254","-143","Jack C. Curtice"
"1961","Stanford (CA)","4","6","0","0.4","105","163","-58","Jack C. Curtice"
"1962","Stanford (CA)","5","5","0","0.5","124","174","-50","Jack C. Curtice"
"1963","Stanford (CA)","3","7","0","0.3","154","199","-45","John Ralston"
"1964","Stanford (CA)","5","5","0","0.5","150","138","12","John Ralston"
"1965","Stanford (CA)","6","3","1","0.65","144","149","-5","John Ralston"
"1966","Stanford (CA)","5","5","0","0.5","149","146","3","John Ralston"
"1967","Stanford (CA)","5","5","0","0.5","157","179","-22","John Ralston"
"1968","Stanford (CA)","6","3","1","0.65","268","162","106","John Ralston"
"1969","Stanford (CA)","7","2","1","0.75","349","172","177","John Ralston"
"1970","Stanford (CA)","9","3","0","0.75","343","206","137","John Ralston"
"1971","Stanford (CA)","9","3","0","0.75","261","135","126","John Ralston"
"1972","Stanford (CA)","6","5","0","0.54545","266","183","83","Jack Christiansen"
"1973","Stanford (CA)","7","4","0","0.63636","244","240","4","Jack Christiansen"
"1974","Stanford (CA)","5","4","2","0.54545","197","228","-31","Jack Christiansen"
"1975","Stanford (CA)","6","4","1","0.59091","322","279","43","Jack Christiansen"
"1976","Stanford (CA)","6","5","0","0.54545","239","284","-45","Jack Christiansen"
"1977","Stanford (CA)","9","3","0","0.75","285","279","6","Bill Walsh"
"1978","Stanford (CA)","8","4","0","0.66667","326","221","105","Bill Walsh"
"1992","Stanford (CA)","10","3","0","0.76923","320","196","124","Bill Walsh"
"1993","Stanford (CA)","4","7","0","0.36364","291","389","-98","Bill Walsh"
"1994","Stanford (CA)","3","7","1","0.31818","327","359","-32","Bill Walsh"
"1979","Stanford (CA)","5","5","1","0.5","259","239","20","Rod Dowhower"
"1980","Stanford (CA)","6","5","0","0.54545","312","275","37","Paul Wiggin"
"1981","Stanford (CA)","4","7","0","0.36364","314","281","33","Paul Wiggin"
"1982","Stanford (CA)","5","6","0","0.45455","328","297","31","Paul Wiggin"
"1983","Stanford (CA)","1","10","0","0.09091","159","293","-134","Paul Wiggin"
"1984","Stanford (CA)","5","6","0","0.45455","239","279","-40","Jack Elway"
"1985","Stanford (CA)","4","7","0","0.36364","245","313","-68","Jack Elway"
"1986","Stanford (CA)","8","4","0","0.66667","279","191","88","Jack Elway"
"1987","Stanford (CA)","5","6","0","0.45455","262","268","-6","Jack Elway"
"1988","Stanford (CA)","3","6","2","0.36364","238","216","22","Jack Elway"
"1989","Stanford (CA)","3","8","0","0.27273","187","258","-71","Dennis Green"
"1990","Stanford (CA)","5","6","0","0.45455","263","284","-21","Dennis Green"
"1991","Stanford (CA)","8","4","0","0.66667","368","246","122","Dennis Green"
"1995","Stanford (CA)","7","4","1","0.625","344","307","37","Tyrone ""Ty"" Willingham"
"1996","Stanford (CA)","7","5","0","0.58333","247","229","18","Tyrone ""Ty"" Willingham"
"1997","Stanford (CA)","5","6","0","0.45455","276","317","-41","Tyrone ""Ty"" Willingham"
"1998","Stanford (CA)","3","8","0","0.27273","261","365","-104","Tyrone ""Ty"" Willingham"
"1999","Stanford (CA)","8","4","0","0.66667","418","364","54","Tyrone ""Ty"" Willingham"
"2000","Stanford (CA)","5","6","0","0.45455","261","294","-33","Tyrone ""Ty"" Willingham"
"2001","Stanford (CA)","9","3","0","0.75","422","339","83","Tyrone ""Ty"" Willingham"
"2002","Stanford (CA)","2","9","0","0.18182","225","377","-152","Eugene ""Buddy"" Teevens"
"2003","Stanford (CA)","4","7","0","0.36364","186","324","-138","Eugene ""Buddy"" Teevens"
"2004","Stanford (CA)","4","7","0","0.36364","242","233","9","Eugene ""Buddy"" Teevens"
"2005","Stanford (CA)","5","6","0","0.45455","269","337","-68","Walt Harris"
"2006","Stanford (CA)","1","11","0","0.08333","127","377","-250","Walt Harris"
"2007","Stanford (CA)","4","8","0","0.33333","235","339","-104","Jim Harbaugh"
"2008","Stanford (CA)","5","7","0","0.41667","315","329","-14","Jim Harbaugh"
"2009","Stanford (CA)","8","5","0","0.61538","461","345","116","Jim Harbaugh"
"2010","Stanford (CA)","12","1","0","0.92308","524","226","298","Jim Harbaugh"
"2011","Stanford (CA)","11","2","0","0.84615","561","285","276","David Shaw"
"2012","Stanford (CA)","12","2","0","0.85714","390","241","149","David Shaw"
"2013","Stanford (CA)","11","3","0","0.78571","452","266","186","David Shaw"
"2014","Stanford (CA)","8","5","0","0.61538","353","213","140","David Shaw"
"1890","Syracuse (NY)","8","3","0","0.72727","140","84","56","Robert ""Bobby"" Winston"
"1891","Syracuse (NY)","4","7","0","0.36364","122","251","-129","William Galbraith"
"1892","Syracuse (NY)","0","8","1","0.05556","4","218","-214","Jordan C. Wells"
"1894","Syracuse (NY)","6","5","0","0.54545","180","157","23","George H. Bond"
"1895","Syracuse (NY)","6","2","2","0.7","154","46","108","George O. Redington"
"1896","Syracuse (NY)","5","3","2","0.6","194","78","116","George O. Redington"
"1897","Syracuse (NY)","5","3","1","0.61111","160","48","112","Frank E. Wade"
"1898","Syracuse (NY)","8","2","1","0.77273","192","69","123","Frank E. Wade"
"1899","Syracuse (NY)","4","4","0","0.5","63","63","0","Frank E. Wade"
"1900","Syracuse (NY)","7","2","1","0.75","208","60","148","Edwin R. Sweetland"
"1901","Syracuse (NY)","7","2","0","0.77778","185","33","152","Edwin R. Sweetland"
"1902","Syracuse (NY)","6","2","1","0.72222","172","93","79","Edwin R. Sweetland"
"1903","Syracuse (NY)","5","4","0","0.55556","200","69","131","Jason B. Parish & Ancil Delos Brown"
"1904","Syracuse (NY)","6","3","0","0.66667","405","57","348","Dr. Charles P. Hutchins"
"1905","Syracuse (NY)","8","3","0","0.72727","224","69","155","Dr. Charles P. Hutchins"
"1906","Syracuse (NY)","6","3","0","0.66667","168","75","93","Frank J. ""Buck"" O'Neill"
"1907","Syracuse (NY)","5","3","1","0.61111","133","64","69","Frank J. ""Buck"" O'Neill"
"1913","Syracuse (NY)","6","4","0","0.6","271","126","145","Frank J. ""Buck"" O'Neill"
"1914","Syracuse (NY)","5","3","2","0.6","202","95","107","Frank J. ""Buck"" O'Neill"
"1915","Syracuse (NY)","9","2","2","0.76923","338","29","309","Frank J. ""Buck"" O'Neill"
"1917","Syracuse (NY)","8","1","1","0.85","197","61","136","Frank J. ""Buck"" O'Neill"
"1918","Syracuse (NY)","5","1","0","0.83333","141","21","120","Frank J. ""Buck"" O'Neill"
"1919","Syracuse (NY)","8","3","0","0.72727","123","41","82","Frank J. ""Buck"" O'Neill"
"1908","Syracuse (NY)","6","3","1","0.65","171","39","132","Howard H. Jones"
"1909","Syracuse (NY)","4","5","1","0.45","110","100","10","T.A. Dwight ""Tad"" Jones"
"1910","Syracuse (NY)","5","4","1","0.55","53","42","11","T.A. Dwight ""Tad"" Jones"
"1911","Syracuse (NY)","5","3","2","0.6","63","59","4","C. DeForest Cummings"
"1912","Syracuse (NY)","4","5","0","0.44444","95","160","-65","C. DeForest Cummings"
"1916","Syracuse (NY)","5","4","0","0.55556","276","87","189","William M. ""Bill"" Hollenback"
"1920","Syracuse (NY)","6","2","1","0.72222","201","27","174","John F. ""Chick"" Meehan"
"1921","Syracuse (NY)","7","2","0","0.77778","194","59","135","John F. ""Chick"" Meehan"
"1922","Syracuse (NY)","6","1","2","0.77778","176","41","135","John F. ""Chick"" Meehan"
"1923","Syracuse (NY)","8","1","0","0.88889","237","19","218","John F. ""Chick"" Meehan"
"1924","Syracuse (NY)","8","2","1","0.77273","154","58","96","John F. ""Chick"" Meehan"
"1925","Syracuse (NY)","8","1","1","0.85","202","27","175","Charles W.P. ""Pete"" Reynolds"
"1926","Syracuse (NY)","7","2","1","0.75","227","58","169","Charles W.P. ""Pete"" Reynolds"
"1927","Syracuse (NY)","5","3","2","0.6","116","81","35","Lewis P. ""Lew"" Andreas"
"1928","Syracuse (NY)","4","4","1","0.5","136","79","57","Lewis P. ""Lew"" Andreas"
"1929","Syracuse (NY)","6","3","0","0.66667","259","46","213","Lewis P. ""Lew"" Andreas"
"1930","Syracuse (NY)","5","2","2","0.66667","207","79","128","Victor A. ""Vic"" Hanson"
"1931","Syracuse (NY)","7","1","1","0.83333","238","56","182","Victor A. ""Vic"" Hanson"
"1932","Syracuse (NY)","4","4","1","0.5","137","96","41","Victor A. ""Vic"" Hanson"
"1933","Syracuse (NY)","4","4","0","0.5","131","79","52","Victor A. ""Vic"" Hanson"
"1934","Syracuse (NY)","6","2","0","0.75","141","42","99","Victor A. ""Vic"" Hanson"
"1935","Syracuse (NY)","6","1","1","0.8125","112","56","56","Victor A. ""Vic"" Hanson"
"1936","Syracuse (NY)","1","7","0","0.125","45","116","-71","Victor A. ""Vic"" Hanson"
"1937","Syracuse (NY)","5","2","1","0.6875","132","57","75","Oscar M. ""Ossie"" Solem"
"1938","Syracuse (NY)","5","3","0","0.625","137","102","35","Oscar M. ""Ossie"" Solem"
"1939","Syracuse (NY)","3","3","2","0.5","63","92","-29","Oscar M. ""Ossie"" Solem"
"1940","Syracuse (NY)","3","4","1","0.4375","114","134","-20","Oscar M. ""Ossie"" Solem"
"1941","Syracuse (NY)","5","2","1","0.6875","190","86","104","Oscar M. ""Ossie"" Solem"
"1942","Syracuse (NY)","6","3","0","0.66667","152","61","91","Oscar M. ""Ossie"" Solem"
"1944","Syracuse (NY)","2","4","1","0.35714","102","152","-50","Oscar M. ""Ossie"" Solem"
"1945","Syracuse (NY)","1","6","0","0.14286","38","106","-68","Oscar M. ""Ossie"" Solem"
"1946","Syracuse (NY)","4","5","0","0.44444","146","158","-12","Clarence L. ""Biggie"" Munn"
"1947","Syracuse (NY)","3","6","0","0.33333","77","167","-90","Reaves H. Baysinger"
"1948","Syracuse (NY)","1","8","0","0.11111","89","244","-155","Reaves H. Baysinger"
"1949","Syracuse (NY)","4","5","0","0.44444","207","215","-8","Floyd B. ""Ben"" Schwartzwalder"
"1950","Syracuse (NY)","5","5","0","0.5","199","139","60","Floyd B. ""Ben"" Schwartzwalder"
"1951","Syracuse (NY)","5","4","0","0.55556","180","147","33","Floyd B. ""Ben"" Schwartzwalder"
"1952","Syracuse (NY)","7","3","0","0.7","203","202","1","Floyd B. ""Ben"" Schwartzwalder"
"1953","Syracuse (NY)","5","3","1","0.61111","197","99","98","Floyd B. ""Ben"" Schwartzwalder"
"1954","Syracuse (NY)","4","4","0","0.5","135","147","-12","Floyd B. ""Ben"" Schwartzwalder"
"1955","Syracuse (NY)","5","3","0","0.625","180","130","50","Floyd B. ""Ben"" Schwartzwalder"
"1956","Syracuse (NY)","7","2","0","0.77778","230","117","113","Floyd B. ""Ben"" Schwartzwalder"
"1957","Syracuse (NY)","5","3","1","0.61111","183","110","73","Floyd B. ""Ben"" Schwartzwalder"
"1958","Syracuse (NY)","8","2","0","0.8","270","80","190","Floyd B. ""Ben"" Schwartzwalder"
"1959","Syracuse (NY)","11","0","0","1","413","73","340","Floyd B. ""Ben"" Schwartzwalder"
"1960","Syracuse (NY)","7","2","0","0.77778","203","74","129","Floyd B. ""Ben"" Schwartzwalder"
"1961","Syracuse (NY)","8","3","0","0.72727","268","131","137","Floyd B. ""Ben"" Schwartzwalder"
"1962","Syracuse (NY)","5","5","0","0.5","159","110","49","Floyd B. ""Ben"" Schwartzwalder"
"1963","Syracuse (NY)","8","2","0","0.8","255","101","154","Floyd B. ""Ben"" Schwartzwalder"
"1964","Syracuse (NY)","7","4","0","0.63636","264","157","107","Floyd B. ""Ben"" Schwartzwalder"
"1965","Syracuse (NY)","7","3","0","0.7","237","146","91","Floyd B. ""Ben"" Schwartzwalder"
"1966","Syracuse (NY)","8","3","0","0.72727","266","156","110","Floyd B. ""Ben"" Schwartzwalder"
"1967","Syracuse (NY)","8","2","0","0.8","210","127","83","Floyd B. ""Ben"" Schwartzwalder"
"1968","Syracuse (NY)","6","4","0","0.6","252","154","98","Floyd B. ""Ben"" Schwartzwalder"
"1969","Syracuse (NY)","5","5","0","0.5","169","126","43","Floyd B. ""Ben"" Schwartzwalder"
"1970","Syracuse (NY)","6","4","0","0.6","248","208","40","Floyd B. ""Ben"" Schwartzwalder"
"1971","Syracuse (NY)","5","5","1","0.5","197","179","18","Floyd B. ""Ben"" Schwartzwalder"
"1972","Syracuse (NY)","5","6","0","0.45455","141","229","-88","Floyd B. ""Ben"" Schwartzwalder"
"1973","Syracuse (NY)","2","9","0","0.18182","129","288","-159","Floyd B. ""Ben"" Schwartzwalder"
"1974","Syracuse (NY)","2","9","0","0.18182","121","271","-150","Frank Maloney"
"1975","Syracuse (NY)","6","5","0","0.54545","174","182","-8","Frank Maloney"
"1976","Syracuse (NY)","3","8","0","0.27273","154","263","-109","Frank Maloney"
"1977","Syracuse (NY)","6","5","0","0.54545","218","234","-16","Frank Maloney"
"1978","Syracuse (NY)","3","8","0","0.27273","192","295","-103","Frank Maloney"
"1979","Syracuse (NY)","7","5","0","0.58333","324","293","31","Frank Maloney"
"1980","Syracuse (NY)","5","6","0","0.45455","207","222","-15","Frank Maloney"
"1981","Syracuse (NY)","4","6","1","0.40909","248","265","-17","Dick MacPherson"
"1982","Syracuse (NY)","2","9","0","0.18182","159","244","-85","Dick MacPherson"
"1983","Syracuse (NY)","6","5","0","0.54545","178","200","-22","Dick MacPherson"
"1984","Syracuse (NY)","6","5","0","0.54545","151","151","0","Dick MacPherson"
"1985","Syracuse (NY)","7","5","0","0.58333","284","195","89","Dick MacPherson"
"1986","Syracuse (NY)","5","6","0","0.45455","241","266","-25","Dick MacPherson"
"1987","Syracuse (NY)","11","0","1","0.95833","379","169","210","Dick MacPherson"
"1988","Syracuse (NY)","10","2","0","0.83333","341","189","152","Dick MacPherson"
"1989","Syracuse (NY)","8","4","0","0.66667","286","242","44","Dick MacPherson"
"1990","Syracuse (NY)","7","4","2","0.61538","341","213","128","Dick MacPherson"
"1991","Syracuse (NY)","10","2","0","0.83333","321","200","121","Paul Pasqualoni"
"1992","Syracuse (NY)","10","2","0","0.83333","340","205","135","Paul Pasqualoni"
"1993","Syracuse (NY)","6","4","1","0.59091","281","288","-7","Paul Pasqualoni"
"1994","Syracuse (NY)","7","4","0","0.63636","256","259","-3","Paul Pasqualoni"
"1995","Syracuse (NY)","9","3","0","0.75","375","213","162","Paul Pasqualoni"
"1996","Syracuse (NY)","9","3","0","0.75","437","208","229","Paul Pasqualoni"
"1997","Syracuse (NY)","9","4","0","0.69231","441","226","215","Paul Pasqualoni"
"1998","Syracuse (NY)","8","4","0","0.66667","478","300","178","Paul Pasqualoni"
"1999","Syracuse (NY)","7","5","0","0.58333","300","256","44","Paul Pasqualoni"
"2000","Syracuse (NY)","6","5","0","0.54545","294","212","82","Paul Pasqualoni"
"2001","Syracuse (NY)","10","3","0","0.76923","334","247","87","Paul Pasqualoni"
"2002","Syracuse (NY)","4","8","0","0.33333","347","406","-59","Paul Pasqualoni"
"2003","Syracuse (NY)","6","6","0","0.5","320","301","19","Paul Pasqualoni"
"2004","Syracuse (NY)","6","6","0","0.5","287","344","-57","Paul Pasqualoni"
"2005","Syracuse (NY)","1","10","0","0.09091","152","295","-143","Greg Robinson"
"2006","Syracuse (NY)","4","8","0","0.33333","209","295","-86","Greg Robinson"
"2007","Syracuse (NY)","2","10","0","0.16667","197","418","-221","Greg Robinson"
"2008","Syracuse (NY)","3","9","0","0.25","217","392","-175","Greg Robinson"
"2009","Syracuse (NY)","4","8","0","0.33333","254","335","-81","Doug Marrone"
"2010","Syracuse (NY)","8","5","0","0.61538","288","251","37","Doug Marrone"
"2011","Syracuse (NY)","5","7","0","0.41667","290","342","-52","Doug Marrone"
"2012","Syracuse (NY)","8","5","0","0.61538","390","322","68","Doug Marrone"
"2013","Syracuse (NY)","7","6","0","0.53846","295","330","-35","Scott Shafer"
"2014","Syracuse (NY)","3","9","0","0.25","205","292","-87","Scott Shafer"
"1902","Tennessee","6","2","0","0.75","88","39","49","H.F. Fisher"
"1903","Tennessee","4","5","0","0.44444","76","110","-34","H.F. Fisher"
"1904","Tennessee","3","5","1","0.38889","45","77","-32","S.D. Crawford"
"1905","Tennessee","3","5","1","0.38889","162","151","11","J.D. DePree"
"1906","Tennessee","1","6","2","0.22222","15","127","-112","J.D. DePree"
"1907","Tennessee","7","2","1","0.75","169","17","152","George Levene"
"1908","Tennessee","7","2","0","0.77778","124","41","83","George Levene"
"1909","Tennessee","1","6","2","0.22222","11","113","-102","George Levene"
"1910","Tennessee","3","5","1","0.38889","50","134","-84","Andrew A. Stone"
"1911","Tennessee","3","4","2","0.44444","82","93","-11","Zora G. Clevenger"
"1912","Tennessee","4","4","0","0.5","294","80","214","Zora G. Clevenger"
"1913","Tennessee","6","3","0","0.66667","283","37","246","Zora G. Clevenger"
"1914","Tennessee","9","0","0","1","374","37","337","Zora G. Clevenger"
"1915","Tennessee","4","4","0","0.5","303","58","245","Zora G. Clevenger"
"1916","Tennessee","8","0","1","0.94444","168","19","149","John R. ""Chief"" Bender"
"1919","Tennessee","3","3","3","0.5","103","62","41","John R. ""Chief"" Bender"
"1920","Tennessee","7","2","0","0.77778","243","40","203","John R. ""Chief"" Bender"
"1921","Tennessee","6","2","1","0.72222","102","35","67","Mark B. Banks"
"1922","Tennessee","7","2","0","0.77778","218","45","173","Mark B. Banks"
"1923","Tennessee","5","4","1","0.55","82","167","-85","Mark B. Banks"
"1924","Tennessee","3","5","0","0.375","83","135","-52","Mark B. Banks"
"1925","Tennessee","5","2","1","0.6875","129","73","56","Mark B. Banks"
"1926","Tennessee","8","1","0","0.88889","151","34","117","Robert R. ""Bob"" Neyland"
"1927","Tennessee","8","0","1","0.94444","245","26","219","Robert R. ""Bob"" Neyland"
"1928","Tennessee","9","0","1","0.95","249","51","198","Robert R. ""Bob"" Neyland"
"1929","Tennessee","9","0","1","0.95","330","19","311","Robert R. ""Bob"" Neyland"
"1930","Tennessee","9","1","0","0.9","209","31","178","Robert R. ""Bob"" Neyland"
"1931","Tennessee","9","0","1","0.95","243","15","228","Robert R. ""Bob"" Neyland"
"1932","Tennessee","9","0","1","0.95","238","36","202","Robert R. ""Bob"" Neyland"
"1933","Tennessee","7","3","0","0.7","176","47","129","Robert R. ""Bob"" Neyland"
"1934","Tennessee","8","2","0","0.8","175","58","117","Robert R. ""Bob"" Neyland"
"1936","Tennessee","6","2","2","0.7","147","52","95","Robert R. ""Bob"" Neyland"
"1937","Tennessee","6","3","1","0.65","189","47","142","Robert R. ""Bob"" Neyland"
"1938","Tennessee","11","0","0","1","293","16","277","Robert R. ""Bob"" Neyland"
"1939","Tennessee","10","1","0","0.90909","212","14","198","Robert R. ""Bob"" Neyland"
"1940","Tennessee","10","1","0","0.90909","331","45","286","Robert R. ""Bob"" Neyland"
"1946","Tennessee","9","2","0","0.81818","175","97","78","Robert R. ""Bob"" Neyland"
"1947","Tennessee","5","5","0","0.5","164","152","12","Robert R. ""Bob"" Neyland"
"1948","Tennessee","4","4","2","0.5","140","98","42","Robert R. ""Bob"" Neyland"
"1949","Tennessee","7","2","1","0.75","214","104","110","Robert R. ""Bob"" Neyland"
"1950","Tennessee","11","1","0","0.91667","335","71","264","Robert R. ""Bob"" Neyland"
"1951","Tennessee","10","1","0","0.90909","386","116","270","Robert R. ""Bob"" Neyland"
"1952","Tennessee","8","2","1","0.77273","259","79","180","Robert R. ""Bob"" Neyland"
"1935","Tennessee","4","5","0","0.44444","98","155","-57","William Hamilton Britton"
"1941","Tennessee","8","2","0","0.8","182","73","109","John Barnhill"
"1942","Tennessee","9","1","1","0.86364","259","61","198","John Barnhill"
"1944","Tennessee","7","1","1","0.83333","173","73","100","John Barnhill"
"1945","Tennessee","8","1","0","0.88889","238","52","186","John Barnhill"
"1953","Tennessee","6","4","1","0.59091","240","153","87","Harvey Robinson"
"1954","Tennessee","4","6","0","0.4","105","164","-59","Harvey Robinson"
"1955","Tennessee","6","3","1","0.65","188","92","96","Bowden Wyatt"
"1956","Tennessee","10","1","0","0.90909","275","88","187","Bowden Wyatt"
"1957","Tennessee","8","3","0","0.72727","164","75","89","Bowden Wyatt"
"1958","Tennessee","4","6","0","0.4","77","122","-45","Bowden Wyatt"
"1959","Tennessee","5","4","1","0.55","112","118","-6","Bowden Wyatt"
"1960","Tennessee","6","2","2","0.7","209","79","130","Bowden Wyatt"
"1961","Tennessee","6","4","0","0.6","221","149","72","Bowden Wyatt"
"1962","Tennessee","4","6","0","0.4","179","134","45","Bowden Wyatt"
"1963","Tennessee","5","5","0","0.5","168","121","47","James Allen McDonald"
"1964","Tennessee","4","5","1","0.45","80","121","-41","Doug Dickey"
"1965","Tennessee","8","1","2","0.81818","220","98","122","Doug Dickey"
"1966","Tennessee","8","3","0","0.72727","240","99","141","Doug Dickey"
"1967","Tennessee","9","2","0","0.81818","283","141","142","Doug Dickey"
"1968","Tennessee","8","2","1","0.77273","261","146","115","Doug Dickey"
"1969","Tennessee","9","2","0","0.81818","328","179","149","Doug Dickey"
"1970","Tennessee","11","1","0","0.91667","370","116","254","Bill Battle"
"1971","Tennessee","10","2","0","0.83333","270","121","149","Bill Battle"
"1972","Tennessee","10","2","0","0.83333","297","100","197","Bill Battle"
"1973","Tennessee","8","4","0","0.66667","291","247","44","Bill Battle"
"1974","Tennessee","7","3","2","0.66667","211","181","30","Bill Battle"
"1975","Tennessee","7","5","0","0.58333","253","193","60","Bill Battle"
"1976","Tennessee","6","5","0","0.54545","237","162","75","Bill Battle"
"1977","Tennessee","4","7","0","0.36364","229","229","0","Johnny Majors"
"1978","Tennessee","5","5","1","0.5","251","209","42","Johnny Majors"
"1979","Tennessee","7","5","0","0.58333","311","235","76","Johnny Majors"
"1980","Tennessee","5","6","0","0.45455","256","189","67","Johnny Majors"
"1981","Tennessee","8","4","0","0.66667","244","265","-21","Johnny Majors"
"1982","Tennessee","6","5","1","0.54167","281","239","42","Johnny Majors"
"1983","Tennessee","9","3","0","0.75","282","165","117","Johnny Majors"
"1984","Tennessee","7","4","1","0.625","327","276","51","Johnny Majors"
"1985","Tennessee","9","1","2","0.83333","325","140","185","Johnny Majors"
"1986","Tennessee","7","5","0","0.58333","293","249","44","Johnny Majors"
"1987","Tennessee","10","2","1","0.80769","422","246","176","Johnny Majors"
"1988","Tennessee","5","6","0","0.45455","212","286","-74","Johnny Majors"
"1989","Tennessee","11","1","0","0.91667","346","217","129","Johnny Majors"
"1990","Tennessee","9","2","2","0.76923","465","220","245","Johnny Majors"
"1991","Tennessee","9","3","0","0.75","352","263","89","Johnny Majors"
"1992","Tennessee","5","3","0","0.625","206","125","81","Johnny Majors"
"1992","Tennessee","4","0","0","1","141","71","70","Phillip Fulmer"
"1993","Tennessee","10","2","0","0.83333","484","175","309","Phillip Fulmer"
"1994","Tennessee","8","4","0","0.66667","363","208","155","Phillip Fulmer"
"1995","Tennessee","11","1","0","0.91667","431","228","203","Phillip Fulmer"
"1996","Tennessee","10","2","0","0.83333","437","185","252","Phillip Fulmer"
"1997","Tennessee","11","2","0","0.84615","428","286","142","Phillip Fulmer"
"1998","Tennessee","13","0","0","1","431","189","242","Phillip Fulmer"
"1999","Tennessee","9","3","0","0.75","369","194","175","Phillip Fulmer"
"2000","Tennessee","8","4","0","0.66667","380","247","133","Phillip Fulmer"
"2001","Tennessee","11","2","0","0.84615","400","251","149","Phillip Fulmer"
"2002","Tennessee","8","5","0","0.61538","296","227","69","Phillip Fulmer"
"2003","Tennessee","10","3","0","0.76923","365","239","126","Phillip Fulmer"
"2004","Tennessee","10","3","0","0.76923","378","295","83","Phillip Fulmer"
"2005","Tennessee","5","6","0","0.45455","205","205","0","Phillip Fulmer"
"2006","Tennessee","9","4","0","0.69231","362","254","108","Phillip Fulmer"
"2007","Tennessee","10","4","0","0.71429","455","382","73","Phillip Fulmer"
"2008","Tennessee","5","7","0","0.41667","208","201","7","Phillip Fulmer"
"2009","Tennessee","7","6","0","0.53846","381","289","92","Lane Kiffin"
"2010","Tennessee","6","7","0","0.46154","351","326","25","Derek Dooley"
"2011","Tennessee","5","7","0","0.41667","244","271","-27","Derek Dooley"
"2012","Tennessee","4","7","0","0.36364","397","411","-14","Derek Dooley"
"2012","Tennessee","1","0","0","1","37","17","20","Jim Chaney"
"2013","Tennessee","5","7","0","0.41667","286","348","-62","Butch Jones"
"2014","Tennessee","7","6","0","0.53846","376","315","61","Butch Jones"
"1894","Texas","6","1","0","0.85714","191","28","163","R.D. Wentworth"
"1895","Texas","5","0","0","1","96","0","96","Frank Crawford"
"1896","Texas","4","5","2","0.45455","104","84","20","Harry Orman Robinson"
"1897","Texas","6","2","0","0.75","144","56","88","Walter F. Kelly"
"1898","Texas","5","1","0","0.83333","136","4","132","D.F. Edwards"
"1899","Texas","6","2","0","0.75","117","24","93","M.G. Clarke"
"1900","Texas","6","0","0","1","113","13","100","Samuel Huston Thompson"
"1901","Texas","8","2","1","0.77273","153","71","82","Samuel Huston Thompson"
"1902","Texas","6","3","1","0.65","87","40","47","J.B. Hart"
"1903","Texas","5","1","2","0.75","131","28","103","Ralph F. Hutchinson"
"1904","Texas","6","2","0","0.75","219","88","131","Ralph F. Hutchinson"
"1905","Texas","5","4","0","0.55556","98","68","30","Ralph F. Hutchinson"
"1906","Texas","9","1","0","0.9","201","60","141","H.R. Schenker"
"1907","Texas","6","1","1","0.8125","154","53","101","W.E. Metzenthin"
"1908","Texas","5","4","0","0.55556","135","135","0","W.E. Metzenthin"
"1909","Texas","4","3","1","0.5625","105","50","55","Dexter W. Draper"
"1910","Texas","6","2","0","0.75","162","32","130","William S. Wasmund"
"1911","Texas","5","2","0","0.71429","66","19","47","William S. Wasmund"
"1912","Texas","7","1","0","0.875","201","62","139","David W. ""Dave"" Allerdice"
"1913","Texas","7","1","0","0.875","250","56","194","David W. ""Dave"" Allerdice"
"1914","Texas","8","0","0","1","358","21","337","David W. ""Dave"" Allerdice"
"1915","Texas","6","3","0","0.66667","335","69","266","David W. ""Dave"" Allerdice"
"1916","Texas","7","2","0","0.77778","218","35","183","Conrad Eugene Van Gent"
"1917","Texas","4","4","0","0.5","89","40","49","William J. ""Bill"" Juneau"
"1918","Texas","9","0","0","1","194","14","180","William J. ""Bill"" Juneau"
"1919","Texas","6","3","0","0.66667","181","63","118","William J. ""Bill"" Juneau"
"1920","Texas","9","0","0","1","282","13","269","Berry Whitaker"
"1921","Texas","6","1","1","0.8125","268","27","241","Berry Whitaker"
"1922","Texas","7","2","0","0.77778","202","68","134","Berry Whitaker"
"1923","Texas","8","0","1","0.94444","241","21","220","Edward J. ""Doc"" Stewart"
"1924","Texas","5","3","1","0.61111","109","64","45","Edward J. ""Doc"" Stewart"
"1925","Texas","6","2","1","0.72222","157","51","106","Edward J. ""Doc"" Stewart"
"1926","Texas","5","4","0","0.55556","146","69","77","Edward J. ""Doc"" Stewart"
"1927","Texas","6","2","1","0.72222","164","73","91","Clyde Littlefield"
"1928","Texas","7","2","0","0.77778","122","32","90","Clyde Littlefield"
"1929","Texas","5","2","2","0.66667","132","28","104","Clyde Littlefield"
"1930","Texas","8","1","1","0.85","179","20","159","Clyde Littlefield"
"1931","Texas","6","4","0","0.6","131","58","73","Clyde Littlefield"
"1932","Texas","8","2","0","0.8","220","49","171","Clyde Littlefield"
"1933","Texas","4","5","2","0.45455","112","104","8","Clyde Littlefield"
"1934","Texas","7","2","1","0.75","137","85","52","John E. ""Jack"" Chevigny"
"1935","Texas","4","6","0","0.4","138","174","-36","John E. ""Jack"" Chevigny"
"1936","Texas","2","6","1","0.27778","69","128","-59","John E. ""Jack"" Chevigny"
"1937","Texas","2","6","1","0.27778","60","103","-43","Dana X. Bible"
"1938","Texas","1","8","0","0.11111","52","162","-110","Dana X. Bible"
"1939","Texas","5","4","0","0.55556","106","125","-19","Dana X. Bible"
"1940","Texas","8","2","0","0.8","172","77","95","Dana X. Bible"
"1941","Texas","8","1","1","0.85","338","55","283","Dana X. Bible"
"1942","Texas","9","2","0","0.81818","244","49","195","Dana X. Bible"
"1943","Texas","7","1","1","0.83333","277","54","223","Dana X. Bible"
"1944","Texas","5","4","0","0.55556","119","76","43","Dana X. Bible"
"1945","Texas","10","1","0","0.90909","257","86","171","Dana X. Bible"
"1946","Texas","8","2","0","0.8","290","68","222","Dana X. Bible"
"1947","Texas","10","1","0","0.90909","292","74","218","J. Blair Cherry"
"1948","Texas","7","3","1","0.68182","223","147","76","J. Blair Cherry"
"1949","Texas","6","4","0","0.6","290","93","197","J. Blair Cherry"
"1950","Texas","9","2","0","0.81818","252","148","104","J. Blair Cherry"
"1951","Texas","7","3","0","0.7","182","129","53","Edwin B. ""Ed"" Price"
"1952","Texas","9","2","0","0.81818","278","164","114","Edwin B. ""Ed"" Price"
"1953","Texas","7","3","0","0.7","190","125","65","Edwin B. ""Ed"" Price"
"1954","Texas","4","5","1","0.45","158","161","-3","Edwin B. ""Ed"" Price"
"1955","Texas","5","5","0","0.5","189","212","-23","Edwin B. ""Ed"" Price"
"1956","Texas","1","9","0","0.1","101","272","-171","Edwin B. ""Ed"" Price"
"1957","Texas","6","4","1","0.59091","159","149","10","Darrell Royal"
"1958","Texas","7","3","0","0.7","157","152","5","Darrell Royal"
"1959","Texas","9","2","0","0.81818","216","96","120","Darrell Royal"
"1960","Texas","7","3","1","0.68182","167","78","89","Darrell Royal"
"1961","Texas","10","1","0","0.90909","303","66","237","Darrell Royal"
"1962","Texas","9","1","1","0.86364","184","72","112","Darrell Royal"
"1963","Texas","11","0","0","1","243","71","172","Darrell Royal"
"1964","Texas","10","1","0","0.90909","220","81","139","Darrell Royal"
"1965","Texas","6","4","0","0.6","231","153","78","Darrell Royal"
"1966","Texas","7","4","0","0.63636","194","111","83","Darrell Royal"
"1967","Texas","6","4","0","0.6","186","123","63","Darrell Royal"
"1968","Texas","9","1","1","0.86364","379","198","181","Darrell Royal"
"1969","Texas","11","0","0","1","435","119","316","Darrell Royal"
"1970","Texas","10","1","0","0.90909","423","149","274","Darrell Royal"
"1971","Texas","8","3","0","0.72727","281","168","113","Darrell Royal"
"1972","Texas","10","1","0","0.90909","271","121","150","Darrell Royal"
"1973","Texas","8","3","0","0.72727","367","162","205","Darrell Royal"
"1974","Texas","8","4","0","0.66667","367","197","170","Darrell Royal"
"1975","Texas","10","2","0","0.83333","401","181","220","Darrell Royal"
"1976","Texas","5","5","1","0.5","195","188","7","Darrell Royal"
"1977","Texas","11","1","0","0.91667","441","152","289","Fred Akers"
"1978","Texas","9","3","0","0.75","287","136","151","Fred Akers"
"1979","Texas","9","3","0","0.75","221","104","117","Fred Akers"
"1980","Texas","7","5","0","0.58333","267","214","53","Fred Akers"
"1981","Texas","10","1","1","0.875","262","158","104","Fred Akers"
"1982","Texas","9","3","0","0.75","357","170","187","Fred Akers"
"1983","Texas","11","1","0","0.91667","289","114","175","Fred Akers"
"1984","Texas","7","4","1","0.625","264","261","3","Fred Akers"
"1985","Texas","8","4","0","0.66667","270","259","11","Fred Akers"
"1986","Texas","5","6","0","0.45455","229","245","-16","Fred Akers"
"1987","Texas","7","5","0","0.58333","335","324","11","David McWilliams"
"1988","Texas","4","7","0","0.36364","252","304","-52","David McWilliams"
"1989","Texas","5","6","0","0.45455","220","289","-69","David McWilliams"
"1990","Texas","10","2","0","0.83333","358","227","131","David McWilliams"
"1991","Texas","5","6","0","0.45455","195","145","50","David McWilliams"
"1992","Texas","6","5","0","0.54545","292","282","10","John Mackovic"
"1993","Texas","5","5","1","0.5","281","269","12","John Mackovic"
"1994","Texas","8","4","0","0.66667","366","291","75","John Mackovic"
"1995","Texas","10","2","1","0.80769","390","255","135","John Mackovic"
"1996","Texas","8","5","0","0.61538","447","305","142","John Mackovic"
"1997","Texas","4","7","0","0.36364","283","366","-83","John Mackovic"
"1998","Texas","9","3","0","0.75","437","337","100","Mack Brown"
"1999","Texas","9","5","0","0.64286","450","295","155","Mack Brown"
"2000","Texas","9","3","0","0.75","455","232","223","Mack Brown"
"2001","Texas","11","2","0","0.84615","517","207","310","Mack Brown"
"2002","Texas","11","2","0","0.84615","439","212","227","Mack Brown"
"2003","Texas","10","3","0","0.76923","533","280","253","Mack Brown"
"2004","Texas","11","1","0","0.91667","423","215","208","Mack Brown"
"2005","Texas","13","0","0","1","652","213","439","Mack Brown"
"2006","Texas","10","3","0","0.76923","467","238","229","Mack Brown"
"2007","Texas","10","3","0","0.76923","484","329","155","Mack Brown"
"2008","Texas","12","1","0","0.92308","551","244","307","Mack Brown"
"2009","Texas","13","1","0","0.92857","550","234","316","Mack Brown"
"2010","Texas","5","7","0","0.41667","285","284","1","Mack Brown"
"2011","Texas","8","5","0","0.61538","365","289","76","Mack Brown"
"2012","Texas","9","4","0","0.69231","464","380","84","Mack Brown"
"2013","Texas","8","5","0","0.61538","381","336","45","Mack Brown"
"2014","Texas","6","7","0","0.46154","278","310","-32","Charlie Strong"
"1894","Texas A&M","1","1","0","0.5","14","44","-30","F.D. Perkins"
"1896","Texas A&M","2","0","1","0.83333","50","4","46","Prof. A.M. Soule & Prof. H.W. South"
"1897","Texas A&M","1","2","0","0.33333","10","40","-30","C.W. Taylor"
"1898","Texas A&M","4","2","0","0.66667","117","60","57","H.W. Williams"
"1899","Texas A&M","4","2","0","0.66667","150","16","134","W.A. Murray"
"1900","Texas A&M","2","2","1","0.5","61","22","39","W.A. Murray"
"1901","Texas A&M","1","4","0","0.2","12","112","-100","W.A. Murray"
"1902","Texas A&M","7","0","2","0.88889","129","11","118","J.E. Platt"
"1903","Texas A&M","7","3","1","0.68182","90","59","31","J.E. Platt"
"1904","Texas A&M","4","2","0","0.66667","104","51","53","J.E. Platt"
"1905","Texas A&M","7","2","0","0.77778","180","83","97","Walter E. Bachman"
"1906","Texas A&M","6","1","0","0.85714","170","42","128","Walter E. Bachman"
"1907","Texas A&M","6","1","1","0.8125","125","27","98","L.L. Larson"
"1908","Texas A&M","3","5","0","0.375","76","117","-41","N.A. Merriam"
"1909","Texas A&M","1","0","1","0.75","17","0","17","N.A. Merriam"
"1909","Texas A&M","6","0","0","1","113","14","99","Charles B. ""Charlie"" Moran"
"1910","Texas A&M","8","1","0","0.88889","203","24","179","Charles B. ""Charlie"" Moran"
"1911","Texas A&M","6","1","0","0.85714","134","17","117","Charles B. ""Charlie"" Moran"
"1912","Texas A&M","8","1","0","0.88889","366","26","340","Charles B. ""Charlie"" Moran"
"1913","Texas A&M","3","4","2","0.44444","53","76","-23","Charles B. ""Charlie"" Moran"
"1914","Texas A&M","6","1","1","0.8125","205","33","172","Charles B. ""Charlie"" Moran"
"1915","Texas A&M","6","2","0","0.75","182","34","148","E.H.W. Harlan"
"1916","Texas A&M","7","3","0","0.7","214","66","148","E.H.W. Harlan"
"1918","Texas A&M","6","1","0","0.85714","123","19","104","D.V. Graves"
"1917","Texas A&M","8","0","0","1","270","0","270","Dana X. Bible"
"1919","Texas A&M","10","0","0","1","275","0","275","Dana X. Bible"
"1920","Texas A&M","6","1","1","0.8125","229","7","222","Dana X. Bible"
"1921","Texas A&M","6","1","2","0.77778","110","57","53","Dana X. Bible"
"1922","Texas A&M","5","4","0","0.55556","166","69","97","Dana X. Bible"
"1923","Texas A&M","5","3","1","0.61111","135","23","112","Dana X. Bible"
"1924","Texas A&M","7","2","1","0.75","229","35","194","Dana X. Bible"
"1925","Texas A&M","7","1","1","0.83333","191","25","166","Dana X. Bible"
"1926","Texas A&M","5","3","1","0.61111","184","59","125","Dana X. Bible"
"1927","Texas A&M","8","0","1","0.94444","262","32","230","Dana X. Bible"
"1928","Texas A&M","5","4","1","0.55","205","77","128","Dana X. Bible"
"1929","Texas A&M","5","4","0","0.55556","203","65","138","Madison A. ""Matty"" Bell"
"1930","Texas A&M","2","7","0","0.22222","66","100","-34","Madison A. ""Matty"" Bell"
"1931","Texas A&M","7","3","0","0.7","137","34","103","Madison A. ""Matty"" Bell"
"1932","Texas A&M","4","4","2","0.5","75","78","-3","Madison A. ""Matty"" Bell"
"1933","Texas A&M","6","3","1","0.65","160","89","71","Madison A. ""Matty"" Bell"
"1934","Texas A&M","2","7","2","0.27273","84","186","-102","Homer H. Norton"
"1935","Texas A&M","3","7","0","0.3","125","121","4","Homer H. Norton"
"1936","Texas A&M","8","3","1","0.70833","156","74","82","Homer H. Norton"
"1937","Texas A&M","5","2","2","0.66667","117","59","58","Homer H. Norton"
"1938","Texas A&M","4","4","1","0.5","137","71","66","Homer H. Norton"
"1939","Texas A&M","11","0","0","1","212","31","181","Homer H. Norton"
"1940","Texas A&M","9","1","0","0.9","183","46","137","Homer H. Norton"
"1941","Texas A&M","9","2","0","0.81818","281","75","206","Homer H. Norton"
"1942","Texas A&M","4","5","1","0.45","130","79","51","Homer H. Norton"
"1943","Texas A&M","7","2","1","0.75","184","65","119","Homer H. Norton"
"1944","Texas A&M","7","4","0","0.63636","289","87","202","Homer H. Norton"
"1945","Texas A&M","6","4","0","0.6","179","103","76","Homer H. Norton"
"1946","Texas A&M","4","6","0","0.4","125","107","18","Homer H. Norton"
"1947","Texas A&M","3","6","1","0.35","169","185","-16","Homer H. Norton"
"1948","Texas A&M","0","9","1","0.05","123","247","-124","Robert Harry Stiteler"
"1949","Texas A&M","1","8","1","0.15","92","267","-175","Robert Harry Stiteler"
"1950","Texas A&M","7","4","0","0.63636","344","206","138","Robert Harry Stiteler"
"1951","Texas A&M","5","3","2","0.6","213","179","34","Raymond George"
"1952","Texas A&M","3","6","1","0.35","137","187","-50","Raymond George"
"1953","Texas A&M","4","5","1","0.45","128","186","-58","Raymond George"
"1954","Texas A&M","1","9","0","0.1","97","177","-80","Paul W. ""Bear"" Bryant"
"1955","Texas A&M","7","2","1","0.75","160","89","71","Paul W. ""Bear"" Bryant"
"1956","Texas A&M","9","0","1","0.95","223","81","142","Paul W. ""Bear"" Bryant"
"1957","Texas A&M","8","3","0","0.72727","158","50","108","Paul W. ""Bear"" Bryant"
"1958","Texas A&M","4","6","0","0.4","124","217","-93","James A. ""Jim"" Myers"
"1959","Texas A&M","3","7","0","0.3","101","141","-40","James A. ""Jim"" Myers"
"1960","Texas A&M","1","6","3","0.25","73","117","-44","James A. ""Jim"" Myers"
"1961","Texas A&M","4","5","1","0.45","184","118","66","James A. ""Jim"" Myers"
"1962","Texas A&M","3","7","0","0.3","61","155","-94","Henry ""Hank"" Foldberg"
"1963","Texas A&M","2","7","1","0.25","90","153","-63","Henry ""Hank"" Foldberg"
"1964","Texas A&M","1","9","0","0.1","88","162","-74","Henry ""Hank"" Foldberg"
"1965","Texas A&M","3","7","0","0.3","80","170","-90","Gene Stallings"
"1966","Texas A&M","4","5","1","0.45","145","183","-38","Gene Stallings"
"1967","Texas A&M","7","4","0","0.63636","211","154","57","Gene Stallings"
"1968","Texas A&M","3","7","0","0.3","196","184","12","Gene Stallings"
"1969","Texas A&M","3","7","0","0.3","116","192","-76","Gene Stallings"
"1970","Texas A&M","2","9","0","0.18182","170","304","-134","Gene Stallings"
"1971","Texas A&M","5","6","0","0.45455","144","212","-68","Gene Stallings"
"1972","Texas A&M","3","8","0","0.27273","165","243","-78","Emory Bellard"
"1973","Texas A&M","5","6","0","0.45455","292","231","61","Emory Bellard"
"1974","Texas A&M","8","3","0","0.72727","222","131","91","Emory Bellard"
"1975","Texas A&M","10","2","0","0.83333","265","124","141","Emory Bellard"
"1976","Texas A&M","10","2","0","0.83333","364","140","224","Emory Bellard"
"1977","Texas A&M","8","4","0","0.66667","350","304","46","Emory Bellard"
"1978","Texas A&M","4","2","0","0.66667","176","78","98","Emory Bellard"
"1978","Texas A&M","4","2","0","0.66667","115","105","10","Tom Wilson"
"1979","Texas A&M","6","5","0","0.54545","243","159","84","Tom Wilson"
"1980","Texas A&M","4","7","0","0.36364","160","259","-99","Tom Wilson"
"1981","Texas A&M","7","5","0","0.58333","280","203","77","Tom Wilson"
"1982","Texas A&M","5","6","0","0.45455","286","314","-28","Jackie Sherrill"
"1983","Texas A&M","5","5","1","0.5","218","174","44","Jackie Sherrill"
"1984","Texas A&M","6","5","0","0.54545","245","217","28","Jackie Sherrill"
"1985","Texas A&M","10","2","0","0.83333","375","196","179","Jackie Sherrill"
"1986","Texas A&M","9","3","0","0.75","372","215","157","Jackie Sherrill"
"1987","Texas A&M","10","2","0","0.83333","313","168","145","Jackie Sherrill"
"1988","Texas A&M","7","5","0","0.58333","293","253","40","Jackie Sherrill"
"1989","Texas A&M","8","4","0","0.66667","343","192","151","R.C. Slocum"
"1990","Texas A&M","9","3","1","0.73077","465","232","233","R.C. Slocum"
"1991","Texas A&M","10","2","0","0.83333","404","154","250","R.C. Slocum"
"1992","Texas A&M","12","1","0","0.92308","352","196","156","R.C. Slocum"
"1993","Texas A&M","10","2","0","0.83333","425","143","282","R.C. Slocum"
"1994","Texas A&M","10","0","1","0.95455","319","147","172","R.C. Slocum"
"1995","Texas A&M","9","3","0","0.75","327","168","159","R.C. Slocum"
"1996","Texas A&M","6","6","0","0.5","351","257","94","R.C. Slocum"
"1997","Texas A&M","9","4","0","0.69231","445","236","209","R.C. Slocum"
"1998","Texas A&M","11","3","0","0.78571","335","214","121","R.C. Slocum"
"1999","Texas A&M","8","4","0","0.66667","318","232","86","R.C. Slocum"
"2000","Texas A&M","7","5","0","0.58333","348","239","109","R.C. Slocum"
"2001","Texas A&M","8","4","0","0.66667","248","213","35","R.C. Slocum"
"2002","Texas A&M","6","6","0","0.5","345","280","65","R.C. Slocum"
"2003","Texas A&M","4","8","0","0.33333","304","465","-161","Dennis Franchione"
"2004","Texas A&M","7","5","0","0.58333","341","292","49","Dennis Franchione"
"2005","Texas A&M","5","6","0","0.45455","352","343","9","Dennis Franchione"
"2006","Texas A&M","9","4","0","0.69231","362","267","95","Dennis Franchione"
"2007","Texas A&M","7","5","0","0.58333","346","313","33","Dennis Franchione"
"2007","Texas A&M","0","1","0","0","17","24","-7","Gary Darnell"
"2008","Texas A&M","4","8","0","0.33333","300","449","-149","Mike Sherman"
"2009","Texas A&M","6","7","0","0.46154","427","436","-9","Mike Sherman"
"2010","Texas A&M","9","4","0","0.69231","406","285","121","Mike Sherman"
"2011","Texas A&M","6","6","0","0.5","475","344","131","Mike Sherman"
"2011","Texas A&M","1","0","0","1","33","22","11","Tim DeRuyter"
"2012","Texas A&M","11","2","0","0.84615","578","283","295","Kevin Sumlin"
"2013","Texas A&M","9","4","0","0.69231","575","419","156","Kevin Sumlin"
"2014","Texas A&M","8","5","0","0.61538","458","365","93","Kevin Sumlin"
"1897","Texas Christian","3","1","0","0.75","78","24","54","Joe J. Field"
"1898","Texas Christian","1","3","1","0.3","41","61","-20","Dr. James Morrison"
"1903","Texas Christian","17","30","2","0.36735","457","672","-215","No Coach"
"1902","Texas Christian","0","5","1","0.08333","0","93","-93","H.E. Hildebrand"
"1904","Texas Christian","1","4","1","0.25","5","90","-85","C.E. Cronk"
"1905","Texas Christian","4","4","0","0.5","77","65","12","E.J. Hyde"
"1906","Texas Christian","2","5","0","0.28571","26","108","-82","E.J. Hyde"
"1907","Texas Christian","3","3","2","0.5","88","69","19","E.J. Hyde"
"1908","Texas Christian","6","3","0","0.66667","155","63","92","J.R. Langley"
"1909","Texas Christian","5","2","1","0.6875","95","33","62","J.R. Langley"
"1910","Texas Christian","2","6","1","0.27778","45","187","-142","Kemp Lewis"
"1911","Texas Christian","4","5","0","0.44444","114","106","8","Henry W. Lever"
"1912","Texas Christian","8","1","0","0.88889","230","53","177","Willis T. Stewart"
"1913","Texas Christian","3","1","2","0.66667","44","6","38","Fred Cahoon"
"1914","Texas Christian","4","4","2","0.5","117","118","-1","S.A. Boles"
"1915","Texas Christian","4","5","0","0.44444","130","182","-52","Ewing Y. Freeland"
"1916","Texas Christian","6","2","1","0.72222","217","85","132","Milton E. Daniel"
"1917","Texas Christian","9","2","0","0.81818","223","60","163","Milton E. Daniel"
"1918","Texas Christian","4","4","0","0.5","96","92","4","E.M. Tipton"
"1919","Texas Christian","1","7","0","0.125","20","119","-99","T.E.D. Hackney"
"1920","Texas Christian","9","1","0","0.9","170","109","61","William L. ""Billy"" Driver"
"1921","Texas Christian","6","3","1","0.65","132","75","57","William L. ""Billy"" Driver"
"1922","Texas Christian","2","5","3","0.35","91","167","-76","John McKnight"
"1923","Texas Christian","4","5","0","0.44444","93","137","-44","Madison A. ""Matty"" Bell"
"1924","Texas Christian","4","5","0","0.44444","83","96","-13","Madison A. ""Matty"" Bell"
"1925","Texas Christian","7","1","1","0.83333","133","54","79","Madison A. ""Matty"" Bell"
"1926","Texas Christian","6","1","2","0.77778","110","74","36","Madison A. ""Matty"" Bell"
"1927","Texas Christian","4","3","2","0.55556","89","64","25","Madison A. ""Matty"" Bell"
"1928","Texas Christian","8","2","0","0.8","142","28","114","Madison A. ""Matty"" Bell"
"1929","Texas Christian","9","0","1","0.95","249","33","216","Francis A. Schmidt"
"1930","Texas Christian","9","2","1","0.79167","298","49","249","Francis A. Schmidt"
"1931","Texas Christian","8","2","1","0.77273","119","41","78","Francis A. Schmidt"
"1932","Texas Christian","10","0","1","0.95455","283","23","260","Francis A. Schmidt"
"1933","Texas Christian","9","2","1","0.79167","208","49","159","Francis A. Schmidt"
"1934","Texas Christian","8","4","0","0.66667","173","116","57","Leo R. ""Dutch"" Meyer"
"1935","Texas Christian","12","1","0","0.92308","265","73","192","Leo R. ""Dutch"" Meyer"
"1936","Texas Christian","9","2","2","0.76923","160","58","102","Leo R. ""Dutch"" Meyer"
"1937","Texas Christian","4","4","2","0.5","73","66","7","Leo R. ""Dutch"" Meyer"
"1938","Texas Christian","11","0","0","1","269","60","209","Leo R. ""Dutch"" Meyer"
"1939","Texas Christian","3","7","0","0.3","116","119","-3","Leo R. ""Dutch"" Meyer"
"1940","Texas Christian","3","7","0","0.3","116","121","-5","Leo R. ""Dutch"" Meyer"
"1941","Texas Christian","7","3","1","0.68182","162","135","27","Leo R. ""Dutch"" Meyer"
"1942","Texas Christian","7","3","0","0.7","129","82","47","Leo R. ""Dutch"" Meyer"
"1943","Texas Christian","2","6","0","0.25","71","146","-75","Leo R. ""Dutch"" Meyer"
"1944","Texas Christian","7","3","1","0.68182","134","109","25","Leo R. ""Dutch"" Meyer"
"1945","Texas Christian","5","5","0","0.5","91","156","-65","Leo R. ""Dutch"" Meyer"
"1946","Texas Christian","2","7","1","0.25","90","148","-58","Leo R. ""Dutch"" Meyer"
"1947","Texas Christian","4","5","2","0.45455","114","99","15","Leo R. ""Dutch"" Meyer"
"1948","Texas Christian","4","5","1","0.45","125","143","-18","Leo R. ""Dutch"" Meyer"
"1949","Texas Christian","6","3","1","0.65","205","185","20","Leo R. ""Dutch"" Meyer"
"1950","Texas Christian","5","5","0","0.5","157","161","-4","Leo R. ""Dutch"" Meyer"
"1951","Texas Christian","6","5","0","0.54545","206","183","23","Leo R. ""Dutch"" Meyer"
"1952","Texas Christian","4","4","2","0.5","141","103","38","Leo R. ""Dutch"" Meyer"
"1953","Texas Christian","3","7","0","0.3","116","150","-34","Othol ""Abe"" Martin"
"1954","Texas Christian","4","6","0","0.4","164","155","9","Othol ""Abe"" Martin"
"1955","Texas Christian","9","2","0","0.81818","306","105","201","Othol ""Abe"" Martin"
"1956","Texas Christian","8","3","0","0.72727","231","110","121","Othol ""Abe"" Martin"
"1957","Texas Christian","5","4","1","0.55","134","101","33","Othol ""Abe"" Martin"
"1958","Texas Christian","8","2","1","0.77273","219","78","141","Othol ""Abe"" Martin"
"1959","Texas Christian","8","3","0","0.72727","169","75","94","Othol ""Abe"" Martin"
"1960","Texas Christian","4","4","2","0.5","85","94","-9","Othol ""Abe"" Martin"
"1961","Texas Christian","3","5","2","0.4","113","194","-81","Othol ""Abe"" Martin"
"1962","Texas Christian","6","4","0","0.6","167","154","13","Othol ""Abe"" Martin"
"1963","Texas Christian","4","5","1","0.45","131","166","-35","Othol ""Abe"" Martin"
"1964","Texas Christian","4","6","0","0.4","94","169","-75","Othol ""Abe"" Martin"
"1965","Texas Christian","6","5","0","0.54545","161","156","5","Othol ""Abe"" Martin"
"1966","Texas Christian","2","8","0","0.2","55","149","-94","Othol ""Abe"" Martin"
"1967","Texas Christian","4","6","0","0.4","113","185","-72","Fred Taylor (1)"
"1968","Texas Christian","3","7","0","0.3","176","215","-39","Fred Taylor (1)"
"1969","Texas Christian","4","6","0","0.4","177","293","-116","Fred Taylor (1)"
"1970","Texas Christian","4","6","1","0.40909","189","265","-76","Fred Taylor (1)"
"1971","Texas Christian","3","3","1","0.5","159","203","-44","Jim Pittman"
"1971","Texas Christian","3","1","0","0.75","55","72","-17","Billy Tohill"
"1972","Texas Christian","5","6","0","0.45455","213","245","-32","Billy Tohill"
"1973","Texas Christian","3","8","0","0.27273","189","290","-101","Billy Tohill"
"1974","Texas Christian","1","10","0","0.09091","79","345","-266","Jim Shofner"
"1975","Texas Christian","1","10","0","0.09091","103","325","-222","Jim Shofner"
"1976","Texas Christian","0","11","0","0","128","430","-302","Jim Shofner"
"1977","Texas Christian","2","9","0","0.18182","184","434","-250","F.A. Dry"
"1978","Texas Christian","2","9","0","0.18182","109","357","-248","F.A. Dry"
"1979","Texas Christian","2","8","1","0.22727","127","226","-99","F.A. Dry"
"1980","Texas Christian","1","10","0","0.09091","143","295","-152","F.A. Dry"
"1981","Texas Christian","2","7","2","0.27273","230","299","-69","F.A. Dry"
"1982","Texas Christian","3","8","0","0.27273","203","266","-63","F.A. Dry"
"1983","Texas Christian","1","8","2","0.18182","174","252","-78","Jim Wacker"
"1984","Texas Christian","8","4","0","0.66667","376","280","96","Jim Wacker"
"1985","Texas Christian","3","8","0","0.27273","150","383","-233","Jim Wacker"
"1986","Texas Christian","3","8","0","0.27273","259","376","-117","Jim Wacker"
"1987","Texas Christian","5","6","0","0.45455","261","226","35","Jim Wacker"
"1988","Texas Christian","4","7","0","0.36364","206","286","-80","Jim Wacker"
"1989","Texas Christian","4","7","0","0.36364","183","301","-118","Jim Wacker"
"1990","Texas Christian","5","6","0","0.45455","292","353","-61","Jim Wacker"
"1991","Texas Christian","7","4","0","0.63636","279","267","12","Jim Wacker"
"1992","Texas Christian","2","8","1","0.22727","195","319","-124","Pat Sullivan"
"1993","Texas Christian","4","7","0","0.36364","201","313","-112","Pat Sullivan"
"1994","Texas Christian","7","5","0","0.58333","302","301","1","Pat Sullivan"
"1995","Texas Christian","6","5","0","0.54545","217","246","-29","Pat Sullivan"
"1996","Texas Christian","4","7","0","0.36364","211","302","-91","Pat Sullivan"
"1997","Texas Christian","1","10","0","0.09091","172","325","-153","Pat Sullivan"
"1998","Texas Christian","7","5","0","0.58333","267","235","32","Dennis Franchione"
"1999","Texas Christian","8","4","0","0.66667","362","213","149","Dennis Franchione"
"2000","Texas Christian","10","1","0","0.90909","410","106","304","Dennis Franchione"
"2000","Texas Christian","0","1","0","0","21","28","-7","Gary Patterson"
"2001","Texas Christian","6","6","0","0.5","289","285","4","Gary Patterson"
"2002","Texas Christian","10","2","0","0.83333","361","222","139","Gary Patterson"
"2003","Texas Christian","11","2","0","0.84615","380","276","104","Gary Patterson"
"2004","Texas Christian","5","6","0","0.45455","362","373","-11","Gary Patterson"
"2005","Texas Christian","11","1","0","0.91667","398","223","175","Gary Patterson"
"2006","Texas Christian","11","2","0","0.84615","380","160","220","Gary Patterson"
"2007","Texas Christian","8","5","0","0.61538","339","243","96","Gary Patterson"
"2008","Texas Christian","11","2","0","0.84615","437","147","290","Gary Patterson"
"2009","Texas Christian","12","1","0","0.92308","498","166","332","Gary Patterson"
"2010","Texas Christian","13","0","0","1","541","156","385","Gary Patterson"
"2011","Texas Christian","11","2","0","0.84615","531","279","252","Gary Patterson"
"2012","Texas Christian","7","6","0","0.53846","368","294","74","Gary Patterson"
"2013","Texas Christian","4","8","0","0.33333","301","303","-2","Gary Patterson"
"2014","Texas Christian","12","1","0","0.92308","604","247","357","Gary Patterson"
"1915","Texas St.","1","1","1","0.5","13","20","-7","No Coach"
"1916","Texas St.","0","2","1","0.16667","0","106","-106","No Coach"
"1917","Texas St.","1","0","0","1","12","0","12","No Team"
"1919","Texas St.","4","4","0","0.5","71","77","-6","O.W. Strahan"
"1920","Texas St.","5","2","1","0.6875","234","84","150","O.W. Strahan"
"1921","Texas St.","7","0","0","1","185","26","159","O.W. Strahan"
"1922","Texas St.","3","3","0","0.5","92","73","19","O.W. Strahan"
"1923","Texas St.","4","4","0","0.5","157","73","84","O.W. Strahan"
"1924","Texas St.","4","4","0","0.5","69","82","-13","O.W. Strahan"
"1925","Texas St.","2","6","1","0.27778","57","106","-49","O.W. Strahan"
"1926","Texas St.","7","2","0","0.77778","171","56","115","O.W. Strahan"
"1927","Texas St.","4","4","1","0.5","127","71","56","O.W. Strahan"
"1928","Texas St.","2","7","0","0.22222","48","113","-65","O.W. Strahan"
"1929","Texas St.","6","1","2","0.77778","120","75","45","O.W. Strahan"
"1930","Texas St.","5","2","3","0.65","51","55","-4","O.W. Strahan"
"1931","Texas St.","4","4","0","0.5","67","46","21","O.W. Strahan"
"1932","Texas St.","5","3","0","0.625","82","40","42","O.W. Strahan"
"1933","Texas St.","7","1","1","0.83333","84","30","54","O.W. Strahan"
"1934","Texas St.","2","7","1","0.25","65","91","-26","O.W. Strahan"
"1935","Texas St.","2","7","0","0.22222","45","76","-31","Joe Bailey Cheaney"
"1936","Texas St.","2","5","2","0.33333","65","134","-69","Joe Bailey Cheaney"
"1937","Texas St.","6","4","0","0.6","136","110","26","Joe Bailey Cheaney"
"1938","Texas St.","0","8","0","0","46","152","-106","Joe Bailey Cheaney"
"1939","Texas St.","3","5","2","0.4","50","78","-28","Joe Bailey Cheaney"
"1940","Texas St.","3","5","1","0.38889","100","98","2","Joe Bailey Cheaney"
"1941","Texas St.","4","4","0","0.5","83","56","27","Joe Bailey Cheaney"
"1942","Texas St.","3","4","1","0.4375","83","106","-23","Joe Bailey Cheaney"
"1946","Texas St.","6","2","2","0.7","115","52","63","George West"
"1947","Texas St.","5","4","0","0.55556","115","92","23","George West"
"1948","Texas St.","8","1","0","0.88889","111","34","77","George West"
"1949","Texas St.","3","6","1","0.35","124","168","-44","George West"
"1950","Texas St.","6","3","0","0.66667","145","136","9","George West"
"1951","Texas St.","6","3","1","0.65","271","142","129","Milton Jowers"
"1952","Texas St.","7","2","0","0.77778","261","192","69","Milton Jowers"
"1953","Texas St.","5","4","0","0.55556","241","186","55","Milton Jowers"
"1961","Texas St.","4","5","1","0.45","150","125","25","Milton Jowers"
"1962","Texas St.","8","2","0","0.8","269","126","143","Milton Jowers"
"1963","Texas St.","10","0","0","1","213","81","132","Milton Jowers"
"1954","Texas St.","6","3","1","0.65","160","170","-10","R.W. Parker"
"1955","Texas St.","6","1","2","0.77778","253","103","150","R.W. Parker"
"1956","Texas St.","6","3","0","0.66667","132","101","31","R.W. Parker"
"1957","Texas St.","4","6","0","0.4","139","200","-61","R.W. Parker"
"1958","Texas St.","5","5","0","0.5","114","170","-56","R.W. Parker"
"1959","Texas St.","4","6","0","0.4","115","157","-42","R.W. Parker"
"1960","Texas St.","2","8","0","0.2","64","173","-109","Jack Henry"
"1964","Texas St.","8","2","0","0.8","281","103","178","Milton Jowers & Bill Miller"
"1965","Texas St.","8","2","0","0.8","234","74","160","Bill Miller"
"1966","Texas St.","7","2","1","0.75","181","93","88","Bill Miller"
"1967","Texas St.","9","1","0","0.9","374","108","266","Bill Miller"
"1968","Texas St.","5","5","0","0.5","248","195","53","Bill Miller"
"1969","Texas St.","3","6","1","0.35","219","241","-22","Bill Miller"
"1970","Texas St.","6","5","0","0.54545","256","220","36","Bill Miller"
"1971","Texas St.","8","1","1","0.85","304","133","171","Bill Miller"
"1972","Texas St.","7","3","0","0.7","213","145","68","Bill Miller"
"1973","Texas St.","4","6","0","0.4","161","198","-37","Bill Miller"
"1974","Texas St.","6","4","0","0.6","156","153","3","Bill Miller"
"1975","Texas St.","7","3","0","0.7","209","169","40","Bill Miller"
"1976","Texas St.","5","5","0","0.5","215","204","11","Bill Miller"
"1977","Texas St.","5","4","0","0.55556","168","164","4","Bill Miller"
"1978","Texas St.","6","4","0","0.6","218","124","94","Bill Miller"
"1979","Texas St.","7","4","0","0.63636","271","202","69","Jim Wacker"
"1980","Texas St.","8","3","0","0.72727","356","140","216","Jim Wacker"
"1981","Texas St.","13","1","0","0.92857","554","138","416","Jim Wacker"
"1982","Texas St.","14","0","0","1","446","199","247","Jim Wacker"
"1983","Texas St.","9","2","0","0.81818","358","128","230","John O'Hara"
"1984","Texas St.","7","4","0","0.63636","240","204","36","John O'Hara"
"1985","Texas St.","3","8","0","0.27273","247","262","-15","John O'Hara"
"1986","Texas St.","4","7","0","0.36364","200","234","-34","John O'Hara"
"1987","Texas St.","4","7","0","0.36364","186","254","-68","John O'Hara"
"1988","Texas St.","4","7","0","0.36364","222","281","-59","John O'Hara"
"1989","Texas St.","5","6","0","0.45455","245","198","47","John O'Hara"
"1992","Texas St.","5","5","1","0.5","253","190","63","Jim Bob Helduser"
"1993","Texas St.","2","9","0","0.18182","220","375","-155","Jim Bob Helduser"
"1994","Texas St.","4","7","0","0.36364","223","307","-84","Jim Bob Helduser"
"1995","Texas St.","4","7","0","0.36364","274","303","-29","Jim Bob Helduser"
"1996","Texas St.","5","6","0","0.45455","221","310","-89","Jim Bob Helduser"
"1997","Texas St.","5","6","0","0.45455","273","276","-3","Bob DeBesse"
"1998","Texas St.","4","7","0","0.36364","186","269","-83","Bob DeBesse"
"1999","Texas St.","3","8","0","0.27273","217","210","7","Bob DeBesse"
"2000","Texas St.","7","4","0","0.63636","220","183","37","Bob DeBesse"
"2001","Texas St.","4","7","0","0.36364","188","258","-70","Bob DeBesse"
"2002","Texas St.","4","7","0","0.36364","211","290","-79","Bob DeBesse"
"2003","Texas St.","4","8","0","0.33333","315","417","-102","Manny Matsakis"
"2004","Texas St.","5","6","0","0.45455","283","285","-2","David Bailiff"
"2005","Texas St.","11","3","0","0.78571","518","284","234","David Bailiff"
"2006","Texas St.","5","6","0","0.45455","244","248","-4","David Bailiff"
"2007","Texas St.","4","7","0","0.36364","309","414","-105","Brad Wright"
"2008","Texas St.","8","5","0","0.61538","473","407","66","Brad Wright"
"2009","Texas St.","7","4","0","0.63636","351","317","34","Brad Wright"
"2010","Texas St.","4","7","0","0.36364","273","377","-104","Brad Wright"
"1990","Texas St.","6","5","0","0.54545","268","220","48","Dennis Franchione"
"1991","Texas St.","7","4","0","0.63636","307","179","128","Dennis Franchione"
"2011","Texas St.","6","6","0","0.5","306","342","-36","Dennis Franchione"
"2012","Texas St.","4","8","0","0.33333","343","402","-59","Dennis Franchione"
"2013","Texas St.","6","6","0","0.5","287","328","-41","Dennis Franchione"
"2014","Texas St.","7","5","0","0.58333","406","332","74","Dennis Franchione"
"1925","Texas Tech","6","1","2","0.77778","210","66","144","Ewing Y. Freeland"
"1926","Texas Tech","6","1","3","0.75","106","48","58","Ewing Y. Freeland"
"1927","Texas Tech","5","4","0","0.55556","134","100","34","Ewing Y. Freeland"
"1928","Texas Tech","4","4","1","0.5","47","78","-31","Ewing Y. Freeland"
"1929","Texas Tech","1","7","2","0.2","31","130","-99","Grady Higgenbotham"
"1930","Texas Tech","3","6","0","0.33333","90","121","-31","Pete W. Cawthon"
"1931","Texas Tech","6","3","0","0.66667","150","66","84","Pete W. Cawthon"
"1932","Texas Tech","10","2","0","0.83333","382","35","347","Pete W. Cawthon"
"1933","Texas Tech","8","1","0","0.88889","145","30","115","Pete W. Cawthon"
"1934","Texas Tech","7","2","1","0.75","192","84","108","Pete W. Cawthon"
"1935","Texas Tech","5","3","2","0.6","110","55","55","Pete W. Cawthon"
"1936","Texas Tech","5","4","1","0.55","111","85","26","Pete W. Cawthon"
"1937","Texas Tech","8","4","0","0.66667","163","93","70","Pete W. Cawthon"
"1938","Texas Tech","10","1","0","0.90909","287","55","232","Pete W. Cawthon"
"1939","Texas Tech","5","5","1","0.5","150","74","76","Pete W. Cawthon"
"1940","Texas Tech","9","1","1","0.86364","241","131","110","Pete W. Cawthon"
"1941","Texas Tech","9","2","0","0.81818","226","36","190","Dell Morgan"
"1942","Texas Tech","4","5","1","0.45","111","87","24","Dell Morgan"
"1943","Texas Tech","4","6","0","0.4","128","177","-49","Dell Morgan"
"1944","Texas Tech","4","7","0","0.36364","134","170","-36","Dell Morgan"
"1945","Texas Tech","3","5","2","0.4","63","145","-82","Dell Morgan"
"1946","Texas Tech","8","3","0","0.72727","148","116","32","Dell Morgan"
"1947","Texas Tech","6","5","0","0.54545","184","228","-44","Dell Morgan"
"1948","Texas Tech","7","3","0","0.7","212","135","77","Dell Morgan"
"1949","Texas Tech","7","5","0","0.58333","187","184","3","Dell Morgan"
"1950","Texas Tech","3","8","0","0.27273","222","241","-19","Dell Morgan"
"1951","Texas Tech","7","4","0","0.63636","301","169","132","DeWitt T. Weaver"
"1952","Texas Tech","3","7","1","0.31818","233","239","-6","DeWitt T. Weaver"
"1953","Texas Tech","11","1","0","0.91667","463","167","296","DeWitt T. Weaver"
"1954","Texas Tech","7","2","1","0.75","367","157","210","DeWitt T. Weaver"
"1955","Texas Tech","7","3","1","0.68182","202","166","36","DeWitt T. Weaver"
"1956","Texas Tech","2","7","1","0.25","117","216","-99","DeWitt T. Weaver"
"1957","Texas Tech","2","8","0","0.2","120","190","-70","DeWitt T. Weaver"
"1958","Texas Tech","3","7","0","0.3","126","163","-37","DeWitt T. Weaver"
"1959","Texas Tech","4","6","0","0.4","139","158","-19","DeWitt T. Weaver"
"1960","Texas Tech","3","6","1","0.35","148","182","-34","DeWitt T. Weaver"
"1961","Texas Tech","4","6","0","0.4","94","201","-107","J.T. King"
"1962","Texas Tech","1","9","0","0.1","83","250","-167","J.T. King"
"1963","Texas Tech","5","5","0","0.5","147","178","-31","J.T. King"
"1964","Texas Tech","6","4","1","0.59091","166","120","46","J.T. King"
"1965","Texas Tech","8","3","0","0.72727","278","222","56","J.T. King"
"1966","Texas Tech","4","6","0","0.4","181","216","-35","J.T. King"
"1967","Texas Tech","6","4","0","0.6","217","165","52","J.T. King"
"1968","Texas Tech","5","3","2","0.6","255","241","14","J.T. King"
"1969","Texas Tech","5","5","0","0.5","212","240","-28","J.T. King"
"1970","Texas Tech","8","4","0","0.66667","222","165","57","Jim Carlen"
"1971","Texas Tech","4","7","0","0.36364","131","138","-7","Jim Carlen"
"1972","Texas Tech","8","4","0","0.66667","282","188","94","Jim Carlen"
"1973","Texas Tech","11","1","0","0.91667","342","187","155","Jim Carlen"
"1974","Texas Tech","6","4","2","0.58333","193","158","35","Jim Carlen"
"1975","Texas Tech","6","5","0","0.54545","272","251","21","Steve Sloan"
"1976","Texas Tech","10","2","0","0.83333","336","206","130","Steve Sloan"
"1977","Texas Tech","7","5","0","0.58333","299","246","53","Steve Sloan"
"1978","Texas Tech","7","4","0","0.63636","246","268","-22","Rex Dockery"
"1979","Texas Tech","3","6","2","0.36364","141","182","-41","Rex Dockery"
"1980","Texas Tech","5","6","0","0.45455","178","188","-10","Rex Dockery"
"1981","Texas Tech","1","9","1","0.13636","198","298","-100","Jerry Moore"
"1982","Texas Tech","4","7","0","0.36364","157","234","-77","Jerry Moore"
"1983","Texas Tech","3","7","1","0.31818","160","253","-93","Jerry Moore"
"1984","Texas Tech","4","7","0","0.36364","200","212","-12","Jerry Moore"
"1985","Texas Tech","4","7","0","0.36364","249","240","9","Jerry Moore"
"1986","Texas Tech","7","4","0","0.63636","254","248","6","David McWilliams"
"1986","Texas Tech","0","1","0","0","17","20","-3","Spike Dykes"
"1987","Texas Tech","6","4","1","0.59091","315","266","49","Spike Dykes"
"1988","Texas Tech","5","6","0","0.45455","328","332","-4","Spike Dykes"
"1989","Texas Tech","9","3","0","0.75","360","281","79","Spike Dykes"
"1990","Texas Tech","4","7","0","0.36364","322","356","-34","Spike Dykes"
"1991","Texas Tech","6","5","0","0.54545","315","272","43","Spike Dykes"
"1992","Texas Tech","5","6","0","0.45455","287","332","-45","Spike Dykes"
"1993","Texas Tech","6","6","0","0.5","419","335","84","Spike Dykes"
"1994","Texas Tech","6","6","0","0.5","312","246","66","Spike Dykes"
"1995","Texas Tech","9","3","0","0.75","385","247","138","Spike Dykes"
"1996","Texas Tech","7","5","0","0.58333","323","232","91","Spike Dykes"
"1997","Texas Tech","6","5","0","0.54545","245","217","28","Spike Dykes"
"1998","Texas Tech","7","5","0","0.58333","315","255","60","Spike Dykes"
"1999","Texas Tech","6","5","0","0.54545","253","282","-29","Spike Dykes"
"2000","Texas Tech","7","6","0","0.53846","330","278","52","Mike Leach"
"2001","Texas Tech","7","5","0","0.58333","402","281","121","Mike Leach"
"2002","Texas Tech","9","5","0","0.64286","537","439","98","Mike Leach"
"2003","Texas Tech","8","5","0","0.61538","552","442","110","Mike Leach"
"2004","Texas Tech","8","4","0","0.66667","434","314","120","Mike Leach"
"2005","Texas Tech","9","3","0","0.75","473","226","247","Mike Leach"
"2006","Texas Tech","8","5","0","0.61538","422","326","96","Mike Leach"
"2007","Texas Tech","9","4","0","0.69231","532","337","195","Mike Leach"
"2008","Texas Tech","11","2","0","0.84615","569","362","207","Mike Leach"
"2009","Texas Tech","8","4","0","0.66667","440","261","179","Mike Leach"
"2009","Texas Tech","1","0","0","1","41","31","10","Ruffin McNeill"
"2012","Texas Tech","1","0","0","1","34","31","3","Chris Thomsen"
"2010","Texas Tech","8","5","0","0.61538","430","402","28","Tommy Tuberville"
"2011","Texas Tech","5","7","0","0.41667","406","471","-65","Tommy Tuberville"
"2012","Texas Tech","7","5","0","0.58333","453","382","71","Tommy Tuberville"
"2013","Texas Tech","8","5","0","0.61538","465","397","68","Kliff Kingsbury"
"2014","Texas Tech","4","8","0","0.33333","366","495","-129","Kliff Kingsbury"
"1914","Texas-El Paso","2","3","0","0.4","34","64","-30","Tommy Dwyer"
"1915","Texas-El Paso","3","2","0","0.6","65","60","5","Tommy Dwyer"
"1916","Texas-El Paso","2","3","0","0.4","28","137","-109","Tommy Dwyer"
"1917","Texas-El Paso","0","0","1","0.5","0","0","0","Tommy Dwyer"
"1919","Texas-El Paso","2","4","0","0.33333","67","132","-65","Tommy Dwyer"
"1920","Texas-El Paso","2","4","0","0.33333","73","180","-107","Henderson E. Van Surdam"
"1921","Texas-El Paso","0","5","0","0","14","149","-135","Thomas C. Holiday"
"1922","Texas-El Paso","5","4","0","0.55556","157","108","49","Jack C. Vowell"
"1923","Texas-El Paso","3","4","0","0.42857","115","65","50","Jack C. Vowell"
"1924","Texas-El Paso","3","2","1","0.58333","70","51","19","George B. Powell"
"1925","Texas-El Paso","5","1","1","0.78571","118","57","61","George B. Powell"
"1926","Texas-El Paso","3","4","0","0.42857","106","92","14","George B. Powell"
"1927","Texas-El Paso","2","2","2","0.5","69","69","0","Edward J. ""Doc"" Stewart"
"1928","Texas-El Paso","3","4","1","0.4375","100","103","-3","Edward J. ""Doc"" Stewart"
"1929","Texas-El Paso","6","1","2","0.77778","154","46","108","Mack Saxon"
"1930","Texas-El Paso","7","1","1","0.83333","186","67","119","Mack Saxon"
"1931","Texas-El Paso","7","1","0","0.875","146","83","63","Mack Saxon"
"1932","Texas-El Paso","7","3","0","0.7","222","113","109","Mack Saxon"
"1933","Texas-El Paso","3","5","1","0.38889","71","79","-8","Mack Saxon"
"1934","Texas-El Paso","4","4","0","0.5","128","104","24","Mack Saxon"
"1935","Texas-El Paso","1","8","0","0.11111","23","178","-155","Mack Saxon"
"1936","Texas-El Paso","5","3","1","0.61111","92","86","6","Mack Saxon"
"1937","Texas-El Paso","7","1","2","0.8","215","91","124","Mack Saxon"
"1938","Texas-El Paso","6","3","0","0.66667","153","72","81","Mack Saxon"
"1939","Texas-El Paso","5","4","0","0.55556","110","71","39","Mack Saxon"
"1940","Texas-El Paso","4","4","1","0.5","129","115","14","Mack Saxon"
"1941","Texas-El Paso","4","5","1","0.45","184","192","-8","Mack Saxon"
"1942","Texas-El Paso","5","4","0","0.55556","162","111","51","Walter J. ""Chule"" Milner"
"1946","Texas-El Paso","3","6","0","0.33333","136","150","-14","Jack C. Curtice"
"1947","Texas-El Paso","5","3","1","0.61111","159","79","80","Jack C. Curtice"
"1948","Texas-El Paso","8","2","1","0.77273","361","182","179","Jack C. Curtice"
"1949","Texas-El Paso","8","2","1","0.77273","292","113","179","Jack C. Curtice"
"1950","Texas-El Paso","7","3","0","0.7","279","232","47","Mike Brumbelow"
"1951","Texas-El Paso","3","7","0","0.3","152","241","-89","Mike Brumbelow"
"1952","Texas-El Paso","5","5","1","0.5","228","236","-8","Mike Brumbelow"
"1953","Texas-El Paso","8","2","0","0.8","257","144","113","Mike Brumbelow"
"1954","Texas-El Paso","8","3","0","0.72727","290","197","93","Mike Brumbelow"
"1955","Texas-El Paso","6","2","2","0.7","227","114","113","Mike Brumbelow"
"1956","Texas-El Paso","9","2","0","0.81818","305","78","227","Mike Brumbelow"
"1957","Texas-El Paso","6","3","0","0.66667","202","168","34","Ben Collins"
"1958","Texas-El Paso","2","7","0","0.22222","92","179","-87","Ben Collins"
"1959","Texas-El Paso","3","7","0","0.3","163","191","-28","Ben Collins"
"1960","Texas-El Paso","4","5","1","0.45","167","176","-9","Ben Collins"
"1961","Texas-El Paso","3","7","0","0.3","176","283","-107","Ben Collins"
"1962","Texas-El Paso","4","5","0","0.44444","84","144","-60","Bum Phillips"
"1963","Texas-El Paso","3","7","0","0.3","98","142","-44","Warren Harper"
"1964","Texas-El Paso","0","8","2","0.1","64","217","-153","Warren Harper"
"1965","Texas-El Paso","8","3","0","0.72727","317","206","111","Robert L. ""Bobby"" Dobbs"
"1966","Texas-El Paso","6","4","0","0.6","293","187","106","Robert L. ""Bobby"" Dobbs"
"1967","Texas-El Paso","7","2","1","0.75","337","145","192","Robert L. ""Bobby"" Dobbs"
"1968","Texas-El Paso","4","5","1","0.45","232","225","7","Robert L. ""Bobby"" Dobbs"
"1969","Texas-El Paso","4","6","0","0.4","158","242","-84","Robert L. ""Bobby"" Dobbs"
"1970","Texas-El Paso","6","4","0","0.6","263","236","27","Robert L. ""Bobby"" Dobbs"
"1971","Texas-El Paso","5","6","0","0.45455","166","217","-51","Robert L. ""Bobby"" Dobbs"
"1972","Texas-El Paso","1","5","0","0.16667","104","197","-93","Robert L. ""Bobby"" Dobbs"
"1972","Texas-El Paso","1","3","0","0.25","78","148","-70","Tommy Hudspeth"
"1973","Texas-El Paso","0","11","0","0","142","544","-402","Tommy Hudspeth"
"1974","Texas-El Paso","4","7","0","0.36364","246","298","-52","Gil Bartosh"
"1975","Texas-El Paso","1","10","0","0.09091","109","281","-172","Gil Bartosh"
"1976","Texas-El Paso","1","11","0","0.08333","172","356","-184","Gil Bartosh"
"1977","Texas-El Paso","1","10","0","0.09091","151","460","-309","Bill Michael"
"1978","Texas-El Paso","1","11","0","0.08333","151","424","-273","Bill Michael"
"1979","Texas-El Paso","2","9","0","0.18182","106","266","-160","Bill Michael"
"1980","Texas-El Paso","1","11","0","0.08333","143","424","-281","Bill Michael"
"1981","Texas-El Paso","0","2","0","0","22","51","-29","Bill Michael"
"1981","Texas-El Paso","1","8","0","0.11111","124","390","-266","Bill Alton"
"1982","Texas-El Paso","2","10","0","0.16667","177","417","-240","Bill Yung"
"1983","Texas-El Paso","2","10","0","0.16667","210","359","-149","Bill Yung"
"1984","Texas-El Paso","2","9","0","0.18182","180","374","-194","Bill Yung"
"1985","Texas-El Paso","1","10","0","0.09091","196","375","-179","Bill Yung"
"1986","Texas-El Paso","4","8","0","0.33333","309","391","-82","Bob Stull"
"1987","Texas-El Paso","7","4","0","0.63636","309","234","75","Bob Stull"
"1988","Texas-El Paso","10","3","0","0.76923","445","275","170","Bob Stull"
"1989","Texas-El Paso","2","10","0","0.16667","238","412","-174","David Lee"
"1990","Texas-El Paso","3","8","0","0.27273","191","342","-151","David Lee"
"1991","Texas-El Paso","4","7","1","0.375","254","252","2","David Lee"
"1992","Texas-El Paso","1","10","0","0.09091","254","386","-132","David Lee"
"1993","Texas-El Paso","1","6","0","0.14286","155","254","-99","David Lee"
"1993","Texas-El Paso","0","5","0","0","65","195","-130","Charlie Bailey"
"1994","Texas-El Paso","3","7","1","0.31818","217","359","-142","Charlie Bailey"
"1995","Texas-El Paso","2","10","0","0.16667","263","486","-223","Charlie Bailey"
"1996","Texas-El Paso","2","9","0","0.18182","183","314","-131","Charlie Bailey"
"1997","Texas-El Paso","4","7","0","0.36364","162","311","-149","Charlie Bailey"
"1998","Texas-El Paso","3","8","0","0.27273","226","305","-79","Charlie Bailey"
"1999","Texas-El Paso","5","7","0","0.41667","306","389","-83","Charlie Bailey"
"2000","Texas-El Paso","8","4","0","0.66667","378","336","42","Gary Nord"
"2001","Texas-El Paso","2","9","0","0.18182","235","414","-179","Gary Nord"
"2002","Texas-El Paso","2","10","0","0.16667","220","511","-291","Gary Nord"
"2003","Texas-El Paso","2","11","0","0.15385","288","498","-210","Gary Nord"
"2004","Texas-El Paso","8","4","0","0.66667","429","301","128","Mike Price"
"2005","Texas-El Paso","8","4","0","0.66667","382","311","71","Mike Price"
"2006","Texas-El Paso","5","7","0","0.41667","328","375","-47","Mike Price"
"2007","Texas-El Paso","4","8","0","0.33333","403","445","-42","Mike Price"
"2008","Texas-El Paso","5","7","0","0.41667","395","444","-49","Mike Price"
"2009","Texas-El Paso","4","8","0","0.33333","358","402","-44","Mike Price"
"2010","Texas-El Paso","6","7","0","0.46154","338","357","-19","Mike Price"
"2011","Texas-El Paso","5","7","0","0.41667","319","364","-45","Mike Price"
"2012","Texas-El Paso","3","9","0","0.25","254","357","-103","Mike Price"
"2013","Texas-El Paso","2","10","0","0.16667","261","472","-211","Sean Kugler"
"2014","Texas-El Paso","7","6","0","0.53846","346","365","-19","Sean Kugler"
"2011","Texas-San Antonio","4","6","0","0.4","266","214","52","Larry Coker"
"2012","Texas-San Antonio","8","4","0","0.66667","374","345","29","Larry Coker"
"2013","Texas-San Antonio","7","5","0","0.58333","307","316","-9","Larry Coker"
"2014","Texas-San Antonio","4","8","0","0.33333","205","311","-106","Larry Coker"
"1921","Troy (AL)","1","7","0","0.125","19","284","-265","Professor Campbell"
"1922","Troy (AL)","6","4","1","0.59091","177","92","85","Professor Campbell"
"1923","Troy (AL)","5","3","0","0.625","96","73","23","Professor Campbell"
"1924","Troy (AL)","2","1","4","0.57143","59","20","39","Ross V. ""Flivver"" Ford"
"1925","Troy (AL)","5","3","0","0.625","76","120","-44","Otis Bynum"
"1926","Troy (AL)","7","1","1","0.83333","147","21","126","Otis Bynum"
"1927","Troy (AL)","5","3","0","0.625","195","66","129","Gladwin Gaumer"
"1928","Troy (AL)","2","4","0","0.33333","20","155","-135","Gladwin Gaumer"
"1930","Troy (AL)","1","2","0","0.33333","7","73","-66","No Coach"
"1931","Troy (AL)","6","4","0","0.6","136","99","37","Albert Elmore"
"1932","Troy (AL)","5","3","2","0.6","132","69","63","Albert Elmore"
"1933","Troy (AL)","5","1","0","0.83333","99","26","73","Albert Elmore"
"1934","Troy (AL)","7","2","0","0.77778","170","51","119","Albert Elmore"
"1935","Troy (AL)","5","5","0","0.5","168","169","-1","Albert Elmore"
"1936","Troy (AL)","3","5","0","0.375","39","125","-86","Albert Elmore"
"1937","Troy (AL)","2","7","2","0.27273","43","173","-130","Albert Elmore"
"1938","Troy (AL)","4","4","1","0.5","85","89","-4","Albert Choate"
"1939","Troy (AL)","7","4","0","0.63636","121","71","50","Albert Choate"
"1940","Troy (AL)","3","6","0","0.33333","60","109","-49","Albert Choate"
"1941","Troy (AL)","5","4","0","0.55556","104","125","-21","Albert Choate"
"1942","Troy (AL)","4","3","0","0.57143","129","126","3","Albert Choate"
"1946","Troy (AL)","4","4","0","0.5","58","117","-59","Albert Choate"
"1947","Troy (AL)","5","4","1","0.55","183","109","74","F.G. ""Buddy"" McCollum"
"1948","Troy (AL)","6","5","0","0.54545","171","121","50","F.G. ""Buddy"" McCollum"
"1949","Troy (AL)","6","3","1","0.65","166","105","61","F.G. ""Buddy"" McCollum"
"1950","Troy (AL)","3","6","1","0.35","123","160","-37","F.G. ""Buddy"" McCollum"
"1951","Troy (AL)","2","7","0","0.22222","80","277","-197","Jim Grantham"
"1952","Troy (AL)","4","6","0","0.4","161","225","-64","Jim Grantham"
"1953","Troy (AL)","3","5","0","0.375","66","86","-20","Jim Grantham"
"1954","Troy (AL)","2","5","1","0.3125","98","156","-58","Jim Grantham"
"1955","Troy (AL)","2","6","0","0.25","65","161","-96","William Clipson"
"1956","Troy (AL)","3","5","0","0.375","107","147","-40","William Clipson"
"1957","Troy (AL)","2","6","0","0.25","60","181","-121","William Clipson"
"1958","Troy (AL)","3","6","0","0.33333","128","150","-22","William Clipson"
"1959","Troy (AL)","3","5","0","0.375","107","170","-63","William Clipson"
"1960","Troy (AL)","1","8","0","0.11111","82","236","-154","William Clipson"
"1961","Troy (AL)","1","8","0","0.11111","56","273","-217","William Clipson"
"1962","Troy (AL)","2","6","0","0.25","89","177","-88","William Clipson"
"1963","Troy (AL)","2","7","0","0.22222","64","124","-60","William Clipson"
"1964","Troy (AL)","6","3","0","0.66667","126","122","4","William Clipson"
"1965","Troy (AL)","1","8","0","0.11111","63","236","-173","William Clipson"
"1966","Troy (AL)","5","5","0","0.5","229","186","43","Billy Atkins"
"1967","Troy (AL)","8","2","0","0.8","287","100","187","Billy Atkins"
"1968","Troy (AL)","11","1","0","0.91667","519","158","361","Billy Atkins"
"1969","Troy (AL)","8","1","1","0.85","283","110","173","Billy Atkins"
"1970","Troy (AL)","6","4","1","0.59091","259","198","61","Billy Atkins"
"1971","Troy (AL)","6","3","0","0.66667","178","146","32","Billy Atkins"
"1972","Troy (AL)","4","5","1","0.45","176","143","33","Tom Jones (1)"
"1973","Troy (AL)","7","2","1","0.75","208","111","97","Tom Jones (1)"
"1974","Troy (AL)","6","4","0","0.6","274","218","56","Byrd Whigham"
"1975","Troy (AL)","6","4","0","0.6","194","172","22","Byrd Whigham"
"1976","Troy (AL)","8","1","1","0.85","206","119","87","Charlie Bradshaw"
"1977","Troy (AL)","6","4","0","0.6","214","194","20","Charlie Bradshaw"
"1978","Troy (AL)","8","2","0","0.8","229","144","85","Charlie Bradshaw"
"1979","Troy (AL)","6","3","1","0.65","234","116","118","Charlie Bradshaw"
"1980","Troy (AL)","8","2","0","0.8","282","105","177","Charlie Bradshaw"
"1981","Troy (AL)","3","7","0","0.3","182","192","-10","Charlie Bradshaw"
"1982","Troy (AL)","2","8","0","0.2","177","210","-33","Charlie Bradshaw"
"1983","Troy (AL)","7","4","0","0.63636","263","226","37","Chan Gailey"
"1984","Troy (AL)","12","1","0","0.92308","372","185","187","Chan Gailey"
"1985","Troy (AL)","6","4","0","0.6","256","161","95","Rick Rhoades"
"1986","Troy (AL)","10","2","0","0.83333","403","239","164","Rick Rhoades"
"1987","Troy (AL)","12","1","1","0.89286","467","166","301","Rick Rhoades"
"1988","Troy (AL)","4","6","0","0.4","215","184","31","Robert Maddox"
"1989","Troy (AL)","4","6","0","0.4","160","230","-70","Robert Maddox"
"1990","Troy (AL)","5","5","0","0.5","228","209","19","Robert Maddox"
"1991","Troy (AL)","5","6","0","0.45455","230","200","30","Larry Blakeney"
"1992","Troy (AL)","10","1","0","0.90909","295","122","173","Larry Blakeney"
"1993","Troy (AL)","12","1","1","0.89286","505","227","278","Larry Blakeney"
"1994","Troy (AL)","8","4","0","0.66667","430","326","104","Larry Blakeney"
"1995","Troy (AL)","11","1","0","0.91667","446","174","272","Larry Blakeney"
"1996","Troy (AL)","12","2","0","0.85714","434","252","182","Larry Blakeney"
"1997","Troy (AL)","5","6","0","0.45455","217","157","60","Larry Blakeney"
"1998","Troy (AL)","8","4","0","0.66667","235","203","32","Larry Blakeney"
"1999","Troy (AL)","11","2","0","0.84615","362","224","138","Larry Blakeney"
"2000","Troy (AL)","10","2","0","0.83333","330","193","137","Larry Blakeney"
"2001","Troy (AL)","7","4","0","0.63636","246","269","-23","Larry Blakeney"
"2002","Troy (AL)","4","8","0","0.33333","218","252","-34","Larry Blakeney"
"2003","Troy (AL)","6","6","0","0.5","185","272","-87","Larry Blakeney"
"2004","Troy (AL)","7","5","0","0.58333","286","200","86","Larry Blakeney"
"2005","Troy (AL)","4","7","0","0.36364","175","255","-80","Larry Blakeney"
"2006","Troy (AL)","8","5","0","0.61538","296","289","7","Larry Blakeney"
"2007","Troy (AL)","8","4","0","0.66667","408","295","113","Larry Blakeney"
"2008","Troy (AL)","8","5","0","0.61538","426","277","149","Larry Blakeney"
"2009","Troy (AL)","9","4","0","0.69231","438","387","51","Larry Blakeney"
"2010","Troy (AL)","8","5","0","0.61538","443","393","50","Larry Blakeney"
"2011","Troy (AL)","3","9","0","0.25","269","404","-135","Larry Blakeney"
"2012","Troy (AL)","5","7","0","0.41667","367","366","1","Larry Blakeney"
"2013","Troy (AL)","6","6","0","0.5","409","431","-22","Larry Blakeney"
"2014","Troy (AL)","3","9","0","0.25","262","434","-172","Larry Blakeney"
"1894","Tulane (LA)","0","4","0","0","14","50","-36","Fred Sweet"
"1893","Tulane (LA)","1","2","0","0.33333","38","24","14","T.L. Bayne"
"1895","Tulane (LA)","3","2","0","0.6","66","28","38","T.L. Bayne"
"1896","Tulane (LA)","3","2","0","0.6","74","18","56","Harry W. Baum"
"1898","Tulane (LA)","1","1","0","0.5","14","46","-32","John Lombard"
"1899","Tulane (LA)","0","6","1","0.07143","0","141","-141","H.H. Collier"
"1900","Tulane (LA)","5","0","0","1","105","0","105","H.T. Summersgill"
"1901","Tulane (LA)","4","2","0","0.66667","117","19","98","H.T. Summersgill"
"1902","Tulane (LA)","1","4","2","0.28571","47","67","-20","Virginius Dabney"
"1903","Tulane (LA)","2","2","1","0.5","64","56","8","Charles Eshieman"
"1904","Tulane (LA)","5","2","0","0.71429","58","24","34","Thomas A. ""Tom"" Berry & J. Janvier"
"1905","Tulane (LA)","0","1","0","0","0","5","-5","John Tobin & Harry Ludlow"
"1906","Tulane (LA)","0","4","1","0.1","0","92","-92","John Russ"
"1907","Tulane (LA)","3","2","0","0.6","71","44","27","Joe Curtis"
"1908","Tulane (LA)","7","1","0","0.875","103","23","80","Joe Curtis"
"1909","Tulane (LA)","4","3","2","0.55556","40","50","-10","Robert Roswell ""Buster"" Brown"
"1910","Tulane (LA)","0","7","0","0","6","126","-120","Appleton A. Mason"
"1911","Tulane (LA)","5","3","1","0.61111","106","46","60","Appleton A. Mason"
"1912","Tulane (LA)","5","3","0","0.625","216","99","117","Appleton A. Mason"
"1913","Tulane (LA)","3","5","0","0.375","59","150","-91","A.C. Hoffman"
"1914","Tulane (LA)","3","3","1","0.5","145","147","-2","Edwin R. Sweetland"
"1915","Tulane (LA)","4","4","0","0.5","118","78","40","Clark D. Shaughnessy"
"1916","Tulane (LA)","4","3","1","0.5625","126","149","-23","Clark D. Shaughnessy"
"1917","Tulane (LA)","5","3","0","0.625","159","105","54","Clark D. Shaughnessy"
"1918","Tulane (LA)","4","1","1","0.75","133","16","117","Clark D. Shaughnessy"
"1919","Tulane (LA)","6","2","1","0.72222","224","55","169","Clark D. Shaughnessy"
"1920","Tulane (LA)","6","2","1","0.72222","181","28","153","Clark D. Shaughnessy"
"1922","Tulane (LA)","4","4","0","0.5","136","100","36","Clark D. Shaughnessy"
"1923","Tulane (LA)","6","3","1","0.65","117","89","28","Clark D. Shaughnessy"
"1924","Tulane (LA)","8","1","0","0.88889","201","59","142","Clark D. Shaughnessy"
"1925","Tulane (LA)","9","0","1","0.95","246","23","223","Clark D. Shaughnessy"
"1926","Tulane (LA)","3","5","1","0.38889","71","60","11","Clark D. Shaughnessy"
"1921","Tulane (LA)","4","6","0","0.4","84","97","-13","Myron E. Fuller"
"1927","Tulane (LA)","2","5","1","0.3125","56","120","-64","Bernard W. ""Bernie"" Bierman"
"1928","Tulane (LA)","6","3","1","0.65","264","76","188","Bernard W. ""Bernie"" Bierman"
"1929","Tulane (LA)","9","0","0","1","279","45","234","Bernard W. ""Bernie"" Bierman"
"1930","Tulane (LA)","8","1","0","0.88889","263","30","233","Bernard W. ""Bernie"" Bierman"
"1931","Tulane (LA)","11","1","0","0.91667","350","56","294","Bernard W. ""Bernie"" Bierman"
"1932","Tulane (LA)","6","2","1","0.72222","131","95","36","Theodore J. ""Ted"" Cox"
"1933","Tulane (LA)","6","3","1","0.65","160","68","92","Theodore J. ""Ted"" Cox"
"1934","Tulane (LA)","10","1","0","0.90909","215","83","132","Theodore J. ""Ted"" Cox"
"1935","Tulane (LA)","6","4","0","0.6","156","123","33","Theodore J. ""Ted"" Cox"
"1936","Tulane (LA)","6","3","1","0.65","163","117","46","Lowell P. ""Red"" Dawson"
"1937","Tulane (LA)","5","4","1","0.55","164","69","95","Lowell P. ""Red"" Dawson"
"1938","Tulane (LA)","7","2","1","0.75","211","53","158","Lowell P. ""Red"" Dawson"
"1939","Tulane (LA)","8","1","1","0.85","194","60","134","Lowell P. ""Red"" Dawson"
"1940","Tulane (LA)","5","5","0","0.5","144","126","18","Lowell P. ""Red"" Dawson"
"1941","Tulane (LA)","5","4","0","0.55556","220","95","125","Lowell P. ""Red"" Dawson"
"1942","Tulane (LA)","4","5","0","0.44444","121","154","-33","Claude Simons, Jr."
"1943","Tulane (LA)","3","3","0","0.5","92","94","-2","Claude Simons, Jr."
"1944","Tulane (LA)","4","3","0","0.57143","113","125","-12","Claude Simons, Jr."
"1945","Tulane (LA)","2","6","1","0.27778","93","212","-119","Claude Simons, Jr."
"1946","Tulane (LA)","3","7","0","0.3","179","209","-30","Henry E. Frnka"
"1947","Tulane (LA)","2","5","2","0.33333","94","192","-98","Henry E. Frnka"
"1948","Tulane (LA)","9","1","0","0.9","207","60","147","Henry E. Frnka"
"1949","Tulane (LA)","7","2","1","0.75","251","142","109","Henry E. Frnka"
"1950","Tulane (LA)","6","2","1","0.72222","260","97","163","Henry E. Frnka"
"1951","Tulane (LA)","4","6","0","0.4","143","172","-29","Henry E. Frnka"
"1952","Tulane (LA)","5","5","0","0.5","188","146","42","Raymond ""Bear"" Wolf"
"1953","Tulane (LA)","1","8","1","0.15","129","228","-99","Raymond ""Bear"" Wolf"
"1954","Tulane (LA)","1","6","3","0.25","46","144","-98","Anton ""Andy"" Pilney"
"1955","Tulane (LA)","5","4","1","0.55","163","136","27","Anton ""Andy"" Pilney"
"1956","Tulane (LA)","6","4","0","0.6","124","123","1","Anton ""Andy"" Pilney"
"1957","Tulane (LA)","2","8","0","0.2","91","195","-104","Anton ""Andy"" Pilney"
"1958","Tulane (LA)","3","7","0","0.3","105","189","-84","Anton ""Andy"" Pilney"
"1959","Tulane (LA)","3","6","1","0.35","94","176","-82","Anton ""Andy"" Pilney"
"1960","Tulane (LA)","3","6","1","0.35","132","140","-8","Anton ""Andy"" Pilney"
"1961","Tulane (LA)","2","8","0","0.2","60","225","-165","Anton ""Andy"" Pilney"
"1962","Tulane (LA)","0","10","0","0","76","293","-217","Thomas J. ""Tommy"" O'Boyle"
"1963","Tulane (LA)","1","8","1","0.15","43","191","-148","Thomas J. ""Tommy"" O'Boyle"
"1964","Tulane (LA)","3","7","0","0.3","79","147","-68","Thomas J. ""Tommy"" O'Boyle"
"1965","Tulane (LA)","2","8","0","0.2","71","268","-197","Thomas J. ""Tommy"" O'Boyle"
"1966","Tulane (LA)","5","4","1","0.55","153","182","-29","Jim Pittman"
"1967","Tulane (LA)","3","7","0","0.3","164","223","-59","Jim Pittman"
"1968","Tulane (LA)","2","8","0","0.2","163","300","-137","Jim Pittman"
"1969","Tulane (LA)","3","7","0","0.3","152","235","-83","Jim Pittman"
"1970","Tulane (LA)","8","4","0","0.66667","196","160","36","Jim Pittman"
"1971","Tulane (LA)","3","8","0","0.27273","152","215","-63","Bennie Ellender"
"1972","Tulane (LA)","6","5","0","0.54545","212","165","47","Bennie Ellender"
"1973","Tulane (LA)","9","3","0","0.75","228","194","34","Bennie Ellender"
"1974","Tulane (LA)","5","6","0","0.45455","176","214","-38","Bennie Ellender"
"1975","Tulane (LA)","4","7","0","0.36364","123","192","-69","Bennie Ellender"
"1976","Tulane (LA)","2","9","0","0.18182","149","228","-79","Larry Smith"
"1977","Tulane (LA)","3","8","0","0.27273","181","289","-108","Larry Smith"
"1978","Tulane (LA)","4","7","0","0.36364","183","211","-28","Larry Smith"
"1979","Tulane (LA)","9","3","0","0.75","320","179","141","Larry Smith"
"1980","Tulane (LA)","7","5","0","0.58333","279","243","36","Vince Gibson"
"1981","Tulane (LA)","6","5","0","0.54545","213","144","69","Vince Gibson"
"1982","Tulane (LA)","4","7","0","0.36364","201","271","-70","Vince Gibson"
"1983","Tulane (LA)","2","9","0","0.18182","192","241","-49","Wally English"
"1984","Tulane (LA)","3","8","0","0.27273","177","275","-98","Wally English"
"1985","Tulane (LA)","1","10","0","0.09091","166","334","-168","Mack Brown"
"1986","Tulane (LA)","4","7","0","0.36364","265","334","-69","Mack Brown"
"1987","Tulane (LA)","6","6","0","0.5","370","376","-6","Mack Brown"
"1988","Tulane (LA)","5","6","0","0.45455","251","334","-83","Greg Davis"
"1989","Tulane (LA)","4","8","0","0.33333","247","337","-90","Greg Davis"
"1990","Tulane (LA)","4","7","0","0.36364","237","253","-16","Greg Davis"
"1991","Tulane (LA)","1","10","0","0.09091","146","384","-238","Greg Davis"
"1992","Tulane (LA)","2","9","0","0.18182","146","349","-203","Eugene ""Buddy"" Teevens"
"1993","Tulane (LA)","4","8","0","0.33333","154","355","-201","Eugene ""Buddy"" Teevens"
"1994","Tulane (LA)","1","10","0","0.09091","135","358","-223","Eugene ""Buddy"" Teevens"
"1995","Tulane (LA)","2","9","0","0.18182","187","303","-116","Eugene ""Buddy"" Teevens"
"1996","Tulane (LA)","2","9","0","0.18182","213","268","-55","Eugene ""Buddy"" Teevens"
"1997","Tulane (LA)","7","4","0","0.63636","375","225","150","Tommy Bowden"
"1998","Tulane (LA)","11","0","0","1","499","268","231","Tommy Bowden"
"1998","Tulane (LA)","1","0","0","1","41","27","14","Chris Scelfo"
"1999","Tulane (LA)","3","8","0","0.27273","279","399","-120","Chris Scelfo"
"2000","Tulane (LA)","6","5","0","0.54545","329","346","-17","Chris Scelfo"
"2001","Tulane (LA)","3","9","0","0.25","344","495","-151","Chris Scelfo"
"2002","Tulane (LA)","8","5","0","0.61538","361","282","79","Chris Scelfo"
"2003","Tulane (LA)","5","7","0","0.41667","337","424","-87","Chris Scelfo"
"2004","Tulane (LA)","5","6","0","0.45455","300","361","-61","Chris Scelfo"
"2005","Tulane (LA)","2","9","0","0.18182","234","348","-114","Chris Scelfo"
"2006","Tulane (LA)","4","8","0","0.33333","224","400","-176","Chris Scelfo"
"2007","Tulane (LA)","4","8","0","0.33333","293","375","-82","Bob Toledo"
"2008","Tulane (LA)","2","10","0","0.16667","200","414","-214","Bob Toledo"
"2009","Tulane (LA)","3","9","0","0.25","193","440","-247","Bob Toledo"
"2010","Tulane (LA)","4","8","0","0.33333","299","446","-147","Bob Toledo"
"2011","Tulane (LA)","2","5","0","0.28571","173","248","-75","Bob Toledo"
"2011","Tulane (LA)","0","6","0","0","101","239","-138","Mark Hutson"
"2012","Tulane (LA)","2","10","0","0.16667","257","461","-204","Curtis Johnson"
"2013","Tulane (LA)","7","6","0","0.53846","322","278","44","Curtis Johnson"
"2014","Tulane (LA)","3","9","0","0.25","192","341","-149","Curtis Johnson"
"1895","Tulsa (OK)","1","0","0","1","1","0","1","Norman Leard"
"1896","Tulsa (OK)","2","1","0","0.66667","2","6","-4","Norman Leard"
"1897","Tulsa (OK)","2","1","0","0.66667","2","1","1","Norman Leard"
"1898","Tulsa (OK)","1","0","0","1","1","0","1","Fred Taylor (2)"
"1899","Tulsa (OK)","0","1","1","0.25","0","11","-11","Fred Taylor (2)"
"1902","Tulsa (OK)","61","58","6","0.512","1159","1140","19","Unknown"
"1908","Tulsa (OK)","2","3","0","0.4","80","43","37","Sam McBirney"
"1914","Tulsa (OK)","6","2","0","0.75","261","48","213","Sam McBirney"
"1915","Tulsa (OK)","6","1","1","0.8125","257","33","224","Sam McBirney"
"1916","Tulsa (OK)","10","0","0","1","566","40","526","Sam McBirney"
"1912","Tulsa (OK)","1","4","0","0.2","75","141","-66","Harvey L. Allen"
"1913","Tulsa (OK)","5","2","0","0.71429","271","59","212","George ""Red"" Evans"
"1917","Tulsa (OK)","0","8","1","0.05556","61","221","-160","Hal Medford"
"1918","Tulsa (OK)","1","2","0","0.33333","9","56","-47","Arthur F. ""Art"" Smith"
"1919","Tulsa (OK)","8","0","1","0.94444","591","27","564","Francis A. Schmidt"
"1920","Tulsa (OK)","10","0","1","0.95455","621","21","600","Francis A. Schmidt"
"1921","Tulsa (OK)","6","3","0","0.66667","257","95","162","Francis A. Schmidt"
"1922","Tulsa (OK)","8","1","0","0.88889","156","60","96","Howard M. Acher"
"1923","Tulsa (OK)","2","5","1","0.3125","107","165","-58","Howard M. Acher"
"1924","Tulsa (OK)","1","7","1","0.16667","24","177","-153","Howard M. Acher"
"1925","Tulsa (OK)","6","2","0","0.75","128","91","37","Elmer C. ""Gus"" Henderson"
"1926","Tulsa (OK)","7","2","0","0.77778","169","56","113","Elmer C. ""Gus"" Henderson"
"1927","Tulsa (OK)","8","1","0","0.88889","206","84","122","Elmer C. ""Gus"" Henderson"
"1928","Tulsa (OK)","7","2","1","0.75","273","80","193","Elmer C. ""Gus"" Henderson"
"1929","Tulsa (OK)","6","3","1","0.65","107","81","26","Elmer C. ""Gus"" Henderson"
"1930","Tulsa (OK)","7","2","0","0.77778","171","79","92","Elmer C. ""Gus"" Henderson"
"1931","Tulsa (OK)","8","3","0","0.72727","256","55","201","Elmer C. ""Gus"" Henderson"
"1932","Tulsa (OK)","7","1","1","0.83333","175","36","139","Elmer C. ""Gus"" Henderson"
"1933","Tulsa (OK)","6","1","0","0.85714","93","19","74","Elmer C. ""Gus"" Henderson"
"1934","Tulsa (OK)","5","2","1","0.6875","106","39","67","Elmer C. ""Gus"" Henderson"
"1935","Tulsa (OK)","3","6","1","0.35","58","94","-36","Elmer C. ""Gus"" Henderson"
"1936","Tulsa (OK)","5","2","2","0.66667","154","56","98","Victor C. ""Vic"" Hurt"
"1937","Tulsa (OK)","6","2","2","0.7","195","90","105","Victor C. ""Vic"" Hurt"
"1938","Tulsa (OK)","4","5","1","0.45","115","148","-33","Victor C. ""Vic"" Hurt"
"1939","Tulsa (OK)","4","5","1","0.45","94","104","-10","Chester ""Chet"" Benefiel"
"1940","Tulsa (OK)","7","3","0","0.7","166","112","54","Chester ""Chet"" Benefiel"
"1941","Tulsa (OK)","8","2","0","0.8","194","65","129","Henry E. Frnka"
"1942","Tulsa (OK)","10","1","0","0.90909","434","46","388","Henry E. Frnka"
"1943","Tulsa (OK)","6","1","1","0.8125","269","52","217","Henry E. Frnka"
"1944","Tulsa (OK)","8","2","0","0.8","380","128","252","Henry E. Frnka"
"1945","Tulsa (OK)","8","3","0","0.72727","275","84","191","Henry E. Frnka"
"1946","Tulsa (OK)","9","1","0","0.9","295","83","212","John O. ""Buddy"" Brothers"
"1947","Tulsa (OK)","5","5","0","0.5","143","128","15","John O. ""Buddy"" Brothers"
"1948","Tulsa (OK)","0","9","1","0.05","135","330","-195","John O. ""Buddy"" Brothers"
"1949","Tulsa (OK)","5","5","1","0.5","223","233","-10","John O. ""Buddy"" Brothers"
"1950","Tulsa (OK)","9","1","1","0.86364","339","124","215","John O. ""Buddy"" Brothers"
"1951","Tulsa (OK)","9","2","0","0.81818","371","200","171","John O. ""Buddy"" Brothers"
"1952","Tulsa (OK)","8","2","1","0.77273","341","197","144","John O. ""Buddy"" Brothers"
"1953","Tulsa (OK)","3","7","0","0.3","117","258","-141","Bernard F. ""Bernie"" Witucki"
"1954","Tulsa (OK)","0","11","0","0","118","338","-220","Bernard F. ""Bernie"" Witucki"
"1955","Tulsa (OK)","2","7","1","0.25","124","232","-108","Robert L. ""Bobby"" Dobbs"
"1956","Tulsa (OK)","7","2","1","0.75","169","76","93","Robert L. ""Bobby"" Dobbs"
"1957","Tulsa (OK)","4","6","0","0.4","110","145","-35","Robert L. ""Bobby"" Dobbs"
"1958","Tulsa (OK)","7","3","0","0.7","216","100","116","Robert L. ""Bobby"" Dobbs"
"1959","Tulsa (OK)","5","5","0","0.5","137","164","-27","Robert L. ""Bobby"" Dobbs"
"1960","Tulsa (OK)","5","5","0","0.5","169","230","-61","Robert L. ""Bobby"" Dobbs"
"1961","Tulsa (OK)","2","8","0","0.2","91","205","-114","Glenn Dobbs"
"1962","Tulsa (OK)","5","5","0","0.5","219","181","38","Glenn Dobbs"
"1963","Tulsa (OK)","5","5","0","0.5","214","241","-27","Glenn Dobbs"
"1964","Tulsa (OK)","9","2","0","0.81818","398","140","258","Glenn Dobbs"
"1965","Tulsa (OK)","8","3","0","0.72727","321","171","150","Glenn Dobbs"
"1966","Tulsa (OK)","6","4","0","0.6","220","203","17","Glenn Dobbs"
"1967","Tulsa (OK)","7","3","0","0.7","304","155","149","Glenn Dobbs"
"1968","Tulsa (OK)","3","7","0","0.3","149","314","-165","Glenn Dobbs"
"1969","Tulsa (OK)","1","9","0","0.1","183","377","-194","Vince Carillot"
"1970","Tulsa (OK)","6","4","0","0.6","187","178","9","Claude Gibson"
"1971","Tulsa (OK)","4","7","0","0.36364","173","297","-124","Claude Gibson"
"1972","Tulsa (OK)","1","5","0","0.16667","70","142","-72","Claude Gibson"
"1972","Tulsa (OK)","3","2","0","0.6","125","127","-2","F.A. Dry"
"1973","Tulsa (OK)","6","5","0","0.54545","258","193","65","F.A. Dry"
"1974","Tulsa (OK)","8","3","0","0.72727","285","204","81","F.A. Dry"
"1975","Tulsa (OK)","7","4","0","0.63636","368","181","187","F.A. Dry"
"1976","Tulsa (OK)","7","4","1","0.625","253","208","45","F.A. Dry"
"1977","Tulsa (OK)","3","8","0","0.27273","192","398","-206","John Cooper"
"1978","Tulsa (OK)","9","2","0","0.81818","289","203","86","John Cooper"
"1979","Tulsa (OK)","6","5","0","0.54545","195","221","-26","John Cooper"
"1980","Tulsa (OK)","8","3","0","0.72727","243","196","47","John Cooper"
"1981","Tulsa (OK)","6","5","0","0.54545","304","196","108","John Cooper"
"1982","Tulsa (OK)","10","1","0","0.90909","342","196","146","John Cooper"
"1983","Tulsa (OK)","8","3","0","0.72727","297","185","112","John Cooper"
"1984","Tulsa (OK)","6","5","0","0.54545","261","206","55","John Cooper"
"1985","Tulsa (OK)","6","5","0","0.54545","274","328","-54","Don Morton"
"1986","Tulsa (OK)","7","4","0","0.63636","293","186","107","Don Morton"
"1987","Tulsa (OK)","3","8","0","0.27273","175","371","-196","George Henshaw"
"1988","Tulsa (OK)","4","7","0","0.36364","254","318","-64","Dave Rader"
"1989","Tulsa (OK)","6","6","0","0.5","302","271","31","Dave Rader"
"1990","Tulsa (OK)","3","8","0","0.27273","183","281","-98","Dave Rader"
"1991","Tulsa (OK)","10","2","0","0.83333","333","225","108","Dave Rader"
"1992","Tulsa (OK)","4","7","0","0.36364","240","303","-63","Dave Rader"
"1993","Tulsa (OK)","4","6","1","0.40909","262","273","-11","Dave Rader"
"1994","Tulsa (OK)","3","8","0","0.27273","244","304","-60","Dave Rader"
"1995","Tulsa (OK)","4","7","0","0.36364","233","300","-67","Dave Rader"
"1996","Tulsa (OK)","4","7","0","0.36364","245","333","-88","Dave Rader"
"1997","Tulsa (OK)","2","9","0","0.18182","258","426","-168","Dave Rader"
"1998","Tulsa (OK)","4","7","0","0.36364","222","258","-36","Dave Rader"
"1999","Tulsa (OK)","1","6","0","0.14286","125","274","-149","Dave Rader"
"1999","Tulsa (OK)","1","3","0","0.25","105","112","-7","Pat Henderson"
"2000","Tulsa (OK)","5","7","0","0.41667","240","283","-43","Keith Burns"
"2001","Tulsa (OK)","1","10","0","0.09091","191","387","-196","Keith Burns"
"2002","Tulsa (OK)","1","11","0","0.08333","233","417","-184","Keith Burns"
"2003","Tulsa (OK)","8","5","0","0.61538","400","361","39","Steve Kragthorpe"
"2004","Tulsa (OK)","4","8","0","0.33333","348","398","-50","Steve Kragthorpe"
"2005","Tulsa (OK)","9","4","0","0.69231","430","305","125","Steve Kragthorpe"
"2006","Tulsa (OK)","8","5","0","0.61538","360","262","98","Steve Kragthorpe"
"2007","Tulsa (OK)","10","4","0","0.71429","576","467","109","Todd Graham"
"2008","Tulsa (OK)","11","3","0","0.78571","661","391","270","Todd Graham"
"2009","Tulsa (OK)","5","7","0","0.41667","351","328","23","Todd Graham"
"2010","Tulsa (OK)","10","3","0","0.76923","538","394","144","Todd Graham"
"2011","Tulsa (OK)","8","5","0","0.61538","430","355","75","Bill Blankenship"
"2012","Tulsa (OK)","11","3","0","0.78571","486","331","155","Bill Blankenship"
"2013","Tulsa (OK)","3","9","0","0.25","253","407","-154","Bill Blankenship"
"2014","Tulsa (OK)","2","10","0","0.16667","296","471","-175","Bill Blankenship"
"1919","UCLA","2","6","0","0.25","52","193","-141","Fred W. Cozens"
"1920","UCLA","0","5","0","0","21","224","-203","Harry Trotter"
"1921","UCLA","0","5","0","0","14","214","-200","Harry Trotter"
"1922","UCLA","2","3","1","0.41667","84","62","22","Harry Trotter"
"1923","UCLA","2","5","0","0.28571","54","132","-78","James J. Cline"
"1924","UCLA","0","5","3","0.1875","40","109","-69","James J. Cline"
"1925","UCLA","6","3","1","0.65","104","137","-33","William H. ""Bill"" Spaulding"
"1926","UCLA","5","3","0","0.625","153","67","86","William H. ""Bill"" Spaulding"
"1927","UCLA","6","2","1","0.72222","144","54","90","William H. ""Bill"" Spaulding"
"1928","UCLA","4","4","1","0.5","171","136","35","William H. ""Bill"" Spaulding"
"1929","UCLA","4","4","0","0.5","121","190","-69","William H. ""Bill"" Spaulding"
"1930","UCLA","3","5","0","0.375","77","125","-48","William H. ""Bill"" Spaulding"
"1931","UCLA","3","4","1","0.4375","83","57","26","William H. ""Bill"" Spaulding"
"1932","UCLA","6","4","0","0.6","149","61","88","William H. ""Bill"" Spaulding"
"1933","UCLA","6","4","1","0.59091","123","62","61","William H. ""Bill"" Spaulding"
"1934","UCLA","7","3","0","0.7","146","69","77","William H. ""Bill"" Spaulding"
"1935","UCLA","8","2","0","0.8","160","79","81","William H. ""Bill"" Spaulding"
"1936","UCLA","6","3","1","0.65","143","91","52","William H. ""Bill"" Spaulding"
"1937","UCLA","2","6","1","0.27778","93","133","-40","William H. ""Bill"" Spaulding"
"1938","UCLA","7","4","1","0.625","217","106","111","William H. ""Bill"" Spaulding"
"1939","UCLA","6","0","4","0.8","127","62","65","Edwin C. ""Babe"" Horrell"
"1940","UCLA","1","9","0","0.1","79","174","-95","Edwin C. ""Babe"" Horrell"
"1941","UCLA","5","5","1","0.5","128","178","-50","Edwin C. ""Babe"" Horrell"
"1942","UCLA","7","4","0","0.63636","174","98","76","Edwin C. ""Babe"" Horrell"
"1943","UCLA","1","8","0","0.11111","59","199","-140","Edwin C. ""Babe"" Horrell"
"1944","UCLA","4","5","1","0.45","189","149","40","Edwin C. ""Babe"" Horrell"
"1945","UCLA","5","4","0","0.55556","135","79","56","Bert LaBrucherie"
"1946","UCLA","10","1","0","0.90909","327","117","210","Bert LaBrucherie"
"1947","UCLA","5","4","0","0.55556","172","80","92","Bert LaBrucherie"
"1948","UCLA","3","7","0","0.3","156","235","-79","Bert LaBrucherie"
"1949","UCLA","6","3","0","0.66667","227","188","39","Harry R. ""Red"" Sanders"
"1950","UCLA","6","3","0","0.66667","196","96","100","Harry R. ""Red"" Sanders"
"1951","UCLA","5","3","1","0.61111","188","120","68","Harry R. ""Red"" Sanders"
"1952","UCLA","8","1","0","0.88889","220","55","165","Harry R. ""Red"" Sanders"
"1953","UCLA","8","2","0","0.8","224","76","148","Harry R. ""Red"" Sanders"
"1954","UCLA","9","0","0","1","367","40","327","Harry R. ""Red"" Sanders"
"1955","UCLA","9","2","0","0.81818","299","74","225","Harry R. ""Red"" Sanders"
"1956","UCLA","7","3","0","0.7","148","122","26","Harry R. ""Red"" Sanders"
"1957","UCLA","8","2","0","0.8","190","90","100","Harry R. ""Red"" Sanders"
"1958","UCLA","1","2","0","0.33333","24","55","-31","George W. Dickerson"
"1958","UCLA","2","4","1","0.35714","112","118","-6","William F. ""Bill"" Barnes"
"1959","UCLA","5","4","1","0.55","169","150","19","William F. ""Bill"" Barnes"
"1960","UCLA","7","2","1","0.75","175","84","91","William F. ""Bill"" Barnes"
"1961","UCLA","7","4","0","0.63636","185","142","43","William F. ""Bill"" Barnes"
"1962","UCLA","4","6","0","0.4","118","139","-21","William F. ""Bill"" Barnes"
"1963","UCLA","2","8","0","0.2","96","219","-123","William F. ""Bill"" Barnes"
"1964","UCLA","4","6","0","0.4","145","236","-91","William F. ""Bill"" Barnes"
"1965","UCLA","8","2","1","0.77273","257","168","89","J. Thompson ""Tommy"" Prothro"
"1966","UCLA","9","1","0","0.9","281","127","154","J. Thompson ""Tommy"" Prothro"
"1967","UCLA","7","2","1","0.75","284","161","123","J. Thompson ""Tommy"" Prothro"
"1968","UCLA","3","7","0","0.3","197","246","-49","J. Thompson ""Tommy"" Prothro"
"1969","UCLA","8","1","1","0.85","329","103","226","J. Thompson ""Tommy"" Prothro"
"1970","UCLA","6","5","0","0.54545","274","240","34","J. Thompson ""Tommy"" Prothro"
"1971","UCLA","2","7","1","0.25","166","243","-77","Pepper Rodgers"
"1972","UCLA","8","3","0","0.72727","351","239","112","Pepper Rodgers"
"1973","UCLA","9","2","0","0.81818","470","199","271","Pepper Rodgers"
"1974","UCLA","6","3","2","0.63636","240","174","66","Dick Vermeil"
"1975","UCLA","9","2","1","0.79167","349","243","106","Dick Vermeil"
"1976","UCLA","9","2","1","0.79167","391","173","218","Terry Donahue"
"1977","UCLA","0","11","0","0","269","196","73","Terry Donahue"
"1978","UCLA","8","3","1","0.70833","261","172","89","Terry Donahue"
"1979","UCLA","5","6","0","0.45455","257","256","1","Terry Donahue"
"1980","UCLA","9","2","0","0.81818","306","135","171","Terry Donahue"
"1981","UCLA","7","4","1","0.625","302","197","105","Terry Donahue"
"1982","UCLA","10","1","1","0.875","399","231","168","Terry Donahue"
"1983","UCLA","7","4","1","0.625","309","265","44","Terry Donahue"
"1984","UCLA","9","3","0","0.75","275","248","27","Terry Donahue"
"1985","UCLA","9","2","1","0.79167","363","214","149","Terry Donahue"
"1986","UCLA","8","3","1","0.70833","385","222","163","Terry Donahue"
"1987","UCLA","10","2","0","0.83333","426","195","231","Terry Donahue"
"1988","UCLA","10","2","0","0.83333","392","190","202","Terry Donahue"
"1989","UCLA","3","7","1","0.31818","209","246","-37","Terry Donahue"
"1990","UCLA","5","6","0","0.45455","305","332","-27","Terry Donahue"
"1991","UCLA","9","3","0","0.75","323","190","133","Terry Donahue"
"1992","UCLA","6","5","0","0.54545","201","228","-27","Terry Donahue"
"1993","UCLA","8","4","0","0.66667","368","230","138","Terry Donahue"
"1994","UCLA","5","6","0","0.45455","239","295","-56","Terry Donahue"
"1995","UCLA","7","5","0","0.58333","338","300","38","Terry Donahue"
"1996","UCLA","5","6","0","0.45455","330","318","12","Bob Toledo"
"1997","UCLA","10","2","0","0.83333","477","247","230","Bob Toledo"
"1998","UCLA","10","2","0","0.83333","476","340","136","Bob Toledo"
"1999","UCLA","5","6","0","0.45455","230","311","-81","Bob Toledo"
"2000","UCLA","6","6","0","0.5","353","368","-15","Bob Toledo"
"2001","UCLA","7","4","0","0.63636","317","225","92","Bob Toledo"
"2002","UCLA","7","5","0","0.58333","360","313","47","Bob Toledo"
"2002","UCLA","1","0","0","1","27","13","14","Ed Kezirian"
"2003","UCLA","6","7","0","0.46154","248","305","-57","Karl Dorrell"
"2004","UCLA","6","6","0","0.5","361","309","52","Karl Dorrell"
"2005","UCLA","10","2","0","0.83333","469","410","59","Karl Dorrell"
"2006","UCLA","7","6","0","0.53846","299","259","40","Karl Dorrell"
"2007","UCLA","6","6","0","0.5","275","273","2","Karl Dorrell"
"2007","UCLA","0","1","0","0","16","17","-1","DeWayne Walker"
"2008","UCLA","4","8","0","0.33333","212","348","-136","Rick Neuheisel"
"2009","UCLA","7","6","0","0.53846","286","276","10","Rick Neuheisel"
"2010","UCLA","4","8","0","0.33333","242","364","-122","Rick Neuheisel"
"2011","UCLA","6","7","0","0.46154","309","419","-110","Rick Neuheisel"
"2011","UCLA","0","1","0","0","14","20","-6","Mike Johnson"
"2012","UCLA","9","5","0","0.64286","482","386","96","Jim L. Mora"
"2013","UCLA","10","3","0","0.76923","480","301","179","Jim L. Mora"
"2014","UCLA","10","3","0","0.76923","435","365","70","Jim L. Mora"
"1896","Utah","2","2","0","0.5","18","16","2","C.B. Ferris"
"1897","Utah","1","5","0","0.16667","12","66","-54","Mr. Cummings"
"1898","Utah","3","1","0","0.75","31","6","25","Mr. Wilson"
"1900","Utah","2","0","0","1","57","6","51","Harvey R. Holmes"
"1901","Utah","5","1","0","0.83333","111","6","105","Harvey R. Holmes"
"1902","Utah","6","2","1","0.72222","162","51","111","Harvey R. Holmes"
"1903","Utah","3","5","0","0.375","126","87","39","Harvey R. Holmes"
"1904","Utah","7","1","0","0.875","301","38","263","Joseph H. ""Joe"" Maddock"
"1905","Utah","6","2","0","0.75","260","74","186","Joseph H. ""Joe"" Maddock"
"1906","Utah","6","1","0","0.85714","170","6","164","Joseph H. ""Joe"" Maddock"
"1907","Utah","7","2","0","0.77778","147","66","81","Joseph H. ""Joe"" Maddock"
"1908","Utah","4","2","1","0.64286","211","49","162","Joseph H. ""Joe"" Maddock"
"1909","Utah","6","1","0","0.85714","180","19","161","Joseph H. ""Joe"" Maddock"
"1910","Utah","4","2","0","0.66667","70","44","26","Fred Bennion"
"1911","Utah","6","1","1","0.8125","212","15","197","Fred Bennion"
"1912","Utah","5","1","1","0.78571","153","16","137","Fred Bennion"
"1913","Utah","2","4","1","0.35714","129","103","26","Fred Bennion"
"1914","Utah","3","3","0","0.5","87","108","-21","Nelson H. Norgren"
"1915","Utah","6","2","0","0.75","175","71","104","Nelson H. Norgren"
"1916","Utah","3","2","0","0.6","113","45","68","Nelson H. Norgren"
"1917","Utah","2","4","0","0.33333","48","116","-68","Nelson H. Norgren"
"1919","Utah","5","2","0","0.71429","151","62","89","Thomas M. Fitzpatrick"
"1920","Utah","2","5","1","0.3125","66","116","-50","Thomas M. Fitzpatrick"
"1921","Utah","3","2","1","0.58333","55","55","0","Thomas M. Fitzpatrick"
"1922","Utah","7","1","0","0.875","153","41","112","Thomas M. Fitzpatrick"
"1923","Utah","4","3","0","0.57143","241","48","193","Thomas M. Fitzpatrick"
"1924","Utah","3","4","1","0.4375","116","95","21","Thomas M. Fitzpatrick"
"1925","Utah","6","2","0","0.75","110","51","59","Ike J. Armstrong"
"1926","Utah","7","0","0","1","164","23","141","Ike J. Armstrong"
"1927","Utah","3","3","1","0.5","93","60","33","Ike J. Armstrong"
"1928","Utah","5","0","2","0.85714","117","41","76","Ike J. Armstrong"
"1929","Utah","7","0","0","1","219","23","196","Ike J. Armstrong"
"1930","Utah","8","0","0","1","340","20","320","Ike J. Armstrong"
"1931","Utah","7","2","0","0.77778","301","31","270","Ike J. Armstrong"
"1932","Utah","6","1","1","0.8125","162","47","115","Ike J. Armstrong"
"1933","Utah","5","3","0","0.625","129","78","51","Ike J. Armstrong"
"1934","Utah","5","3","0","0.625","150","42","108","Ike J. Armstrong"
"1935","Utah","4","3","1","0.5625","166","69","97","Ike J. Armstrong"
"1936","Utah","6","3","0","0.66667","142","75","67","Ike J. Armstrong"
"1937","Utah","5","3","0","0.625","133","52","81","Ike J. Armstrong"
"1938","Utah","7","1","2","0.8","187","36","151","Ike J. Armstrong"
"1939","Utah","6","1","2","0.77778","261","74","187","Ike J. Armstrong"
"1940","Utah","7","2","0","0.77778","169","87","82","Ike J. Armstrong"
"1941","Utah","6","0","2","0.875","209","65","144","Ike J. Armstrong"
"1942","Utah","6","3","0","0.66667","155","84","71","Ike J. Armstrong"
"1943","Utah","0","7","0","0","38","297","-259","Ike J. Armstrong"
"1944","Utah","5","2","1","0.6875","161","86","75","Ike J. Armstrong"
"1945","Utah","4","4","0","0.5","146","165","-19","Ike J. Armstrong"
"1946","Utah","8","3","0","0.72727","257","114","143","Ike J. Armstrong"
"1947","Utah","8","1","1","0.85","207","80","127","Ike J. Armstrong"
"1948","Utah","8","1","1","0.85","221","96","125","Ike J. Armstrong"
"1949","Utah","2","7","1","0.25","141","166","-25","Ike J. Armstrong"
"1950","Utah","3","4","3","0.45","240","254","-14","Jack C. Curtice"
"1951","Utah","7","4","0","0.63636","236","247","-11","Jack C. Curtice"
"1952","Utah","6","3","1","0.65","188","128","60","Jack C. Curtice"
"1953","Utah","8","2","0","0.8","264","150","114","Jack C. Curtice"
"1954","Utah","4","7","0","0.36364","172","212","-40","Jack C. Curtice"
"1955","Utah","6","3","0","0.66667","182","136","46","Jack C. Curtice"
"1956","Utah","5","5","0","0.5","227","177","50","Jack C. Curtice"
"1957","Utah","6","4","0","0.6","262","136","126","Jack C. Curtice"
"1958","Utah","4","7","0","0.36364","161","187","-26","Raymond R. ""Ray"" Nagel"
"1959","Utah","5","5","0","0.5","224","195","29","Raymond R. ""Ray"" Nagel"
"1960","Utah","7","3","0","0.7","194","90","104","Raymond R. ""Ray"" Nagel"
"1961","Utah","6","4","0","0.6","176","134","42","Raymond R. ""Ray"" Nagel"
"1962","Utah","4","5","1","0.45","169","196","-27","Raymond R. ""Ray"" Nagel"
"1963","Utah","4","6","0","0.4","204","187","17","Raymond R. ""Ray"" Nagel"
"1964","Utah","9","2","0","0.81818","234","68","166","Raymond R. ""Ray"" Nagel"
"1965","Utah","3","7","0","0.3","177","164","13","Raymond R. ""Ray"" Nagel"
"1966","Utah","5","5","0","0.5","176","203","-27","Mike Giddings"
"1967","Utah","4","7","0","0.36364","204","252","-48","Mike Giddings"
"1968","Utah","3","7","0","0.3","162","234","-72","William M. ""Bill"" Meek"
"1969","Utah","8","2","0","0.8","231","107","124","William M. ""Bill"" Meek"
"1970","Utah","6","4","0","0.6","208","176","32","William M. ""Bill"" Meek"
"1971","Utah","3","8","0","0.27273","244","315","-71","William M. ""Bill"" Meek"
"1972","Utah","6","5","0","0.54545","354","336","18","William M. ""Bill"" Meek"
"1973","Utah","7","5","0","0.58333","385","344","41","William M. ""Bill"" Meek"
"1974","Utah","1","10","0","0.09091","115","339","-224","Tom Lovat"
"1975","Utah","1","10","0","0.09091","132","332","-200","Tom Lovat"
"1976","Utah","3","8","0","0.27273","245","361","-116","Tom Lovat"
"1977","Utah","3","8","0","0.27273","212","379","-167","Wayne Howard"
"1978","Utah","8","3","0","0.72727","291","182","109","Wayne Howard"
"1979","Utah","6","6","0","0.5","267","296","-29","Wayne Howard"
"1980","Utah","5","5","1","0.5","259","293","-34","Wayne Howard"
"1981","Utah","8","2","1","0.77273","321","207","114","Wayne Howard"
"1982","Utah","5","6","0","0.45455","247","188","59","Charles R. ""Chuck"" Stobart"
"1983","Utah","5","6","0","0.45455","296","289","7","Charles R. ""Chuck"" Stobart"
"1984","Utah","6","5","1","0.54167","347","253","94","Charles R. ""Chuck"" Stobart"
"1985","Utah","8","4","0","0.66667","405","343","62","Jim Fassel"
"1986","Utah","2","9","0","0.18182","278","444","-166","Jim Fassel"
"1987","Utah","5","7","0","0.41667","321","362","-41","Jim Fassel"
"1988","Utah","6","5","0","0.54545","399","357","42","Jim Fassel"
"1989","Utah","4","8","0","0.33333","365","524","-159","Jim Fassel"
"1990","Utah","4","7","0","0.36364","214","342","-128","Ron McBride"
"1991","Utah","7","5","0","0.58333","276","277","-1","Ron McBride"
"1992","Utah","6","6","0","0.5","320","289","31","Ron McBride"
"1993","Utah","7","6","0","0.53846","390","396","-6","Ron McBride"
"1994","Utah","10","2","0","0.83333","426","210","216","Ron McBride"
"1995","Utah","7","4","0","0.63636","296","230","66","Ron McBride"
"1996","Utah","8","4","0","0.66667","313","309","4","Ron McBride"
"1997","Utah","6","5","0","0.54545","253","200","53","Ron McBride"
"1998","Utah","7","4","0","0.63636","339","227","112","Ron McBride"
"1999","Utah","9","3","0","0.75","380","210","170","Ron McBride"
"2000","Utah","4","7","0","0.36364","234","207","27","Ron McBride"
"2001","Utah","8","4","0","0.66667","329","210","119","Ron McBride"
"2002","Utah","5","6","0","0.45455","249","226","23","Ron McBride"
"2003","Utah","10","2","0","0.83333","344","229","115","Urban Meyer"
"2004","Utah","11","0","0","1","509","227","282","Urban Meyer"
"2004","Utah","1","0","0","1","35","7","28","Urban Meyer & Kyle Whittingham"
"2005","Utah","7","5","0","0.58333","360","289","71","Kyle Whittingham"
"2006","Utah","8","5","0","0.61538","363","258","105","Kyle Whittingham"
"2007","Utah","9","4","0","0.69231","341","219","122","Kyle Whittingham"
"2008","Utah","13","0","0","1","480","224","256","Kyle Whittingham"
"2009","Utah","10","3","0","0.76923","388","263","125","Kyle Whittingham"
"2010","Utah","10","3","0","0.76923","430","264","166","Kyle Whittingham"
"2011","Utah","8","5","0","0.61538","325","263","62","Kyle Whittingham"
"2012","Utah","5","7","0","0.41667","320","301","19","Kyle Whittingham"
"2013","Utah","5","7","0","0.41667","350","336","14","Kyle Whittingham"
"2014","Utah","9","4","0","0.69231","407","324","83","Kyle Whittingham"
"1896","Utah St.","0","1","0","0","0","6","-6","Professor Mayo"
"1898","Utah St.","0","1","0","0","5","12","-7","Lt. Dunning"
"1899","Utah St.","1","0","0","1","10","6","4","Willard Langton"
"1900","Utah St.","0","1","0","0","0","21","-21","Willard Langton"
"1901","Utah St.","3","2","1","0.58333","65","46","19","Dick Richards"
"1902","Utah St.","0","4","0","0","10","73","-63","George P. Campbell"
"1903","Utah St.","3","0","0","1","78","0","78","George P. Campbell"
"1904","Utah St.","4","8","0","0.33333","63","253","-190","George P. Campbell"
"1905","Utah St.","2","2","1","0.5","31","33","-2","George P. Campbell"
"1906","Utah St.","3","1","0","0.75","37","51","-14","George P. Campbell"
"1907","Utah St.","6","1","0","0.85714","184","25","159","Fred M. Walker"
"1908","Utah St.","4","2","0","0.66667","142","39","103","Fred M. Walker"
"1909","Utah St.","2","2","1","0.5","34","55","-21","Clayton T. Teetzel"
"1910","Utah St.","5","2","0","0.71429","102","33","69","Clayton T. Teetzel"
"1911","Utah St.","5","0","0","1","164","0","164","Clayton T. Teetzel"
"1912","Utah St.","4","2","1","0.64286","154","40","114","Clayton T. Teetzel"
"1913","Utah St.","3","3","0","0.5","97","69","28","Clayton T. Teetzel"
"1914","Utah St.","2","5","0","0.28571","56","208","-152","Clayton T. Teetzel"
"1915","Utah St.","3","4","0","0.42857","56","99","-43","Clayton T. Teetzel"
"1916","Utah St.","1","5","1","0.21429","69","178","-109","John W. ""Jack"" Watson"
"1917","Utah St.","7","0","1","0.9375","267","26","241","John W. ""Jack"" Watson"
"1919","Utah St.","5","2","0","0.71429","234","44","190","E. Lowell ""Dick"" Romney"
"1920","Utah St.","4","2","1","0.64286","84","48","36","E. Lowell ""Dick"" Romney"
"1921","Utah St.","7","1","0","0.875","151","82","69","E. Lowell ""Dick"" Romney"
"1922","Utah St.","5","4","0","0.55556","132","83","49","E. Lowell ""Dick"" Romney"
"1923","Utah St.","5","2","0","0.71429","147","59","88","E. Lowell ""Dick"" Romney"
"1924","Utah St.","4","2","1","0.64286","127","52","75","E. Lowell ""Dick"" Romney"
"1925","Utah St.","6","1","0","0.85714","111","39","72","E. Lowell ""Dick"" Romney"
"1926","Utah St.","5","1","2","0.75","93","43","50","E. Lowell ""Dick"" Romney"
"1927","Utah St.","3","4","1","0.4375","129","53","76","E. Lowell ""Dick"" Romney"
"1928","Utah St.","5","3","1","0.61111","182","87","95","E. Lowell ""Dick"" Romney"
"1929","Utah St.","3","4","0","0.42857","50","60","-10","E. Lowell ""Dick"" Romney"
"1930","Utah St.","3","5","1","0.38889","73","205","-132","E. Lowell ""Dick"" Romney"
"1931","Utah St.","6","2","0","0.75","147","72","75","E. Lowell ""Dick"" Romney"
"1932","Utah St.","4","4","0","0.5","123","105","18","E. Lowell ""Dick"" Romney"
"1933","Utah St.","5","4","0","0.55556","148","63","85","E. Lowell ""Dick"" Romney"
"1934","Utah St.","6","1","1","0.8125","162","42","120","E. Lowell ""Dick"" Romney"
"1935","Utah St.","5","2","1","0.6875","165","73","92","E. Lowell ""Dick"" Romney"
"1936","Utah St.","7","0","1","0.9375","99","13","86","E. Lowell ""Dick"" Romney"
"1937","Utah St.","2","4","2","0.375","47","152","-105","E. Lowell ""Dick"" Romney"
"1938","Utah St.","4","4","0","0.5","85","87","-2","E. Lowell ""Dick"" Romney"
"1939","Utah St.","3","4","1","0.4375","76","81","-5","E. Lowell ""Dick"" Romney"
"1940","Utah St.","2","5","1","0.3125","48","104","-56","E. Lowell ""Dick"" Romney"
"1941","Utah St.","0","8","0","0","46","153","-107","E. Lowell ""Dick"" Romney"
"1942","Utah St.","6","3","1","0.65","201","137","64","E. Lowell ""Dick"" Romney"
"1944","Utah St.","3","3","0","0.5","88","109","-21","E. Lowell ""Dick"" Romney"
"1945","Utah St.","4","3","0","0.57143","173","92","81","E. Lowell ""Dick"" Romney"
"1946","Utah St.","7","2","1","0.75","219","75","144","E. Lowell ""Dick"" Romney"
"1947","Utah St.","6","5","0","0.54545","228","210","18","E. Lowell ""Dick"" Romney"
"1948","Utah St.","5","6","0","0.45455","196","238","-42","E. Lowell ""Dick"" Romney"
"1949","Utah St.","3","7","0","0.3","105","209","-104","George L. Melinkovich"
"1950","Utah St.","2","9","0","0.18182","107","374","-267","George L. Melinkovich"
"1951","Utah St.","3","5","1","0.38889","161","183","-22","John O. Roning"
"1952","Utah St.","3","7","1","0.31818","121","209","-88","John O. Roning"
"1953","Utah St.","8","3","0","0.72727","207","139","68","John O. Roning"
"1954","Utah St.","4","6","0","0.4","158","187","-29","John O. Roning"
"1955","Utah St.","4","6","0","0.4","177","172","5","Everette G. ""Ev"" Faunce"
"1956","Utah St.","6","4","0","0.6","221","199","22","Everette G. ""Ev"" Faunce"
"1957","Utah St.","2","7","1","0.25","153","255","-102","Everette G. ""Ev"" Faunce"
"1958","Utah St.","3","7","0","0.3","123","188","-65","Everette G. ""Ev"" Faunce"
"1959","Utah St.","5","6","0","0.45455","181","185","-4","John Ralston"
"1960","Utah St.","9","2","0","0.81818","274","85","189","John Ralston"
"1961","Utah St.","9","1","1","0.86364","396","102","294","John Ralston"
"1962","Utah St.","8","2","0","0.8","273","139","134","John Ralston"
"1963","Utah St.","8","2","0","0.8","317","99","218","Tony Knap"
"1964","Utah St.","5","4","1","0.55","294","136","158","Tony Knap"
"1965","Utah St.","8","2","0","0.8","271","136","135","Tony Knap"
"1966","Utah St.","4","6","0","0.4","181","163","18","Tony Knap"
"1967","Utah St.","7","2","1","0.75","205","143","62","Chuck Mills"
"1968","Utah St.","7","3","0","0.7","247","142","105","Chuck Mills"
"1969","Utah St.","3","7","0","0.3","134","250","-116","Chuck Mills"
"1970","Utah St.","5","5","0","0.5","217","225","-8","Chuck Mills"
"1971","Utah St.","8","3","0","0.72727","243","183","60","Chuck Mills"
"1972","Utah St.","8","3","0","0.72727","329","230","99","Chuck Mills"
"1973","Utah St.","7","4","0","0.63636","220","202","18","Phil Krueger"
"1974","Utah St.","8","3","0","0.72727","181","199","-18","Phil Krueger"
"1975","Utah St.","6","5","0","0.54545","193","240","-47","Phil Krueger"
"1976","Utah St.","3","8","0","0.27273","170","263","-93","Bruce Snyder"
"1977","Utah St.","4","7","0","0.36364","177","249","-72","Bruce Snyder"
"1978","Utah St.","7","4","0","0.63636","269","214","55","Bruce Snyder"
"1979","Utah St.","8","2","1","0.77273","347","270","77","Bruce Snyder"
"1980","Utah St.","6","5","0","0.54545","290","255","35","Bruce Snyder"
"1981","Utah St.","5","5","1","0.5","204","210","-6","Bruce Snyder"
"1982","Utah St.","5","6","0","0.45455","192","262","-70","Bruce Snyder"
"1983","Utah St.","5","6","0","0.45455","193","214","-21","Chris Pella"
"1984","Utah St.","1","10","0","0.09091","196","390","-194","Chris Pella"
"1985","Utah St.","3","8","0","0.27273","177","319","-142","Chris Pella"
"1986","Utah St.","3","8","0","0.27273","134","243","-109","Chuck Shelton"
"1987","Utah St.","5","6","0","0.45455","205","306","-101","Chuck Shelton"
"1988","Utah St.","4","7","0","0.36364","215","362","-147","Chuck Shelton"
"1989","Utah St.","4","7","0","0.36364","191","355","-164","Chuck Shelton"
"1990","Utah St.","5","5","1","0.5","287","310","-23","Chuck Shelton"
"1991","Utah St.","5","6","0","0.45455","219","265","-46","Chuck Shelton"
"1992","Utah St.","5","6","0","0.45455","300","328","-28","Charlie Weatherbie"
"1993","Utah St.","7","5","0","0.58333","363","354","9","Charlie Weatherbie"
"1994","Utah St.","3","8","0","0.27273","209","313","-104","Charlie Weatherbie"
"1995","Utah St.","4","7","0","0.36364","293","287","6","John L. Smith"
"1996","Utah St.","6","5","0","0.54545","330","339","-9","John L. Smith"
"1997","Utah St.","6","6","0","0.5","389","296","93","John L. Smith"
"1998","Utah St.","3","8","0","0.27273","237","309","-72","Dave Arslanian"
"1999","Utah St.","4","7","0","0.36364","234","301","-67","Dave Arslanian"
"2000","Utah St.","5","6","0","0.45455","292","356","-64","Mick Dennehy"
"2001","Utah St.","4","7","0","0.36364","316","421","-105","Mick Dennehy"
"2002","Utah St.","4","7","0","0.36364","305","432","-127","Mick Dennehy"
"2003","Utah St.","3","9","0","0.25","264","315","-51","Mick Dennehy"
"2004","Utah St.","3","8","0","0.27273","184","333","-149","Mick Dennehy"
"2005","Utah St.","3","8","0","0.27273","208","360","-152","Brent Guy"
"2006","Utah St.","1","11","0","0.08333","130","462","-332","Brent Guy"
"2007","Utah St.","2","10","0","0.16667","247","406","-159","Brent Guy"
"2008","Utah St.","3","9","0","0.25","288","416","-128","Brent Guy"
"2009","Utah St.","4","8","0","0.33333","349","408","-59","Gary Andersen"
"2010","Utah St.","4","8","0","0.33333","264","405","-141","Gary Andersen"
"2011","Utah St.","7","6","0","0.53846","437","363","74","Gary Andersen"
"2012","Utah St.","11","2","0","0.84615","454","200","254","Gary Andersen"
"2013","Utah St.","9","5","0","0.64286","445","239","206","Matt Wells"
"2014","Utah St.","10","4","0","0.71429","377","276","101","Matt Wells"
"1915","Virginia","8","1","0","0.88889","219","26","193","Henry H. Varner"
"1916","Virginia","4","5","0","0.44444","106","172","-66","Peyton R. Evans"
"1919","Virginia","2","5","2","0.33333","39","134","-95","Harris W. Coleman"
"1922","Virginia","4","4","1","0.5","102","60","42","Thomas J. Campbell"
"1923","Virginia","3","5","1","0.38889","87","81","6","A. Earle ""Greasy"" Neale"
"1924","Virginia","5","4","0","0.55556","72","83","-11","A. Earle ""Greasy"" Neale"
"1925","Virginia","7","1","1","0.83333","144","31","113","A. Earle ""Greasy"" Neale"
"1926","Virginia","6","2","2","0.7","161","53","108","A. Earle ""Greasy"" Neale"
"1927","Virginia","5","4","0","0.55556","117","122","-5","A. Earle ""Greasy"" Neale"
"1928","Virginia","2","6","1","0.27778","121","142","-21","A. Earle ""Greasy"" Neale"
"1929","Virginia","4","3","2","0.55556","129","139","-10","Earl C. Abell"
"1930","Virginia","4","6","0","0.4","144","215","-71","Earl C. Abell"
"1931","Virginia","1","7","2","0.2","40","112","-72","Fred T. Dawson"
"1932","Virginia","5","4","0","0.55556","95","67","28","Fred T. Dawson"
"1933","Virginia","2","6","2","0.3","83","149","-66","Fred T. Dawson"
"1934","Virginia","3","6","0","0.33333","70","151","-81","G.K. ""Gus"" Tebell"
"1935","Virginia","1","5","4","0.3","39","133","-94","G.K. ""Gus"" Tebell"
"1936","Virginia","2","7","0","0.22222","73","222","-149","G.K. ""Gus"" Tebell"
"1937","Virginia","2","7","0","0.22222","52","169","-117","Frank J. Murray"
"1938","Virginia","4","4","1","0.5","113","169","-56","Frank J. Murray"
"1939","Virginia","5","4","0","0.55556","143","75","68","Frank J. Murray"
"1940","Virginia","4","5","0","0.44444","117","103","14","Frank J. Murray"
"1941","Virginia","8","1","0","0.88889","279","42","237","Frank J. Murray"
"1942","Virginia","2","6","1","0.27778","123","181","-58","Frank J. Murray"
"1943","Virginia","3","4","1","0.4375","106","133","-27","Frank J. Murray"
"1944","Virginia","6","1","2","0.77778","197","52","145","Frank J. Murray"
"1945","Virginia","7","2","0","0.77778","265","79","186","Frank J. Murray"
"1946","Virginia","4","4","1","0.5","180","170","10","Arthur L ""Art"" Guepe"
"1947","Virginia","7","3","0","0.7","244","99","145","Arthur L ""Art"" Guepe"
"1948","Virginia","5","3","1","0.61111","175","157","18","Arthur L ""Art"" Guepe"
"1949","Virginia","7","2","0","0.77778","199","121","78","Arthur L ""Art"" Guepe"
"1950","Virginia","8","2","0","0.8","260","151","109","Arthur L ""Art"" Guepe"
"1951","Virginia","8","1","0","0.88889","278","104","174","Arthur L ""Art"" Guepe"
"1952","Virginia","8","2","0","0.8","297","90","207","Arthur L ""Art"" Guepe"
"1953","Virginia","1","8","0","0.11111","75","242","-167","Ned L. McDonald"
"1954","Virginia","3","6","0","0.33333","113","162","-49","Ned L. McDonald"
"1955","Virginia","1","9","0","0.1","96","201","-105","Ned L. McDonald"
"1956","Virginia","4","6","0","0.4","92","167","-75","Ben Martin"
"1957","Virginia","3","6","1","0.35","117","171","-54","Ben Martin"
"1958","Virginia","1","9","0","0.1","89","301","-212","Richard ""Dick"" Voris"
"1959","Virginia","0","10","0","0","80","393","-313","Richard ""Dick"" Voris"
"1960","Virginia","0","10","0","0","103","332","-229","Richard ""Dick"" Voris"
"1961","Virginia","4","6","0","0.4","123","190","-67","William T. ""Bill"" Elias"
"1962","Virginia","5","5","0","0.5","194","167","27","William T. ""Bill"" Elias"
"1963","Virginia","2","7","1","0.25","76","169","-93","William T. ""Bill"" Elias"
"1964","Virginia","5","5","0","0.5","163","214","-51","William T. ""Bill"" Elias"
"1965","Virginia","4","6","0","0.4","170","189","-19","George ""Blackie"" Blackburn"
"1966","Virginia","4","6","0","0.4","214","235","-21","George ""Blackie"" Blackburn"
"1967","Virginia","5","5","0","0.5","172","169","3","George ""Blackie"" Blackburn"
"1968","Virginia","7","3","0","0.7","328","222","106","George ""Blackie"" Blackburn"
"1969","Virginia","3","7","0","0.3","115","170","-55","George ""Blackie"" Blackburn"
"1970","Virginia","5","6","0","0.45455","240","187","53","George ""Blackie"" Blackburn"
"1971","Virginia","3","8","0","0.27273","134","272","-138","Don Lawrence"
"1972","Virginia","4","7","0","0.36364","199","276","-77","Don Lawrence"
"1973","Virginia","4","7","0","0.36364","199","300","-101","Don Lawrence"
"1974","Virginia","4","7","0","0.36364","207","239","-32","Sonny Randle"
"1975","Virginia","1","10","0","0.09091","175","428","-253","Sonny Randle"
"1976","Virginia","2","9","0","0.18182","106","266","-160","Dick Bestwick"
"1977","Virginia","1","9","1","0.13636","56","280","-224","Dick Bestwick"
"1978","Virginia","2","9","0","0.18182","139","236","-97","Dick Bestwick"
"1979","Virginia","6","5","0","0.54545","258","134","124","Dick Bestwick"
"1980","Virginia","4","7","0","0.36364","144","259","-115","Dick Bestwick"
"1981","Virginia","1","10","0","0.09091","127","261","-134","Dick Bestwick"
"1982","Virginia","2","9","0","0.18182","208","320","-112","George Welsh"
"1983","Virginia","6","5","0","0.54545","252","280","-28","George Welsh"
"1984","Virginia","8","2","2","0.75","325","233","92","George Welsh"
"1985","Virginia","6","5","0","0.54545","262","217","45","George Welsh"
"1986","Virginia","3","8","0","0.27273","198","315","-117","George Welsh"
"1987","Virginia","8","4","0","0.66667","292","276","16","George Welsh"
"1988","Virginia","7","4","0","0.63636","251","244","7","George Welsh"
"1989","Virginia","10","3","0","0.76923","371","272","99","George Welsh"
"1990","Virginia","8","4","0","0.66667","464","227","237","George Welsh"
"1991","Virginia","8","3","1","0.70833","327","167","160","George Welsh"
"1992","Virginia","7","4","0","0.63636","341","229","112","George Welsh"
"1993","Virginia","7","5","0","0.58333","317","217","100","George Welsh"
"1994","Virginia","9","3","0","0.75","370","195","175","George Welsh"
"1995","Virginia","9","4","0","0.69231","378","270","108","George Welsh"
"1996","Virginia","7","5","0","0.58333","341","203","138","George Welsh"
"1997","Virginia","7","4","0","0.63636","277","242","35","George Welsh"
"1998","Virginia","9","3","0","0.75","358","247","111","George Welsh"
"1999","Virginia","7","5","0","0.58333","345","365","-20","George Welsh"
"2000","Virginia","6","6","0","0.5","242","292","-50","George Welsh"
"2001","Virginia","5","7","0","0.41667","249","331","-82","Al Groh"
"2002","Virginia","9","5","0","0.64286","402","348","54","Al Groh"
"2003","Virginia","8","5","0","0.61538","364","265","99","Al Groh"
"2004","Virginia","8","4","0","0.66667","363","212","151","Al Groh"
"2005","Virginia","7","5","0","0.58333","320","279","41","Al Groh"
"2006","Virginia","5","7","0","0.41667","181","214","-33","Al Groh"
"2007","Virginia","9","4","0","0.69231","317","256","61","Al Groh"
"2008","Virginia","5","7","0","0.41667","193","260","-67","Al Groh"
"2009","Virginia","3","9","0","0.25","232","316","-84","Al Groh"
"2010","Virginia","4","8","0","0.33333","304","339","-35","Mike London"
"2011","Virginia","8","5","0","0.61538","302","310","-8","Mike London"
"2012","Virginia","4","8","0","0.33333","273","347","-74","Mike London"
"2013","Virginia","2","10","0","0.16667","237","399","-162","Mike London"
"2014","Virginia","5","7","0","0.41667","310","289","21","Mike London"
"1892","Virginia Tech","1","1","0","0.5","14","22","-8","E.A. Smyth"
"1893","Virginia Tech","0","2","0","0","6","40","-34","E.A. Smyth"
"1894","Virginia Tech","4","1","0","0.8","112","10","102","Joseph A. Massie"
"1895","Virginia Tech","4","2","0","0.66667","69","76","-7","Art C. Jones"
"1896","Virginia Tech","5","2","1","0.6875","158","50","108","Art C. Jones"
"1897","Virginia Tech","5","2","0","0.71429","149","36","113","Charles Firth"
"1898","Virginia Tech","3","2","0","0.6","110","51","59","J. Lewis Ingles"
"1899","Virginia Tech","4","1","0","0.8","106","28","78","Dr. James Morrison"
"1900","Virginia Tech","3","3","1","0.5","65","42","23","Dr. Davis"
"1901","Virginia Tech","6","1","0","0.85714","115","33","82","Dr. A.B. Morrison, Jr."
"1902","Virginia Tech","3","2","1","0.58333","89","23","66","Robert Roswell ""Buster"" Brown"
"1903","Virginia Tech","5","1","0","0.83333","108","21","87","Dr. Charles Augustus Lueder"
"1904","Virginia Tech","5","3","0","0.625","121","27","94","John C. O'Connor"
"1905","Virginia Tech","9","1","0","0.9","305","24","281","C.P. Miles"
"1906","Virginia Tech","5","2","2","0.66667","74","15","59","C.P. Miles"
"1907","Virginia Tech","7","2","0","0.77778","157","30","127","Charles Robert ""Bob"" Williams"
"1908","Virginia Tech","5","4","0","0.55556","104","41","63","Ralph Manning Brown"
"1911","Virginia Tech","6","1","2","0.77778","176","52","124","L.W. Riess"
"1909","Virginia Tech","6","1","0","0.85714","148","27","121","Branch Bocock"
"1910","Virginia Tech","6","2","0","0.75","109","18","91","Branch Bocock"
"1912","Virginia Tech","5","4","0","0.55556","202","92","110","Branch Bocock"
"1913","Virginia Tech","7","1","1","0.83333","175","60","115","Branch Bocock"
"1914","Virginia Tech","6","2","1","0.72222","143","33","110","Branch Bocock"
"1915","Virginia Tech","4","4","0","0.5","91","109","-18","Branch Bocock"
"1916","Virginia Tech","7","2","0","0.77778","193","60","133","J.E. ""Jack"" Ingersoll"
"1917","Virginia Tech","6","2","1","0.72222","220","75","145","Charles A. Bemier"
"1918","Virginia Tech","7","0","0","1","152","13","139","Charles A. Bemier"
"1919","Virginia Tech","5","4","0","0.55556","186","52","134","Charles A. Bemier"
"1920","Virginia Tech","4","6","0","0.4","172","111","61","Stanley B. Sutton"
"1921","Virginia Tech","7","3","0","0.7","191","50","141","Ben C. Cubbage"
"1922","Virginia Tech","8","1","1","0.85","262","32","230","Ben C. Cubbage"
"1923","Virginia Tech","6","3","0","0.66667","116","55","61","Ben C. Cubbage"
"1924","Virginia Tech","4","2","3","0.61111","103","18","85","Ben C. Cubbage"
"1925","Virginia Tech","5","3","2","0.6","39","52","-13","Ben C. Cubbage"
"1926","Virginia Tech","5","3","1","0.61111","134","80","54","Andy Gustafson"
"1927","Virginia Tech","5","4","0","0.55556","125","48","77","Andy Gustafson"
"1928","Virginia Tech","7","2","0","0.77778","198","92","106","Andy Gustafson"
"1929","Virginia Tech","5","4","0","0.55556","170","128","42","Andy Gustafson"
"1930","Virginia Tech","5","3","1","0.61111","122","130","-8","Orville E. Neale"
"1931","Virginia Tech","3","4","2","0.44444","76","104","-28","Orville E. Neale"
"1932","Virginia Tech","8","1","0","0.88889","153","28","125","Henry B. ""Puss"" Redd"
"1933","Virginia Tech","4","3","3","0.55","54","86","-32","Henry B. ""Puss"" Redd"
"1934","Virginia Tech","5","5","0","0.5","95","113","-18","Henry B. ""Puss"" Redd"
"1935","Virginia Tech","4","3","2","0.55556","68","47","21","Henry B. ""Puss"" Redd"
"1936","Virginia Tech","5","5","0","0.5","63","100","-37","Henry B. ""Puss"" Redd"
"1937","Virginia Tech","5","5","0","0.5","117","116","1","Henry B. ""Puss"" Redd"
"1938","Virginia Tech","3","5","2","0.4","75","86","-11","Henry B. ""Puss"" Redd"
"1939","Virginia Tech","4","5","1","0.45","106","84","22","Henry B. ""Puss"" Redd"
"1940","Virginia Tech","5","5","0","0.5","140","145","-5","Henry B. ""Puss"" Redd"
"1941","Virginia Tech","6","4","0","0.6","112","120","-8","James R. ""Jimmy"" Kitts"
"1946","Virginia Tech","3","4","3","0.45","102","149","-47","James R. ""Jimmy"" Kitts"
"1947","Virginia Tech","4","5","0","0.44444","162","191","-29","James R. ""Jimmy"" Kitts"
"1942","Virginia Tech","7","2","1","0.75","161","114","47","Sumner D. ""Tex"" Tilson & Henry Macauley ""Mac"" McEver"
"1945","Virginia Tech","2","6","0","0.25","78","150","-72","Henry Macauley ""Mac"" McEver"
"1948","Virginia Tech","0","8","1","0.05556","28","209","-181","Robert C. McNeish"
"1949","Virginia Tech","1","7","2","0.2","130","272","-142","Robert C. McNeish"
"1950","Virginia Tech","0","10","0","0","72","430","-358","Robert C. McNeish"
"1951","Virginia Tech","2","8","0","0.2","105","311","-206","Frank O. Moselely"
"1952","Virginia Tech","5","6","0","0.45455","155","221","-66","Frank O. Moselely"
"1953","Virginia Tech","5","5","0","0.5","142","124","18","Frank O. Moselely"
"1954","Virginia Tech","8","0","1","0.94444","198","75","123","Frank O. Moselely"
"1955","Virginia Tech","6","3","1","0.65","191","133","58","Frank O. Moselely"
"1956","Virginia Tech","7","2","1","0.75","264","98","166","Frank O. Moselely"
"1957","Virginia Tech","4","6","0","0.4","114","148","-34","Frank O. Moselely"
"1958","Virginia Tech","5","4","1","0.55","165","196","-31","Frank O. Moselely"
"1959","Virginia Tech","6","4","0","0.6","222","178","44","Frank O. Moselely"
"1960","Virginia Tech","6","4","0","0.6","173","103","70","Frank O. Moselely"
"1961","Virginia Tech","4","5","0","0.44444","93","112","-19","Jerry Claiborne"
"1962","Virginia Tech","5","5","0","0.5","137","137","0","Jerry Claiborne"
"1963","Virginia Tech","8","2","0","0.8","216","126","90","Jerry Claiborne"
"1964","Virginia Tech","6","4","0","0.6","224","178","46","Jerry Claiborne"
"1965","Virginia Tech","7","3","0","0.7","188","134","54","Jerry Claiborne"
"1966","Virginia Tech","8","2","1","0.77273","245","104","141","Jerry Claiborne"
"1967","Virginia Tech","7","3","0","0.7","183","112","71","Jerry Claiborne"
"1968","Virginia Tech","7","4","0","0.63636","240","165","75","Jerry Claiborne"
"1969","Virginia Tech","4","5","1","0.45","234","110","124","Jerry Claiborne"
"1970","Virginia Tech","5","6","0","0.45455","199","228","-29","Jerry Claiborne"
"1971","Virginia Tech","4","7","0","0.36364","249","272","-23","Charlie Coffey"
"1972","Virginia Tech","6","4","1","0.59091","307","253","54","Charlie Coffey"
"1973","Virginia Tech","2","9","0","0.18182","223","380","-157","Charlie Coffey"
"1974","Virginia Tech","4","7","0","0.36364","278","261","17","Jimmy Sharpe"
"1975","Virginia Tech","8","3","0","0.72727","238","151","87","Jimmy Sharpe"
"1976","Virginia Tech","6","5","0","0.54545","223","176","47","Jimmy Sharpe"
"1977","Virginia Tech","3","7","1","0.31818","174","210","-36","Jimmy Sharpe"
"1978","Virginia Tech","4","7","0","0.36364","162","225","-63","Bill Dooley"
"1979","Virginia Tech","5","6","0","0.45455","224","222","2","Bill Dooley"
"1980","Virginia Tech","8","4","0","0.66667","249","129","120","Bill Dooley"
"1981","Virginia Tech","7","4","0","0.63636","232","128","104","Bill Dooley"
"1982","Virginia Tech","7","4","0","0.63636","211","141","70","Bill Dooley"
"1983","Virginia Tech","9","2","0","0.81818","301","91","210","Bill Dooley"
"1984","Virginia Tech","8","4","0","0.66667","253","150","103","Bill Dooley"
"1985","Virginia Tech","6","5","0","0.54545","274","219","55","Bill Dooley"
"1986","Virginia Tech","10","1","1","0.875","286","208","78","Bill Dooley"
"1987","Virginia Tech","2","9","0","0.18182","203","300","-97","Frank Beamer"
"1988","Virginia Tech","3","8","0","0.27273","176","264","-88","Frank Beamer"
"1989","Virginia Tech","6","4","1","0.59091","203","180","23","Frank Beamer"
"1990","Virginia Tech","6","5","0","0.54545","245","227","18","Frank Beamer"
"1991","Virginia Tech","5","6","0","0.45455","275","229","46","Frank Beamer"
"1992","Virginia Tech","2","8","1","0.22727","270","282","-12","Frank Beamer"
"1993","Virginia Tech","9","3","0","0.75","445","270","175","Frank Beamer"
"1994","Virginia Tech","8","4","0","0.66667","327","247","80","Frank Beamer"
"1995","Virginia Tech","10","2","0","0.83333","349","165","184","Frank Beamer"
"1996","Virginia Tech","10","2","0","0.83333","370","209","161","Frank Beamer"
"1997","Virginia Tech","7","5","0","0.58333","324","227","97","Frank Beamer"
"1998","Virginia Tech","9","3","0","0.75","381","149","232","Frank Beamer"
"1999","Virginia Tech","11","1","0","0.91667","484","162","322","Frank Beamer"
"2000","Virginia Tech","11","1","0","0.91667","484","269","215","Frank Beamer"
"2001","Virginia Tech","8","4","0","0.66667","376","177","199","Frank Beamer"
"2002","Virginia Tech","10","4","0","0.71429","429","263","166","Frank Beamer"
"2003","Virginia Tech","8","5","0","0.61538","460","299","161","Frank Beamer"
"2004","Virginia Tech","10","3","0","0.76923","400","167","233","Frank Beamer"
"2005","Virginia Tech","11","2","0","0.84615","440","168","272","Frank Beamer"
"2006","Virginia Tech","10","3","0","0.76923","336","143","193","Frank Beamer"
"2007","Virginia Tech","11","3","0","0.78571","402","225","177","Frank Beamer"
"2008","Virginia Tech","10","4","0","0.71429","309","234","75","Frank Beamer"
"2009","Virginia Tech","10","3","0","0.76923","414","203","211","Frank Beamer"
"2010","Virginia Tech","11","3","0","0.78571","474","288","186","Frank Beamer"
"2011","Virginia Tech","11","3","0","0.78571","391","247","144","Frank Beamer"
"2012","Virginia Tech","7","6","0","0.53846","326","297","29","Frank Beamer"
"2013","Virginia Tech","8","5","0","0.61538","293","251","42","Frank Beamer"
"2014","Virginia Tech","7","6","0","0.53846","313","262","51","Frank Beamer"
"1888","Wake Forest (NC)","1","0","0","1","6","4","2","W.C. Dowd"
"1888","Wake Forest (NC)","1","1","0","0.5","32","33","-1","W.C. Riddick"
"1889","Wake Forest (NC)","2","2","0","0.5","58","76","-18","W.C. Riddick"
"1891","Wake Forest (NC)","1","0","0","1","4","6","-2","E. Walter Sikes"
"1892","Wake Forest (NC)","4","0","1","0.9","94","18","76","E. Walter Sikes"
"1893","Wake Forest (NC)","1","2","0","0.33333","70","52","18","E. Walter Sikes"
"1908","Wake Forest (NC)","1","4","0","0.2","25","149","-124","A.P. Hall, Jr."
"1909","Wake Forest (NC)","2","4","0","0.33333","11","45","-34","A.T. Myers"
"1910","Wake Forest (NC)","2","7","0","0.22222","53","154","-101","Reddy Rowe"
"1911","Wake Forest (NC)","3","5","0","0.375","159","81","78","Frank Thompson"
"1912","Wake Forest (NC)","2","6","0","0.25","108","87","21","Frank Thompson"
"1913","Wake Forest (NC)","0","8","0","0","30","200","-170","Frank Thompson"
"1914","Wake Forest (NC)","3","6","0","0.33333","86","221","-135","Dr. Wilbur C. Smith"
"1915","Wake Forest (NC)","3","4","0","0.42857","161","90","71","Dr. Wilbur C. Smith"
"1916","Wake Forest (NC)","3","3","0","0.5","107","85","22","G.M. Billings"
"1917","Wake Forest (NC)","1","6","1","0.1875","59","215","-156","Edward Thomas MacDonnell, Sr."
"1918","Wake Forest (NC)","1","3","0","0.25","40","59","-19","Harry A. Rabenhorst"
"1919","Wake Forest (NC)","2","6","0","0.25","118","143","-25","Harry A. Rabenhorst"
"1920","Wake Forest (NC)","2","7","0","0.22222","98","190","-92","J.L. White"
"1921","Wake Forest (NC)","2","8","0","0.2","66","222","-156","J.L. White"
"1922","Wake Forest (NC)","3","5","2","0.4","62","144","-82","George Levene"
"1923","Wake Forest (NC)","6","3","0","0.66667","125","64","61","Henry M. ""Hank"" Garrity"
"1924","Wake Forest (NC)","7","2","0","0.77778","206","62","144","Henry M. ""Hank"" Garrity"
"1925","Wake Forest (NC)","6","2","1","0.72222","185","40","145","Henry M. ""Hank"" Garrity"
"1926","Wake Forest (NC)","5","4","1","0.55","186","46","140","James A. Baldwin"
"1927","Wake Forest (NC)","2","6","2","0.3","64","222","-158","James A. Baldwin"
"1928","Wake Forest (NC)","2","6","2","0.3","64","203","-139","Stanley B. ""Stan"" Cofall"
"1929","Wake Forest (NC)","6","5","1","0.54167","108","155","-47","Frank S. ""Pat"" Miller"
"1930","Wake Forest (NC)","5","3","1","0.61111","125","77","48","Frank S. ""Pat"" Miller"
"1931","Wake Forest (NC)","4","4","0","0.5","44","138","-94","Frank S. ""Pat"" Miller"
"1932","Wake Forest (NC)","3","3","2","0.5","39","36","3","Frank S. ""Pat"" Miller"
"1933","Wake Forest (NC)","0","5","1","0.08333","13","93","-80","James H. ""Jim"" Weaver"
"1934","Wake Forest (NC)","3","7","0","0.3","118","141","-23","James H. ""Jim"" Weaver"
"1935","Wake Forest (NC)","2","7","0","0.22222","52","106","-54","James H. ""Jim"" Weaver"
"1936","Wake Forest (NC)","5","4","0","0.55556","110","72","38","James H. ""Jim"" Weaver"
"1937","Wake Forest (NC)","3","6","0","0.33333","68","220","-152","Douglas Clyde ""Pea Head"" Walker"
"1938","Wake Forest (NC)","4","5","1","0.45","161","98","63","Douglas Clyde ""Pea Head"" Walker"
"1939","Wake Forest (NC)","7","3","0","0.7","257","89","168","Douglas Clyde ""Pea Head"" Walker"
"1940","Wake Forest (NC)","7","3","0","0.7","193","113","80","Douglas Clyde ""Pea Head"" Walker"
"1941","Wake Forest (NC)","5","5","1","0.5","218","168","50","Douglas Clyde ""Pea Head"" Walker"
"1942","Wake Forest (NC)","6","2","1","0.72222","134","66","68","Douglas Clyde ""Pea Head"" Walker"
"1943","Wake Forest (NC)","4","5","0","0.44444","165","101","64","Douglas Clyde ""Pea Head"" Walker"
"1944","Wake Forest (NC)","8","1","0","0.88889","178","75","103","Douglas Clyde ""Pea Head"" Walker"
"1945","Wake Forest (NC)","5","3","1","0.61111","163","151","12","Douglas Clyde ""Pea Head"" Walker"
"1946","Wake Forest (NC)","6","3","0","0.66667","156","92","64","Douglas Clyde ""Pea Head"" Walker"
"1947","Wake Forest (NC)","6","4","0","0.6","133","101","32","Douglas Clyde ""Pea Head"" Walker"
"1948","Wake Forest (NC)","6","4","0","0.6","224","168","56","Douglas Clyde ""Pea Head"" Walker"
"1949","Wake Forest (NC)","4","6","0","0.4","207","183","24","Douglas Clyde ""Pea Head"" Walker"
"1950","Wake Forest (NC)","6","1","2","0.77778","168","47","121","Douglas Clyde ""Pea Head"" Walker"
"1951","Wake Forest (NC)","6","4","0","0.6","200","142","58","Tom Rogers"
"1952","Wake Forest (NC)","5","4","1","0.55","162","133","29","Tom Rogers"
"1953","Wake Forest (NC)","3","6","1","0.35","114","157","-43","Tom Rogers"
"1954","Wake Forest (NC)","2","7","1","0.25","129","165","-36","Tom Rogers"
"1955","Wake Forest (NC)","5","4","1","0.55","131","153","-22","Tom Rogers"
"1956","Wake Forest (NC)","2","5","3","0.35","91","102","-11","Paul J. Amen"
"1957","Wake Forest (NC)","0","10","0","0","64","225","-161","Paul J. Amen"
"1958","Wake Forest (NC)","3","7","0","0.3","124","163","-39","Paul J. Amen"
"1959","Wake Forest (NC)","6","4","0","0.6","218","178","40","Paul J. Amen"
"1960","Wake Forest (NC)","2","8","0","0.2","119","215","-96","Bill Hildebrand"
"1961","Wake Forest (NC)","4","6","0","0.4","103","159","-56","Bill Hildebrand"
"1962","Wake Forest (NC)","0","10","0","0","66","278","-212","Bill Hildebrand"
"1963","Wake Forest (NC)","1","9","0","0.1","37","318","-281","Bill Hildebrand"
"1964","Wake Forest (NC)","5","5","0","0.5","172","178","-6","Bill Tate"
"1965","Wake Forest (NC)","3","7","0","0.3","88","204","-116","Bill Tate"
"1966","Wake Forest (NC)","3","7","0","0.3","90","162","-72","Bill Tate"
"1967","Wake Forest (NC)","4","6","0","0.4","175","256","-81","Bill Tate"
"1968","Wake Forest (NC)","2","7","1","0.25","212","228","-16","Bill Tate"
"1969","Wake Forest (NC)","3","7","0","0.3","125","279","-154","Cal Stoll"
"1970","Wake Forest (NC)","6","5","0","0.54545","191","241","-50","Cal Stoll"
"1971","Wake Forest (NC)","6","5","0","0.54545","218","178","40","Cal Stoll"
"1972","Wake Forest (NC)","2","9","0","0.18182","88","339","-251","Tom Harper"
"1973","Wake Forest (NC)","1","9","1","0.13636","73","326","-253","Chuck Mills"
"1974","Wake Forest (NC)","1","10","0","0.09091","74","348","-274","Chuck Mills"
"1975","Wake Forest (NC)","3","8","0","0.27273","221","264","-43","Chuck Mills"
"1976","Wake Forest (NC)","5","6","0","0.45455","177","206","-29","Chuck Mills"
"1977","Wake Forest (NC)","1","10","0","0.09091","113","270","-157","Chuck Mills"
"1978","Wake Forest (NC)","1","10","0","0.09091","104","274","-170","John Mackovic"
"1979","Wake Forest (NC)","8","4","0","0.66667","240","283","-43","John Mackovic"
"1980","Wake Forest (NC)","5","6","0","0.45455","251","213","38","John Mackovic"
"1981","Wake Forest (NC)","4","7","0","0.36364","217","365","-148","Al Groh"
"1982","Wake Forest (NC)","3","8","0","0.27273","200","322","-122","Al Groh"
"1983","Wake Forest (NC)","4","7","0","0.36364","257","281","-24","Al Groh"
"1984","Wake Forest (NC)","6","5","0","0.54545","205","232","-27","Al Groh"
"1985","Wake Forest (NC)","4","7","0","0.36364","212","249","-37","Al Groh"
"1986","Wake Forest (NC)","5","6","0","0.45455","325","295","30","Al Groh"
"1987","Wake Forest (NC)","7","4","0","0.63636","201","185","16","Bill Dooley"
"1988","Wake Forest (NC)","6","4","1","0.59091","282","238","44","Bill Dooley"
"1989","Wake Forest (NC)","2","8","1","0.22727","194","319","-125","Bill Dooley"
"1990","Wake Forest (NC)","3","8","0","0.27273","247","351","-104","Bill Dooley"
"1991","Wake Forest (NC)","3","8","0","0.27273","195","300","-105","Bill Dooley"
"1992","Wake Forest (NC)","8","4","0","0.66667","266","260","6","Bill Dooley"
"1993","Wake Forest (NC)","2","9","0","0.18182","199","318","-119","Jim Caldwell"
"1994","Wake Forest (NC)","3","8","0","0.27273","143","373","-230","Jim Caldwell"
"1995","Wake Forest (NC)","1","10","0","0.09091","190","360","-170","Jim Caldwell"
"1996","Wake Forest (NC)","3","8","0","0.27273","144","374","-230","Jim Caldwell"
"1997","Wake Forest (NC)","5","6","0","0.45455","245","288","-43","Jim Caldwell"
"1998","Wake Forest (NC)","3","8","0","0.27273","235","335","-100","Jim Caldwell"
"1999","Wake Forest (NC)","7","5","0","0.58333","266","209","57","Jim Caldwell"
"2000","Wake Forest (NC)","2","9","0","0.18182","181","362","-181","Jim Caldwell"
"2001","Wake Forest (NC)","6","5","0","0.54545","292","311","-19","Jim Grobe"
"2002","Wake Forest (NC)","7","6","0","0.53846","356","327","29","Jim Grobe"
"2003","Wake Forest (NC)","5","7","0","0.41667","335","347","-12","Jim Grobe"
"2004","Wake Forest (NC)","4","7","0","0.36364","230","253","-23","Jim Grobe"
"2005","Wake Forest (NC)","4","7","0","0.36364","269","316","-47","Jim Grobe"
"2006","Wake Forest (NC)","11","3","0","0.78571","302","215","87","Jim Grobe"
"2007","Wake Forest (NC)","9","4","0","0.69231","362","289","73","Jim Grobe"
"2008","Wake Forest (NC)","8","5","0","0.61538","273","238","35","Jim Grobe"
"2009","Wake Forest (NC)","5","7","0","0.41667","316","315","1","Jim Grobe"
"2010","Wake Forest (NC)","3","9","0","0.25","273","430","-157","Jim Grobe"
"2011","Wake Forest (NC)","6","7","0","0.46154","338","356","-18","Jim Grobe"
"2012","Wake Forest (NC)","5","7","0","0.41667","222","382","-160","Jim Grobe"
"2013","Wake Forest (NC)","4","8","0","0.33333","220","289","-69","Jim Grobe"
"2014","Wake Forest (NC)","3","9","0","0.25","178","317","-139","Dave Clawson"
"1892","Washington","1","1","0","0.5","14","28","-14","William B. Goodwin"
"1893","Washington","1","3","1","0.3","18","86","-68","William B. Goodwin"
"1894","Washington","1","1","1","0.5","60","38","22","C. ""Papa"" Cobb"
"1895","Washington","4","0","1","0.9","98","8","90","Ralph Nichols"
"1896","Washington","2","3","0","0.4","20","40","-20","Ralph Nichols"
"1898","Washington","1","1","0","0.5","24","18","6","Ralph Nichols"
"1897","Washington","1","2","0","0.33333","16","26","-10","Carl L. Clemans"
"1899","Washington","4","1","1","0.75","71","21","50","A.S. Jeffs"
"1900","Washington","1","2","2","0.4","27","71","-44","J.S. Dodge"
"1901","Washington","4","3","0","0.57143","59","48","11","Charles A. ""Jack"" Wright"
"1902","Washington","5","1","0","0.83333","65","17","48","James Knight"
"1903","Washington","6","1","0","0.85714","63","11","52","James Knight"
"1904","Washington","4","2","1","0.64286","113","66","47","James Knight"
"1905","Washington","5","2","2","0.66667","96","52","44","Oliver F. Cutts"
"1906","Washington","4","1","4","0.66667","49","35","14","Victor M. Place"
"1907","Washington","4","4","2","0.5","96","48","48","Victor M. Place"
"1908","Washington","6","0","1","0.92857","128","15","113","Gilmour ""Gloomy Gil"" Dobie"
"1909","Washington","7","0","0","1","214","6","208","Gilmour ""Gloomy Gil"" Dobie"
"1910","Washington","6","0","0","1","150","8","142","Gilmour ""Gloomy Gil"" Dobie"
"1911","Washington","7","0","0","1","277","9","268","Gilmour ""Gloomy Gil"" Dobie"
"1912","Washington","6","0","0","1","190","17","173","Gilmour ""Gloomy Gil"" Dobie"
"1913","Washington","7","0","0","1","266","20","246","Gilmour ""Gloomy Gil"" Dobie"
"1914","Washington","6","0","1","0.92857","242","13","229","Gilmour ""Gloomy Gil"" Dobie"
"1915","Washington","7","0","0","1","274","14","260","Gilmour ""Gloomy Gil"" Dobie"
"1916","Washington","6","0","1","0.92857","189","16","173","Gilmour ""Gloomy Gil"" Dobie"
"1918","Washington","1","1","0","0.5","6","7","-1","Anthony Savage"
"1917","Washington","1","2","1","0.375","14","47","-33","Claude J. Hunt"
"1919","Washington","5","1","0","0.83333","202","31","171","Claude J. Hunt"
"1920","Washington","1","5","0","0.16667","54","83","-29","Leonard B. ""Stub"" Allison"
"1921","Washington","3","4","1","0.4375","69","145","-76","Enoch Bagshaw"
"1922","Washington","6","1","1","0.8125","129","72","57","Enoch Bagshaw"
"1923","Washington","10","1","1","0.875","298","58","240","Enoch Bagshaw"
"1924","Washington","8","1","1","0.85","355","24","331","Enoch Bagshaw"
"1925","Washington","10","1","1","0.875","480","59","421","Enoch Bagshaw"
"1926","Washington","8","2","0","0.8","213","60","153","Enoch Bagshaw"
"1927","Washington","9","2","0","0.81818","287","59","228","Enoch Bagshaw"
"1928","Washington","7","4","0","0.63636","188","74","114","Enoch Bagshaw"
"1929","Washington","2","6","1","0.27778","145","127","18","Enoch Bagshaw"
"1930","Washington","5","4","0","0.55556","182","67","115","James M. ""Jimmy"" Phelan"
"1931","Washington","5","3","1","0.61111","166","83","83","James M. ""Jimmy"" Phelan"
"1932","Washington","6","2","2","0.7","193","56","137","James M. ""Jimmy"" Phelan"
"1933","Washington","5","4","0","0.55556","88","81","7","James M. ""Jimmy"" Phelan"
"1934","Washington","6","1","1","0.8125","104","51","53","James M. ""Jimmy"" Phelan"
"1935","Washington","5","3","0","0.625","93","42","51","James M. ""Jimmy"" Phelan"
"1936","Washington","7","2","1","0.75","148","56","92","James M. ""Jimmy"" Phelan"
"1937","Washington","7","2","2","0.72727","187","52","135","James M. ""Jimmy"" Phelan"
"1938","Washington","3","5","1","0.38889","68","83","-15","James M. ""Jimmy"" Phelan"
"1939","Washington","4","5","0","0.44444","77","93","-16","James M. ""Jimmy"" Phelan"
"1940","Washington","7","2","0","0.77778","169","54","115","James M. ""Jimmy"" Phelan"
"1941","Washington","5","4","0","0.55556","120","94","26","James M. ""Jimmy"" Phelan"
"1942","Washington","4","3","3","0.55","113","60","53","W. Ralph ""Pest"" Welch"
"1943","Washington","4","1","0","0.8","150","61","89","W. Ralph ""Pest"" Welch"
"1944","Washington","5","3","0","0.625","293","132","161","W. Ralph ""Pest"" Welch"
"1945","Washington","6","3","0","0.66667","91","54","37","W. Ralph ""Pest"" Welch"
"1946","Washington","5","4","0","0.55556","144","140","4","W. Ralph ""Pest"" Welch"
"1947","Washington","3","6","0","0.33333","98","99","-1","W. Ralph ""Pest"" Welch"
"1948","Washington","2","7","1","0.25","89","189","-100","Howard ""Howie"" Odell"
"1949","Washington","3","7","0","0.3","167","285","-118","Howard ""Howie"" Odell"
"1950","Washington","8","2","0","0.8","265","134","131","Howard ""Howie"" Odell"
"1951","Washington","3","6","1","0.35","273","218","55","Howard ""Howie"" Odell"
"1952","Washington","7","3","0","0.7","248","201","47","Howard ""Howie"" Odell"
"1953","Washington","3","6","1","0.35","154","217","-63","John Cherberg"
"1954","Washington","2","8","0","0.2","78","215","-137","John Cherberg"
"1955","Washington","5","4","1","0.55","141","93","48","John Cherberg"
"1956","Washington","5","5","0","0.5","232","206","26","Darrell Royal"
"1957","Washington","3","6","1","0.35","120","212","-92","James ""Jim"" Owens"
"1958","Washington","3","7","0","0.3","102","146","-44","James ""Jim"" Owens"
"1959","Washington","10","1","0","0.90909","253","73","180","James ""Jim"" Owens"
"1960","Washington","10","1","0","0.90909","272","107","165","James ""Jim"" Owens"
"1961","Washington","5","4","1","0.55","119","98","21","James ""Jim"" Owens"
"1962","Washington","7","1","2","0.8","208","83","125","James ""Jim"" Owens"
"1963","Washington","6","5","0","0.54545","183","141","42","James ""Jim"" Owens"
"1964","Washington","6","4","0","0.6","139","110","29","James ""Jim"" Owens"
"1965","Washington","5","5","0","0.5","205","185","20","James ""Jim"" Owens"
"1966","Washington","6","4","0","0.6","171","141","30","James ""Jim"" Owens"
"1967","Washington","5","5","0","0.5","136","130","6","James ""Jim"" Owens"
"1968","Washington","3","5","2","0.4","154","177","-23","James ""Jim"" Owens"
"1969","Washington","1","9","0","0.1","116","304","-188","James ""Jim"" Owens"
"1970","Washington","6","4","0","0.6","334","216","118","James ""Jim"" Owens"
"1971","Washington","8","3","0","0.72727","357","188","169","James ""Jim"" Owens"
"1972","Washington","8","3","0","0.72727","208","204","4","James ""Jim"" Owens"
"1973","Washington","2","9","0","0.18182","218","376","-158","James ""Jim"" Owens"
"1974","Washington","5","6","0","0.45455","272","285","-13","James ""Jim"" Owens"
"1975","Washington","6","5","0","0.54545","196","250","-54","Don James"
"1976","Washington","5","6","0","0.45455","237","207","30","Don James"
"1977","Washington","10","2","0","0.83333","344","194","150","Don James"
"1978","Washington","7","4","0","0.63636","270","155","115","Don James"
"1979","Washington","10","2","0","0.83333","321","154","167","Don James"
"1980","Washington","9","3","0","0.75","333","198","135","Don James"
"1981","Washington","10","2","0","0.83333","281","171","110","Don James"
"1982","Washington","10","2","0","0.83333","354","193","161","Don James"
"1983","Washington","8","4","0","0.66667","285","178","107","Don James"
"1984","Washington","11","1","0","0.91667","352","145","207","Don James"
"1985","Washington","7","5","0","0.58333","238","225","13","Don James"
"1986","Washington","8","3","1","0.70833","378","197","181","Don James"
"1987","Washington","7","4","1","0.625","295","254","41","Don James"
"1988","Washington","6","5","0","0.54545","254","223","31","Don James"
"1989","Washington","8","4","0","0.66667","332","225","107","Don James"
"1990","Washington","10","2","0","0.83333","440","184","256","Don James"
"1991","Washington","12","0","0","1","495","115","380","Don James"
"1992","Washington","9","3","0","0.75","337","186","151","Don James"
"1993","Washington","7","4","0","0.63636","288","198","90","Jim Lambright"
"1994","Washington","7","4","0","0.63636","295","233","62","Jim Lambright"
"1995","Washington","7","4","1","0.625","312","280","32","Jim Lambright"
"1996","Washington","9","3","0","0.75","391","254","137","Jim Lambright"
"1997","Washington","8","4","0","0.66667","420","259","161","Jim Lambright"
"1998","Washington","6","6","0","0.5","303","343","-40","Jim Lambright"
"1999","Washington","7","5","0","0.58333","331","302","29","Rick Neuheisel"
"2000","Washington","11","1","0","0.91667","387","270","117","Rick Neuheisel"
"2001","Washington","8","4","0","0.66667","353","370","-17","Rick Neuheisel"
"2002","Washington","7","6","0","0.53846","398","342","56","Rick Neuheisel"
"2003","Washington","6","6","0","0.5","312","316","-4","Keith Gilbertson"
"2004","Washington","1","10","0","0.09091","154","334","-180","Keith Gilbertson"
"2005","Washington","2","9","0","0.18182","237","337","-100","Tyrone ""Ty"" Willingham"
"2006","Washington","5","7","0","0.41667","262","311","-49","Tyrone ""Ty"" Willingham"
"2007","Washington","4","9","0","0.30769","380","411","-31","Tyrone ""Ty"" Willingham"
"2008","Washington","0","12","0","0","159","463","-304","Tyrone ""Ty"" Willingham"
"2009","Washington","5","7","0","0.41667","313","320","-7","Steve Sarkisian"
"2010","Washington","7","6","0","0.53846","284","381","-97","Steve Sarkisian"
"2011","Washington","7","6","0","0.53846","434","467","-33","Steve Sarkisian"
"2012","Washington","7","6","0","0.53846","312","314","-2","Steve Sarkisian"
"2013","Washington","8","4","0","0.66667","462","281","181","Steve Sarkisian"
"2013","Washington","1","0","0","1","31","16","15","Marques Tuiasosopo"
"2014","Washington","8","6","0","0.57143","423","347","76","Chris Petersen"
"1894","Washington St.","1","1","0","0.5","10","18","-8","William Goodyear"
"1895","Washington St.","2","0","0","1","36","8","28","W.W. Waite"
"1896","Washington St.","2","0","1","0.83333","56","6","50","David A. Brodie"
"1897","Washington St.","2","0","0","1","32","12","20","Robert R. Gailey"
"1898","Washington St.","0","0","1","0.5","0","0","0","Frank Shively"
"1899","Washington St.","1","1","0","0.5","21","11","10","Frank Shively"
"1901","Washington St.","5","1","0","0.83333","71","7","64","William H. Namack"
"1900","Washington St.","4","0","1","0.9","39","5","34","William L. Allen"
"1902","Washington St.","2","3","0","0.4","28","39","-11","William L. Allen"
"1903","Washington St.","3","3","2","0.5","92","54","38","James N. Ashmore"
"1904","Washington St.","2","2","0","0.5","46","26","20","Everett M. Sweeley"
"1905","Washington St.","4","4","0","0.5","175","61","114","Everett M. Sweeley"
"1908","Washington St.","4","0","2","0.83333","164","10","154","Walter M. Rheinschild"
"1909","Washington St.","4","1","0","0.8","159","17","142","William S. ""Willis"" Keinholz"
"1910","Washington St.","2","3","0","0.4","25","34","-9","Oscar P. Osthoff"
"1911","Washington St.","3","3","0","0.5","92","42","50","Oscar P. Osthoff"
"1906","Washington St.","6","0","0","1","44","0","44","John R. ""Chief"" Bender"
"1907","Washington St.","7","1","0","0.875","282","19","263","John R. ""Chief"" Bender"
"1912","Washington St.","2","3","0","0.4","17","71","-54","John R. ""Chief"" Bender"
"1913","Washington St.","4","4","0","0.5","111","61","50","John R. ""Chief"" Bender"
"1914","Washington St.","2","4","0","0.33333","10","75","-65","John R. ""Chief"" Bender"
"1915","Washington St.","7","0","0","1","204","10","194","William H. ""Lone Star"" Dietz"
"1916","Washington St.","4","2","0","0.66667","136","25","111","William H. ""Lone Star"" Dietz"
"1917","Washington St.","6","0","1","0.92857","112","3","109","William H. ""Lone Star"" Dietz"
"1919","Washington St.","5","2","0","0.71429","156","33","123","Gustavius A. ""Gus"" Welch"
"1920","Washington St.","5","1","0","0.83333","129","76","53","Gustavius A. ""Gus"" Welch"
"1921","Washington St.","4","2","1","0.64286","109","62","47","Gustavius A. ""Gus"" Welch"
"1922","Washington St.","2","5","0","0.28571","44","163","-119","Gustavius A. ""Gus"" Welch"
"1923","Washington St.","2","4","1","0.35714","56","84","-28","Albert A. ""Al"" Exendine"
"1924","Washington St.","1","5","2","0.25","107","88","19","Albert A. ""Al"" Exendine"
"1925","Washington St.","3","4","1","0.4375","67","104","-37","Albert A. ""Al"" Exendine"
"1926","Washington St.","6","1","0","0.85714","85","28","57","Orin E. ""Babe"" Hollingbery"
"1927","Washington St.","3","3","2","0.5","120","67","53","Orin E. ""Babe"" Hollingbery"
"1928","Washington St.","7","3","0","0.7","202","65","137","Orin E. ""Babe"" Hollingbery"
"1929","Washington St.","10","2","0","0.83333","294","74","220","Orin E. ""Babe"" Hollingbery"
"1930","Washington St.","9","1","0","0.9","218","56","162","Orin E. ""Babe"" Hollingbery"
"1931","Washington St.","6","4","0","0.6","123","111","12","Orin E. ""Babe"" Hollingbery"
"1932","Washington St.","7","1","1","0.83333","130","28","102","Orin E. ""Babe"" Hollingbery"
"1933","Washington St.","6","3","1","0.65","170","67","103","Orin E. ""Babe"" Hollingbery"
"1934","Washington St.","5","3","1","0.61111","144","28","116","Orin E. ""Babe"" Hollingbery"
"1935","Washington St.","5","3","1","0.61111","141","81","60","Orin E. ""Babe"" Hollingbery"
"1936","Washington St.","6","3","1","0.65","108","102","6","Orin E. ""Babe"" Hollingbery"
"1937","Washington St.","3","3","3","0.5","36","67","-31","Orin E. ""Babe"" Hollingbery"
"1938","Washington St.","2","8","0","0.2","44","159","-115","Orin E. ""Babe"" Hollingbery"
"1939","Washington St.","4","5","0","0.44444","67","134","-67","Orin E. ""Babe"" Hollingbery"
"1940","Washington St.","4","4","2","0.5","131","147","-16","Orin E. ""Babe"" Hollingbery"
"1941","Washington St.","6","4","0","0.6","157","63","94","Orin E. ""Babe"" Hollingbery"
"1942","Washington St.","6","2","2","0.7","157","95","62","Orin E. ""Babe"" Hollingbery"
"1945","Washington St.","6","2","1","0.72222","157","70","87","Phillip J. ""Phil"" Sarboe"
"1946","Washington St.","1","6","1","0.1875","118","147","-29","Phillip J. ""Phil"" Sarboe"
"1947","Washington St.","3","7","0","0.3","93","148","-55","Phillip J. ""Phil"" Sarboe"
"1948","Washington St.","4","5","1","0.45","164","219","-55","Phillip J. ""Phil"" Sarboe"
"1949","Washington St.","3","6","0","0.33333","149","205","-56","Phillip J. ""Phil"" Sarboe"
"1950","Washington St.","4","3","2","0.55556","168","182","-14","Forest Evashevski"
"1951","Washington St.","7","3","0","0.7","280","187","93","Forest Evashevski"
"1952","Washington St.","4","6","0","0.4","171","215","-44","Alton S. ""Al"" Kircher"
"1953","Washington St.","4","6","0","0.4","146","256","-110","Alton S. ""Al"" Kircher"
"1954","Washington St.","4","6","0","0.4","149","225","-76","Alton S. ""Al"" Kircher"
"1955","Washington St.","1","7","2","0.2","67","257","-190","Alton S. ""Al"" Kircher"
"1956","Washington St.","3","6","1","0.35","163","247","-84","James ""Jim"" Sutherland"
"1957","Washington St.","6","4","0","0.6","193","161","32","James ""Jim"" Sutherland"
"1958","Washington St.","7","3","0","0.7","199","117","82","James ""Jim"" Sutherland"
"1959","Washington St.","6","4","0","0.6","177","121","56","James ""Jim"" Sutherland"
"1960","Washington St.","4","5","1","0.45","210","161","49","James ""Jim"" Sutherland"
"1961","Washington St.","3","7","0","0.3","163","213","-50","James ""Jim"" Sutherland"
"1962","Washington St.","5","4","1","0.55","213","167","46","James ""Jim"" Sutherland"
"1963","Washington St.","3","6","1","0.35","95","160","-65","James ""Jim"" Sutherland"
"1964","Washington St.","3","6","1","0.35","165","208","-43","Bert Clark"
"1965","Washington St.","7","3","0","0.7","139","103","36","Bert Clark"
"1966","Washington St.","3","7","0","0.3","132","211","-79","Bert Clark"
"1967","Washington St.","2","8","0","0.2","141","266","-125","Bert Clark"
"1968","Washington St.","3","6","1","0.35","189","188","1","Jim Sweeney"
"1969","Washington St.","1","9","0","0.1","143","339","-196","Jim Sweeney"
"1970","Washington St.","1","10","0","0.09091","231","460","-229","Jim Sweeney"
"1971","Washington St.","4","7","0","0.36364","246","286","-40","Jim Sweeney"
"1972","Washington St.","7","4","0","0.63636","274","241","33","Jim Sweeney"
"1973","Washington St.","5","6","0","0.45455","250","290","-40","Jim Sweeney"
"1974","Washington St.","2","9","0","0.18182","162","272","-110","Jim Sweeney"
"1975","Washington St.","3","8","0","0.27273","262","295","-33","Jim Sweeney"
"1976","Washington St.","3","8","0","0.27273","240","331","-91","Jackie Sherrill"
"1977","Washington St.","7","4","0","0.63636","263","236","27","Warren Powers"
"1978","Washington St.","4","6","1","0.40909","276","296","-20","Jim Walden"
"1979","Washington St.","5","6","0","0.45455","241","366","-125","Jim Walden"
"1980","Washington St.","4","7","0","0.36364","287","271","16","Jim Walden"
"1981","Washington St.","8","3","1","0.70833","297","197","100","Jim Walden"
"1982","Washington St.","3","7","1","0.31818","170","255","-85","Jim Walden"
"1983","Washington St.","7","4","0","0.63636","237","211","26","Jim Walden"
"1984","Washington St.","6","5","0","0.54545","317","319","-2","Jim Walden"
"1985","Washington St.","4","7","0","0.36364","313","282","31","Jim Walden"
"1986","Washington St.","3","7","1","0.31818","221","312","-91","Jim Walden"
"1987","Washington St.","3","7","1","0.31818","238","356","-118","Dennis Erickson"
"1988","Washington St.","9","3","0","0.75","415","303","112","Dennis Erickson"
"1989","Washington St.","6","5","0","0.54545","351","268","83","Mike Price"
"1990","Washington St.","3","8","0","0.27273","286","381","-95","Mike Price"
"1991","Washington St.","4","7","0","0.36364","280","340","-60","Mike Price"
"1992","Washington St.","9","3","0","0.75","337","281","56","Mike Price"
"1993","Washington St.","5","6","0","0.45455","271","248","23","Mike Price"
"1994","Washington St.","8","4","0","0.66667","192","136","56","Mike Price"
"1995","Washington St.","3","8","0","0.27273","236","274","-38","Mike Price"
"1996","Washington St.","5","6","0","0.45455","314","317","-3","Mike Price"
"1997","Washington St.","10","2","0","0.83333","483","296","187","Mike Price"
"1998","Washington St.","3","8","0","0.27273","223","349","-126","Mike Price"
"1999","Washington St.","3","9","0","0.25","248","327","-79","Mike Price"
"2000","Washington St.","4","7","0","0.36364","281","354","-73","Mike Price"
"2001","Washington St.","10","2","0","0.83333","420","269","151","Mike Price"
"2002","Washington St.","10","3","0","0.76923","431","296","135","Mike Price"
"2003","Washington St.","10","3","0","0.76923","394","257","137","Bill Doba"
"2004","Washington St.","5","6","0","0.45455","275","307","-32","Bill Doba"
"2005","Washington St.","4","7","0","0.36364","368","346","22","Bill Doba"
"2006","Washington St.","6","6","0","0.5","295","277","18","Bill Doba"
"2007","Washington St.","5","7","0","0.41667","308","389","-81","Bill Doba"
"2008","Washington St.","2","11","0","0.15385","165","570","-405","Paul Wulff"
"2009","Washington St.","1","11","0","0.08333","144","462","-318","Paul Wulff"
"2010","Washington St.","2","10","0","0.16667","235","430","-195","Paul Wulff"
"2011","Washington St.","4","8","0","0.33333","358","381","-23","Paul Wulff"
"2012","Washington St.","3","9","0","0.25","245","404","-159","Mike Leach"
"2013","Washington St.","6","7","0","0.46154","403","423","-20","Mike Leach"
"2014","Washington St.","3","9","0","0.25","382","463","-81","Mike Leach"
"1922","Western Michigan","6","0","0","1","160","0","160","Milton Olander"
"1923","Western Michigan","6","1","1","0.8125","159","21","138","Milton Olander"
"1924","Western Michigan","6","1","1","0.8125","121","46","75","Earl Martineau"
"1925","Western Michigan","6","2","1","0.72222","125","47","78","Earl Martineau"
"1926","Western Michigan","7","1","0","0.875","132","20","112","Earl Martineau"
"1927","Western Michigan","3","4","0","0.42857","100","75","25","Earl Martineau"
"1928","Western Michigan","5","2","0","0.71429","119","32","87","Earl Martineau"
"1929","Western Michigan","5","2","1","0.6875","161","44","117","Mitchell Gary"
"1930","Western Michigan","5","1","1","0.78571","192","25","167","Mitchell Gary"
"1931","Western Michigan","5","2","0","0.71429","86","51","35","Mitchell Gary"
"1932","Western Michigan","6","0","1","0.92857","174","6","168","Mitchell Gary"
"1933","Western Michigan","3","3","1","0.5","66","64","2","Mitchell Gary"
"1934","Western Michigan","7","1","0","0.875","104","52","52","Mitchell Gary"
"1935","Western Michigan","5","3","0","0.625","78","91","-13","Mitchell Gary"
"1936","Western Michigan","2","5","0","0.28571","60","90","-30","Mitchell Gary"
"1937","Western Michigan","5","3","0","0.625","92","65","27","Mitchell Gary"
"1938","Western Michigan","4","3","0","0.57143","102","26","76","Mitchell Gary"
"1939","Western Michigan","2","6","1","0.27778","51","85","-34","Mitchell Gary"
"1940","Western Michigan","2","5","0","0.28571","77","117","-40","Mitchell Gary"
"1941","Western Michigan","8","0","0","1","183","27","156","Mitchell Gary"
"1942","Western Michigan","5","1","0","0.83333","66","36","30","John W. Gill"
"1943","Western Michigan","4","2","0","0.66667","151","89","62","John W. Gill"
"1944","Western Michigan","4","3","0","0.57143","162","123","39","John W. Gill"
"1945","Western Michigan","4","3","0","0.57143","147","105","42","John W. Gill"
"1946","Western Michigan","5","2","1","0.6875","158","100","58","John W. Gill"
"1947","Western Michigan","5","4","0","0.55556","139","147","-8","John W. Gill"
"1948","Western Michigan","6","3","0","0.66667","199","106","93","John W. Gill"
"1949","Western Michigan","4","4","0","0.5","148","123","25","John W. Gill"
"1950","Western Michigan","5","4","0","0.55556","188","163","25","John W. Gill"
"1951","Western Michigan","4","4","0","0.5","164","160","4","John W. Gill"
"1952","Western Michigan","4","4","0","0.5","154","159","-5","John W. Gill"
"1953","Western Michigan","1","6","1","0.1875","66","238","-172","Jack Petoskey"
"1954","Western Michigan","4","5","0","0.44444","136","186","-50","Jack Petoskey"
"1955","Western Michigan","1","7","1","0.16667","80","200","-120","Jack Petoskey"
"1956","Western Michigan","2","7","0","0.22222","114","168","-54","Jack Petoskey"
"1957","Western Michigan","4","4","1","0.5","150","127","23","Merle Schlosser"
"1958","Western Michigan","4","5","0","0.44444","188","200","-12","Merle Schlosser"
"1959","Western Michigan","4","5","0","0.44444","184","116","68","Merle Schlosser"
"1960","Western Michigan","4","4","1","0.5","173","106","67","Merle Schlosser"
"1961","Western Michigan","5","4","1","0.55","142","179","-37","Merle Schlosser"
"1962","Western Michigan","5","4","0","0.55556","158","112","46","Merle Schlosser"
"1963","Western Michigan","2","7","0","0.22222","111","201","-90","Merle Schlosser"
"1964","Western Michigan","3","6","0","0.33333","77","185","-108","William Doolittle"
"1965","Western Michigan","6","2","1","0.72222","128","127","1","William Doolittle"
"1966","Western Michigan","7","3","0","0.7","175","194","-19","William Doolittle"
"1967","Western Michigan","5","4","0","0.55556","156","164","-8","William Doolittle"
"1968","Western Michigan","3","6","0","0.33333","160","191","-31","William Doolittle"
"1969","Western Michigan","4","6","0","0.4","216","203","13","William Doolittle"
"1970","Western Michigan","7","3","0","0.7","277","132","145","William Doolittle"
"1971","Western Michigan","7","3","0","0.7","228","124","104","William Doolittle"
"1972","Western Michigan","7","3","1","0.68182","229","201","28","William Doolittle"
"1973","Western Michigan","6","5","0","0.54545","190","218","-28","William Doolittle"
"1974","Western Michigan","3","8","0","0.27273","187","269","-82","William Doolittle"
"1975","Western Michigan","1","10","0","0.09091","119","297","-178","Elliot Uzelac"
"1976","Western Michigan","7","4","0","0.63636","270","202","68","Elliot Uzelac"
"1977","Western Michigan","4","7","0","0.36364","254","231","23","Elliot Uzelac"
"1978","Western Michigan","7","4","0","0.63636","220","152","68","Elliot Uzelac"
"1979","Western Michigan","6","5","0","0.54545","186","127","59","Elliot Uzelac"
"1980","Western Michigan","7","4","0","0.63636","233","179","54","Elliot Uzelac"
"1981","Western Michigan","6","5","0","0.54545","206","170","36","Elliot Uzelac"
"1982","Western Michigan","7","2","2","0.72727","186","78","108","Jack Harbaugh"
"1983","Western Michigan","6","5","0","0.54545","179","208","-29","Jack Harbaugh"
"1984","Western Michigan","5","6","0","0.45455","234","213","21","Jack Harbaugh"
"1985","Western Michigan","4","6","1","0.40909","182","212","-30","Jack Harbaugh"
"1986","Western Michigan","4","7","0","0.36364","183","257","-74","Jack Harbaugh"
"1987","Western Michigan","5","6","0","0.45455","218","240","-22","Alan ""Al"" Molde"
"1988","Western Michigan","9","3","0","0.75","354","237","117","Alan ""Al"" Molde"
"1989","Western Michigan","5","6","0","0.45455","210","210","0","Alan ""Al"" Molde"
"1990","Western Michigan","7","4","0","0.63636","249","235","14","Alan ""Al"" Molde"
"1991","Western Michigan","6","5","0","0.54545","218","253","-35","Alan ""Al"" Molde"
"1992","Western Michigan","7","3","1","0.68182","197","177","20","Alan ""Al"" Molde"
"1993","Western Michigan","7","3","1","0.68182","236","187","49","Alan ""Al"" Molde"
"1994","Western Michigan","7","4","0","0.63636","274","189","85","Alan ""Al"" Molde"
"1995","Western Michigan","7","4","0","0.63636","253","190","63","Alan ""Al"" Molde"
"1996","Western Michigan","2","9","0","0.18182","208","304","-96","Alan ""Al"" Molde"
"1997","Western Michigan","8","3","0","0.72727","301","265","36","Gary Darnell"
"1998","Western Michigan","7","4","0","0.63636","360","312","48","Gary Darnell"
"1999","Western Michigan","7","5","0","0.58333","373","342","31","Gary Darnell"
"2000","Western Michigan","9","3","0","0.75","359","139","220","Gary Darnell"
"2001","Western Michigan","5","6","0","0.45455","277","266","11","Gary Darnell"
"2002","Western Michigan","4","8","0","0.33333","303","330","-27","Gary Darnell"
"2003","Western Michigan","5","7","0","0.41667","331","370","-39","Gary Darnell"
"2004","Western Michigan","1","10","0","0.09091","248","436","-188","Gary Darnell"
"2005","Western Michigan","7","4","0","0.63636","354","342","12","Bill Cubit"
"2006","Western Michigan","8","5","0","0.61538","299","259","40","Bill Cubit"
"2007","Western Michigan","5","7","0","0.41667","323","347","-24","Bill Cubit"
"2008","Western Michigan","9","4","0","0.69231","372","324","48","Bill Cubit"
"2009","Western Michigan","5","7","0","0.41667","296","330","-34","Bill Cubit"
"2010","Western Michigan","6","6","0","0.5","388","286","102","Bill Cubit"
"2011","Western Michigan","7","6","0","0.53846","459","373","86","Bill Cubit"
"2012","Western Michigan","4","8","0","0.33333","352","356","-4","Bill Cubit"
"2013","Western Michigan","1","11","0","0.08333","206","425","-219","Phillip John ""PJ"" Fleck"
"2014","Western Michigan","8","5","0","0.61538","439","324","115","Phillip John ""PJ"" Fleck"
"1889","Wisconsin","0","2","0","0","0","31","-31","Alvin Kletsch"
"1890","Wisconsin","1","3","0","0.25","122","101","21","Ted Mestre"
"1891","Wisconsin","3","1","1","0.7","98","30","68","Herb Alward"
"1892","Wisconsin","4","4","0","0.5","102","96","6","Frank Crawford"
"1893","Wisconsin","4","2","0","0.66667","112","110","2","Parke H. Davis"
"1894","Wisconsin","5","2","0","0.71429","158","20","138","Hiram O. Stickney"
"1895","Wisconsin","5","2","1","0.6875","144","71","73","Hiram O. Stickney"
"1896","Wisconsin","7","1","1","0.83333","206","30","176","Phillip ""Phil"" King"
"1897","Wisconsin","9","1","0","0.9","210","14","196","Phillip ""Phil"" King"
"1898","Wisconsin","9","1","0","0.9","318","17","301","Phillip ""Phil"" King"
"1899","Wisconsin","10","2","0","0.83333","299","33","266","Phillip ""Phil"" King"
"1900","Wisconsin","8","1","0","0.88889","300","11","289","Phillip ""Phil"" King"
"1901","Wisconsin","9","0","0","1","316","5","311","Phillip ""Phil"" King"
"1902","Wisconsin","6","3","0","0.66667","228","39","189","Phillip ""Phil"" King"
"1905","Wisconsin","8","2","0","0.8","226","28","198","Phillip ""Phil"" King"
"1903","Wisconsin","6","3","1","0.65","305","67","238","Arthur H. Curtis"
"1904","Wisconsin","5","3","0","0.625","265","74","191","Arthur H. Curtis"
"1906","Wisconsin","5","0","0","1","78","15","63","Dr. Charles P. Hutchins"
"1907","Wisconsin","3","1","1","0.7","50","51","-1","Dr. Charles P. Hutchins"
"1908","Wisconsin","5","1","0","0.83333","101","39","62","Thomas A. ""Tom"" Barry"
"1909","Wisconsin","3","1","1","0.7","61","54","7","Thomas A. ""Tom"" Barry"
"1910","Wisconsin","1","2","2","0.4","19","46","-27","Thomas A. ""Tom"" Barry"
"1911","Wisconsin","5","1","1","0.78571","111","14","97","John R. Richards"
"1917","Wisconsin","4","2","1","0.64286","85","30","55","John R. Richards"
"1919","Wisconsin","5","2","0","0.71429","91","41","50","John R. Richards"
"1920","Wisconsin","6","1","0","0.85714","141","29","112","John R. Richards"
"1921","Wisconsin","5","1","1","0.78571","141","13","128","John R. Richards"
"1922","Wisconsin","4","2","1","0.64286","101","22","79","John R. Richards"
"1912","Wisconsin","7","0","0","1","246","29","217","William J. ""Bill"" Juneau"
"1913","Wisconsin","3","3","1","0.5","100","66","34","William J. ""Bill"" Juneau"
"1914","Wisconsin","4","2","1","0.64286","102","51","51","William J. ""Bill"" Juneau"
"1915","Wisconsin","4","3","0","0.57143","235","54","181","William J. ""Bill"" Juneau"
"1916","Wisconsin","4","2","1","0.64286","104","78","26","Dr. Paul O. Withington"
"1918","Wisconsin","3","3","0","0.5","42","44","-2","Guy Summer Lowman"
"1923","Wisconsin","3","3","1","0.5","89","32","57","John J. ""Jack"" Ryan"
"1924","Wisconsin","2","3","3","0.4375","66","94","-28","John J. ""Jack"" Ryan"
"1925","Wisconsin","6","1","1","0.8125","131","50","81","George E. Little"
"1926","Wisconsin","5","2","1","0.6875","122","72","50","George E. Little"
"1927","Wisconsin","4","4","0","0.5","96","75","21","Glenn F. Thistlethwaite"
"1928","Wisconsin","7","1","1","0.83333","163","38","125","Glenn F. Thistlethwaite"
"1929","Wisconsin","4","5","0","0.44444","88","78","10","Glenn F. Thistlethwaite"
"1930","Wisconsin","6","2","1","0.72222","227","40","187","Glenn F. Thistlethwaite"
"1931","Wisconsin","5","4","1","0.55","105","110","-5","Glenn F. Thistlethwaite"
"1932","Wisconsin","6","1","1","0.8125","151","48","103","Clarence W. ""Doc"" Spears"
"1933","Wisconsin","2","5","1","0.3125","54","79","-25","Clarence W. ""Doc"" Spears"
"1934","Wisconsin","4","4","0","0.5","48","84","-36","Clarence W. ""Doc"" Spears"
"1935","Wisconsin","1","7","0","0.125","53","171","-118","Clarence W. ""Doc"" Spears"
"1936","Wisconsin","2","6","0","0.25","95","144","-49","Harry A. Stuhldreher"
"1937","Wisconsin","4","3","1","0.5625","103","61","42","Harry A. Stuhldreher"
"1938","Wisconsin","5","3","0","0.625","111","93","18","Harry A. Stuhldreher"
"1939","Wisconsin","1","6","1","0.1875","54","113","-59","Harry A. Stuhldreher"
"1940","Wisconsin","4","4","0","0.5","125","134","-9","Harry A. Stuhldreher"
"1941","Wisconsin","3","5","0","0.375","144","208","-64","Harry A. Stuhldreher"
"1942","Wisconsin","8","1","1","0.85","149","68","81","Harry A. Stuhldreher"
"1943","Wisconsin","1","9","0","0.1","41","282","-241","Harry A. Stuhldreher"
"1944","Wisconsin","3","6","0","0.33333","112","180","-68","Harry A. Stuhldreher"
"1945","Wisconsin","3","4","2","0.44444","128","128","0","Harry A. Stuhldreher"
"1946","Wisconsin","4","5","0","0.44444","140","144","-4","Harry A. Stuhldreher"
"1947","Wisconsin","5","3","1","0.61111","171","156","15","Harry A. Stuhldreher"
"1948","Wisconsin","2","7","0","0.22222","126","193","-67","Harry A. Stuhldreher"
"1949","Wisconsin","5","3","1","0.61111","207","129","78","Ivan B. ""Ivy"" Williamson"
"1950","Wisconsin","6","3","0","0.66667","137","97","40","Ivan B. ""Ivy"" Williamson"
"1951","Wisconsin","7","1","1","0.83333","196","53","143","Ivan B. ""Ivy"" Williamson"
"1952","Wisconsin","6","3","1","0.65","228","150","78","Ivan B. ""Ivy"" Williamson"
"1953","Wisconsin","6","2","1","0.72222","179","110","69","Ivan B. ""Ivy"" Williamson"
"1954","Wisconsin","7","2","0","0.77778","200","98","102","Ivan B. ""Ivy"" Williamson"
"1955","Wisconsin","4","5","0","0.44444","172","166","6","Ivan B. ""Ivy"" Williamson"
"1956","Wisconsin","1","5","3","0.27778","93","129","-36","Milton ""Milt"" Bruhn"
"1957","Wisconsin","6","3","0","0.66667","234","122","112","Milton ""Milt"" Bruhn"
"1958","Wisconsin","7","1","1","0.83333","201","77","124","Milton ""Milt"" Bruhn"
"1959","Wisconsin","7","3","0","0.7","165","149","16","Milton ""Milt"" Bruhn"
"1960","Wisconsin","4","5","0","0.44444","148","183","-35","Milton ""Milt"" Bruhn"
"1961","Wisconsin","6","3","0","0.66667","179","158","21","Milton ""Milt"" Bruhn"
"1962","Wisconsin","8","2","0","0.8","322","130","192","Milton ""Milt"" Bruhn"
"1963","Wisconsin","5","4","0","0.55556","150","124","26","Milton ""Milt"" Bruhn"
"1964","Wisconsin","3","6","0","0.33333","98","190","-92","Milton ""Milt"" Bruhn"
"1965","Wisconsin","2","7","1","0.25","81","291","-210","Milton ""Milt"" Bruhn"
"1966","Wisconsin","3","6","1","0.35","87","212","-125","Milton ""Milt"" Bruhn"
"1967","Wisconsin","0","9","1","0.05","120","224","-104","John Coatta"
"1968","Wisconsin","0","10","0","0","86","310","-224","John Coatta"
"1969","Wisconsin","3","7","0","0.3","196","349","-153","John Coatta"
"1970","Wisconsin","4","5","1","0.45","198","195","3","John Jardine"
"1971","Wisconsin","4","6","1","0.40909","240","258","-18","John Jardine"
"1972","Wisconsin","4","7","0","0.36364","152","229","-77","John Jardine"
"1973","Wisconsin","4","7","0","0.36364","216","237","-21","John Jardine"
"1974","Wisconsin","7","4","0","0.63636","341","243","98","John Jardine"
"1975","Wisconsin","4","6","1","0.40909","174","269","-95","John Jardine"
"1976","Wisconsin","5","6","0","0.45455","298","266","32","John Jardine"
"1977","Wisconsin","5","6","0","0.45455","133","200","-67","John Jardine"
"1978","Wisconsin","5","4","2","0.54545","223","277","-54","Dave McClain"
"1979","Wisconsin","4","7","0","0.36364","208","311","-103","Dave McClain"
"1980","Wisconsin","4","7","0","0.36364","138","211","-73","Dave McClain"
"1981","Wisconsin","7","5","0","0.58333","268","219","49","Dave McClain"
"1982","Wisconsin","7","5","0","0.58333","287","252","35","Dave McClain"
"1983","Wisconsin","7","4","0","0.63636","359","242","117","Dave McClain"
"1984","Wisconsin","7","4","1","0.625","242","206","36","Dave McClain"
"1985","Wisconsin","5","6","0","0.45455","231","263","-32","Dave McClain"
"1986","Wisconsin","3","9","0","0.25","201","266","-65","Jim Hilles"
"1987","Wisconsin","3","8","0","0.27273","202","299","-97","Don Morton"
"1988","Wisconsin","1","10","0","0.09091","106","314","-208","Don Morton"
"1989","Wisconsin","2","9","0","0.18182","172","341","-169","Don Morton"
"1990","Wisconsin","1","10","0","0.09091","133","285","-152","Barry Alvarez"
"1991","Wisconsin","5","6","0","0.45455","172","194","-22","Barry Alvarez"
"1992","Wisconsin","5","6","0","0.45455","212","199","13","Barry Alvarez"
"1993","Wisconsin","10","1","1","0.875","354","195","159","Barry Alvarez"
"1994","Wisconsin","8","3","1","0.70833","357","238","119","Barry Alvarez"
"1995","Wisconsin","4","5","2","0.45455","235","253","-18","Barry Alvarez"
"1996","Wisconsin","8","5","0","0.61538","377","243","134","Barry Alvarez"
"1997","Wisconsin","8","5","0","0.61538","291","306","-15","Barry Alvarez"
"1998","Wisconsin","11","1","0","0.91667","382","143","239","Barry Alvarez"
"1999","Wisconsin","10","2","0","0.83333","409","154","255","Barry Alvarez"
"2000","Wisconsin","9","4","0","0.69231","328","265","63","Barry Alvarez"
"2001","Wisconsin","5","7","0","0.41667","313","346","-33","Barry Alvarez"
"2002","Wisconsin","8","6","0","0.57143","372","322","50","Barry Alvarez"
"2003","Wisconsin","7","6","0","0.53846","355","306","49","Barry Alvarez"
"2004","Wisconsin","9","3","0","0.75","249","185","64","Barry Alvarez"
"2005","Wisconsin","10","3","0","0.76923","446","309","137","Barry Alvarez"
"2012","Wisconsin","0","1","0","0","14","20","-6","Barry Alvarez"
"2014","Wisconsin","1","0","0","1","34","31","3","Barry Alvarez"
"2006","Wisconsin","12","1","0","0.92308","380","157","223","Bret Bielema"
"2007","Wisconsin","9","4","0","0.69231","383","301","82","Bret Bielema"
"2008","Wisconsin","7","6","0","0.53846","357","345","12","Bret Bielema"
"2009","Wisconsin","10","3","0","0.76923","413","283","130","Bret Bielema"
"2010","Wisconsin","11","2","0","0.84615","539","267","272","Bret Bielema"
"2011","Wisconsin","11","3","0","0.78571","618","266","352","Bret Bielema"
"2012","Wisconsin","8","5","0","0.61538","400","248","152","Bret Bielema"
"2013","Wisconsin","9","4","0","0.69231","453","212","241","Gary Andersen"
"2014","Wisconsin","10","3","0","0.76923","450","260","190","Deleted"
"1894","Wyoming","3","0","0","1","46","6","40","Fred Hess & Justus F. Soule"
"1893","Wyoming","1","0","0","1","14","0","14","Fred Hess"
"1898","Wyoming","0","4","0","0","8","95","-87","Fred Hess"
"1895","Wyoming","1","0","0","1","34","0","34","Justus F. Soule"
"1896","Wyoming","2","0","0","1","28","20","8","Justus F. Soule"
"1897","Wyoming","2","0","0","1","20","0","20","Justus F. Soule"
"1899","Wyoming","0","1","1","0.25","5","17","-12","Justus F. Soule"
"1900","Wyoming","3","3","0","0.5","105","59","46","William McMurray"
"1901","Wyoming","1","0","0","1","38","0","38","William McMurray"
"1902","Wyoming","1","0","0","1","18","0","18","William McMurray"
"1903","Wyoming","3","2","0","0.6","32","63","-31","William McMurray"
"1904","Wyoming","4","1","1","0.75","97","35","62","William McMurray"
"1905","Wyoming","3","4","0","0.42857","63","162","-99","William McMurray"
"1906","Wyoming","1","1","0","0.5","12","35","-23","William McMurray"
"1907","Wyoming","2","1","0","0.66667","68","77","-9","Robert Ehlman"
"1908","Wyoming","1","2","0","0.33333","66","95","-29","Robert Ehlman"
"1909","Wyoming","3","5","0","0.375","93","170","-77","H.I. Dean"
"1910","Wyoming","4","4","0","0.5","107","74","33","H.I. Dean"
"1911","Wyoming","4","3","1","0.5625","139","53","86","H.I. Dean"
"1912","Wyoming","2","7","0","0.22222","64","291","-227","Leon C. Excelby"
"1913","Wyoming","0","5","0","0","0","183","-183","Ralph W. Thacker"
"1914","Wyoming","1","5","0","0.16667","31","158","-127","Ralph W. Thacker"
"1915","Wyoming","2","6","0","0.25","46","213","-167","John J. Corbett"
"1916","Wyoming","1","4","0","0.2","50","115","-65","John J. Corbett"
"1917","Wyoming","3","4","0","0.42857","24","140","-116","John J. Corbett"
"1919","Wyoming","3","5","0","0.375","68","115","-47","John J. Corbett"
"1920","Wyoming","4","5","1","0.45","58","106","-48","John J. Corbett"
"1921","Wyoming","1","4","2","0.28571","39","92","-53","John J. Corbett"
"1922","Wyoming","1","8","0","0.11111","13","256","-243","John J. Corbett"
"1923","Wyoming","0","8","0","0","16","265","-249","John J. Corbett"
"1924","Wyoming","2","6","0","0.25","59","140","-81","William H. ""Lone Star"" Dietz"
"1925","Wyoming","6","3","0","0.66667","147","83","64","William H. ""Lone Star"" Dietz"
"1926","Wyoming","2","4","2","0.375","152","91","61","William H. ""Lone Star"" Dietz"
"1927","Wyoming","4","5","0","0.44444","122","105","17","George W. McLaren"
"1928","Wyoming","2","7","0","0.22222","106","224","-118","George W. McLaren"
"1929","Wyoming","1","7","0","0.125","33","160","-127","George W. McLaren"
"1930","Wyoming","2","5","1","0.3125","86","161","-75","John R. Rhodes"
"1931","Wyoming","6","4","0","0.6","168","76","92","John R. Rhodes"
"1932","Wyoming","2","6","1","0.27778","53","137","-84","John R. Rhodes"
"1933","Wyoming","2","6","1","0.27778","54","114","-60","Willard A. ""Dutch"" Witte"
"1934","Wyoming","3","5","0","0.375","78","109","-31","Willard A. ""Dutch"" Witte"
"1935","Wyoming","4","4","0","0.5","76","59","17","Willard A. ""Dutch"" Witte"
"1936","Wyoming","2","5","1","0.3125","74","159","-85","Willard A. ""Dutch"" Witte"
"1937","Wyoming","3","5","0","0.375","86","92","-6","Willard A. ""Dutch"" Witte"
"1938","Wyoming","2","5","1","0.3125","66","147","-81","Willard A. ""Dutch"" Witte"
"1939","Wyoming","0","7","1","0.0625","47","241","-194","Joel Hunt"
"1940","Wyoming","1","7","1","0.16667","32","190","-158","Claire H. ""Okie"" Blanchard"
"1941","Wyoming","2","7","1","0.25","44","233","-189","Bernard F. ""Bunny"" Oakes"
"1942","Wyoming","3","5","0","0.375","106","115","-9","Bernard F. ""Bunny"" Oakes"
"1946","Wyoming","1","8","1","0.15","44","192","-148","Bernard F. ""Bunny"" Oakes"
"1947","Wyoming","4","5","0","0.44444","175","168","7","Bowden Wyatt"
"1948","Wyoming","4","5","0","0.44444","270","145","125","Bowden Wyatt"
"1949","Wyoming","9","1","0","0.9","381","65","316","Bowden Wyatt"
"1950","Wyoming","10","0","0","1","363","59","304","Bowden Wyatt"
"1951","Wyoming","7","2","1","0.75","220","82","138","Bowden Wyatt"
"1952","Wyoming","5","4","0","0.55556","114","102","12","Bowden Wyatt"
"1953","Wyoming","5","4","1","0.55","195","110","85","Phil Dickens"
"1954","Wyoming","6","4","0","0.6","215","171","44","Phil Dickens"
"1955","Wyoming","8","3","0","0.72727","225","137","88","Phil Dickens"
"1956","Wyoming","10","0","0","1","252","112","140","Phil Dickens"
"1957","Wyoming","4","3","3","0.55","139","135","4","Robert S. ""Bob"" Devaney"
"1958","Wyoming","8","3","0","0.72727","205","136","69","Robert S. ""Bob"" Devaney"
"1959","Wyoming","9","1","0","0.9","287","62","225","Robert S. ""Bob"" Devaney"
"1960","Wyoming","8","2","0","0.8","212","71","141","Robert S. ""Bob"" Devaney"
"1961","Wyoming","6","1","2","0.77778","171","74","97","Robert S. ""Bob"" Devaney"
"1962","Wyoming","5","5","0","0.5","165","143","22","Lloyd W. Eaton"
"1963","Wyoming","6","4","0","0.6","191","152","39","Lloyd W. Eaton"
"1964","Wyoming","6","2","2","0.7","181","117","64","Lloyd W. Eaton"
"1965","Wyoming","6","4","0","0.6","201","182","19","Lloyd W. Eaton"
"1966","Wyoming","10","1","0","0.90909","355","89","266","Lloyd W. Eaton"
"1967","Wyoming","10","1","0","0.90909","289","119","170","Lloyd W. Eaton"
"1968","Wyoming","7","3","0","0.7","242","118","124","Lloyd W. Eaton"
"1969","Wyoming","6","4","0","0.6","232","187","45","Lloyd W. Eaton"
"1970","Wyoming","1","9","0","0.1","110","314","-204","Lloyd W. Eaton"
"1971","Wyoming","5","6","0","0.45455","222","309","-87","Fritz Shurmur"
"1972","Wyoming","4","7","0","0.36364","223","309","-86","Fritz Shurmur"
"1973","Wyoming","4","7","0","0.36364","248","290","-42","Fritz Shurmur"
"1974","Wyoming","2","9","0","0.18182","150","283","-133","Fritz Shurmur"
"1975","Wyoming","2","9","0","0.18182","174","219","-45","Fred Akers"
"1976","Wyoming","8","4","0","0.66667","278","250","28","Fred Akers"
"1977","Wyoming","4","6","1","0.40909","166","273","-107","Bill Lewis"
"1978","Wyoming","5","7","0","0.41667","253","245","8","Bill Lewis"
"1979","Wyoming","4","8","0","0.33333","186","276","-90","Bill Lewis"
"1980","Wyoming","6","5","0","0.54545","316","243","73","Pat Dye"
"1981","Wyoming","8","3","0","0.72727","344","203","141","Al Kincaid"
"1982","Wyoming","5","7","0","0.41667","267","280","-13","Al Kincaid"
"1983","Wyoming","7","5","0","0.58333","341","327","14","Al Kincaid"
"1984","Wyoming","6","6","0","0.5","334","342","-8","Al Kincaid"
"1985","Wyoming","3","8","0","0.27273","210","371","-161","Al Kincaid"
"1986","Wyoming","6","6","0","0.5","299","272","27","Dennis Erickson"
"1987","Wyoming","10","3","0","0.76923","426","271","155","Paul Roach"
"1988","Wyoming","11","2","0","0.84615","511","280","231","Paul Roach"
"1989","Wyoming","5","6","0","0.45455","281","299","-18","Paul Roach"
"1990","Wyoming","9","4","0","0.69231","327","297","30","Paul Roach"
"1991","Wyoming","4","6","1","0.40909","305","357","-52","Joe Tiller"
"1992","Wyoming","5","7","0","0.41667","302","341","-39","Joe Tiller"
"1993","Wyoming","8","4","0","0.66667","357","329","28","Joe Tiller"
"1994","Wyoming","6","6","0","0.5","319","341","-22","Joe Tiller"
"1995","Wyoming","6","5","0","0.54545","322","264","58","Joe Tiller"
"1996","Wyoming","10","2","0","0.83333","464","284","180","Joe Tiller"
"1997","Wyoming","7","6","0","0.53846","322","227","95","Dana Dimel"
"1998","Wyoming","8","3","0","0.72727","222","215","7","Dana Dimel"
"1999","Wyoming","7","4","0","0.63636","302","270","32","Dana Dimel"
"2000","Wyoming","1","10","0","0.09091","170","393","-223","Vic Koenning"
"2001","Wyoming","2","9","0","0.18182","229","368","-139","Vic Koenning"
"2002","Wyoming","2","10","0","0.16667","288","432","-144","Vic Koenning"
"2003","Wyoming","4","8","0","0.33333","286","360","-74","Joe Glenn"
"2004","Wyoming","7","5","0","0.58333","318","297","21","Joe Glenn"
"2005","Wyoming","4","7","0","0.36364","271","297","-26","Joe Glenn"
"2006","Wyoming","6","6","0","0.5","258","264","-6","Joe Glenn"
"2007","Wyoming","5","7","0","0.41667","233","311","-78","Joe Glenn"
"2008","Wyoming","4","8","0","0.33333","152","333","-181","Joe Glenn"
"2009","Wyoming","7","6","0","0.53846","238","355","-117","Dave Christensen"
"2010","Wyoming","3","9","0","0.25","230","364","-134","Dave Christensen"
"2011","Wyoming","8","5","0","0.61538","339","361","-22","Dave Christensen"
"2012","Wyoming","4","7","0","0.36364","308","356","-48","Dave Christensen"
"2013","Wyoming","5","7","0","0.41667","375","440","-65","Dave Christensen"
"2012","Wyoming","0","1","0","0","14","45","-31","Pete Kaligis"
"2014","Wyoming","4","8","0","0.33333","253","394","-141","Craig Bohl"
"1911","Middle Tennessee St.","0","2","0","0","0","26","-26","L.E. ""Mutt"" Weber"
"1912","Middle Tennessee St.","1","0","0","1","29","7","22","L.E. ""Mutt"" Weber"
"1913","Middle Tennessee St.","5","1","1","0.78571","164","48","116","Alfred B. Miles"
"1914","Middle Tennessee St.","5","0","1","0.91667","132","13","119","Alfred B. Miles"
"1915","Middle Tennessee St.","2","3","1","0.41667","34","92","-58","Alfred B. Miles"
"1916","Middle Tennessee St.","5","2","0","0.71429","116","30","86","Alfred B. Miles"
"1919","Middle Tennessee St.","4","0","0","1","148","6","142","Alfred B. Miles"
"1920","Middle Tennessee St.","4","1","0","0.8","133","54","79","Alfred B. Miles"
"1921","Middle Tennessee St.","3","2","1","0.58333","36","74","-38","Alfred B. Miles"
"1922","Middle Tennessee St.","2","6","0","0.25","20","175","-155","Alfred B. Miles"
"1923","Middle Tennessee St.","4","1","0","0.8","121","39","82","Alfred B. Miles"
"1924","Middle Tennessee St.","1","7","0","0.125","26","160","-134","Guy Stephenson"
"1925","Middle Tennessee St.","3","4","2","0.44444","104","121","-17","Guy Stephenson"
"1926","Middle Tennessee St.","4","2","1","0.64286","102","124","-22","Frank Faulkinberry"
"1927","Middle Tennessee St.","6","2","0","0.75","197","54","143","Frank Faulkinberry"
"1928","Middle Tennessee St.","3","4","1","0.4375","85","84","1","Frank Faulkinberry"
"1929","Middle Tennessee St.","6","3","1","0.65","85","93","-8","Frank Faulkinberry"
"1930","Middle Tennessee St.","5","5","1","0.5","127","98","29","Frank Faulkinberry"
"1931","Middle Tennessee St.","6","4","0","0.6","163","64","99","Frank Faulkinberry"
"1932","Middle Tennessee St.","4","6","0","0.4","63","117","-54","Frank Faulkinberry"
"1933","Middle Tennessee St.","1","7","1","0.16667","44","194","-150","E.M. Waller"
"1934","Middle Tennessee St.","1","8","0","0.11111","32","99","-67","E.M. Waller"
"1917","Middle Tennessee St.","7","0","0","1","201","0","201","Johnny ""Red"" Floyd"
"1935","Middle Tennessee St.","8","0","0","1","128","25","103","Johnny ""Red"" Floyd"
"1936","Middle Tennessee St.","7","1","0","0.875","112","65","47","Johnny ""Red"" Floyd"
"1937","Middle Tennessee St.","6","1","1","0.8125","134","40","94","Johnny ""Red"" Floyd"
"1938","Middle Tennessee St.","2","6","0","0.25","65","115","-50","Johnny ""Red"" Floyd"
"1939","Middle Tennessee St.","1","6","1","0.1875","39","125","-86","Ernest Hayes Alley"
"1940","Middle Tennessee St.","4","4","0","0.5","107","71","36","E.W. Midgett"
"1941","Middle Tennessee St.","4","3","1","0.5625","120","87","33","E.W. Midgett"
"1942","Middle Tennessee St.","4","2","1","0.64286","106","77","29","E.W. Midgett"
"1946","Middle Tennessee St.","6","2","1","0.72222","149","75","74","E.W. Midgett"
"1947","Middle Tennessee St.","9","1","0","0.9","226","61","165","Charles M. Murphy"
"1948","Middle Tennessee St.","5","5","0","0.5","93","116","-23","Charles M. Murphy"
"1949","Middle Tennessee St.","8","0","1","0.94444","252","74","178","Charles M. Murphy"
"1950","Middle Tennessee St.","9","2","0","0.81818","303","139","164","Charles M. Murphy"
"1951","Middle Tennessee St.","7","2","2","0.72727","318","106","212","Charles M. Murphy"
"1952","Middle Tennessee St.","6","5","0","0.54545","214","194","20","Charles M. Murphy"
"1953","Middle Tennessee St.","7","4","0","0.63636","186","179","7","Charles M. Murphy"
"1954","Middle Tennessee St.","4","4","2","0.5","153","156","-3","Charles M. Murphy"
"1955","Middle Tennessee St.","7","2","1","0.75","187","205","-18","Charles M. Murphy"
"1956","Middle Tennessee St.","7","3","0","0.7","202","132","70","Charles M. Murphy"
"1957","Middle Tennessee St.","10","0","0","1","241","40","201","Charles M. Murphy"
"1958","Middle Tennessee St.","8","2","0","0.8","196","77","119","Charles M. Murphy"
"1959","Middle Tennessee St.","10","0","1","0.95455","324","93","231","Charles M. Murphy"
"1960","Middle Tennessee St.","5","5","0","0.5","115","126","-11","Charles M. Murphy"
"1961","Middle Tennessee St.","7","4","0","0.63636","201","128","73","Charles M. Murphy"
"1962","Middle Tennessee St.","6","4","0","0.6","161","104","57","Charles M. Murphy"
"1963","Middle Tennessee St.","8","2","0","0.8","213","106","107","Charles M. Murphy"
"1964","Middle Tennessee St.","8","2","1","0.77273","156","65","91","Charles M. Murphy"
"1965","Middle Tennessee St.","10","0","0","1","286","157","129","Charles M. Murphy"
"1966","Middle Tennessee St.","7","3","0","0.7","160","95","65","Charles M. Murphy"
"1967","Middle Tennessee St.","5","5","0","0.5","236","231","5","Charles M. Murphy"
"1968","Middle Tennessee St.","2","8","0","0.2","146","279","-133","Charles M. Murphy"
"1969","Middle Tennessee St.","1","9","0","0.1","134","216","-82","Donald E. ""Don"" Fuoss"
"1970","Middle Tennessee St.","6","3","1","0.65","167","105","62","Bill Peck"
"1971","Middle Tennessee St.","7","4","0","0.63636","196","178","18","Bill Peck"
"1972","Middle Tennessee St.","7","3","1","0.68182","216","172","44","Bill Peck"
"1973","Middle Tennessee St.","4","7","0","0.36364","148","264","-116","Bill Peck"
"1974","Middle Tennessee St.","3","8","0","0.27273","164","254","-90","Bill Peck"
"1975","Middle Tennessee St.","4","7","0","0.36364","189","254","-65","Ben Hurt"
"1976","Middle Tennessee St.","4","7","0","0.36364","205","281","-76","Ben Hurt"
"1977","Middle Tennessee St.","3","8","0","0.27273","125","283","-158","Ben Hurt"
"1978","Middle Tennessee St.","1","9","1","0.13636","95","340","-245","Ben Hurt"
"1979","Middle Tennessee St.","1","9","0","0.1","137","333","-196","James ""Boots"" Donnelly"
"1980","Middle Tennessee St.","2","8","0","0.2","85","224","-139","James ""Boots"" Donnelly"
"1981","Middle Tennessee St.","6","5","0","0.54545","158","173","-15","James ""Boots"" Donnelly"
"1982","Middle Tennessee St.","8","3","0","0.72727","231","110","121","James ""Boots"" Donnelly"
"1983","Middle Tennessee St.","8","2","0","0.8","296","111","185","James ""Boots"" Donnelly"
"1984","Middle Tennessee St.","11","3","0","0.78571","374","220","154","James ""Boots"" Donnelly"
"1985","Middle Tennessee St.","11","1","0","0.91667","388","173","215","James ""Boots"" Donnelly"
"1986","Middle Tennessee St.","6","5","0","0.54545","254","155","99","James ""Boots"" Donnelly"
"1987","Middle Tennessee St.","6","5","0","0.54545","248","160","88","James ""Boots"" Donnelly"
"1988","Middle Tennessee St.","7","4","0","0.63636","294","115","179","James ""Boots"" Donnelly"
"1989","Middle Tennessee St.","9","4","0","0.69231","318","225","93","James ""Boots"" Donnelly"
"1990","Middle Tennessee St.","11","2","0","0.84615","425","128","297","James ""Boots"" Donnelly"
"1991","Middle Tennessee St.","9","4","0","0.69231","345","193","152","James ""Boots"" Donnelly"
"1992","Middle Tennessee St.","10","3","0","0.76923","417","189","228","James ""Boots"" Donnelly"
"1993","Middle Tennessee St.","5","6","0","0.45455","354","235","119","James ""Boots"" Donnelly"
"1994","Middle Tennessee St.","8","3","1","0.70833","401","229","172","James ""Boots"" Donnelly"
"1995","Middle Tennessee St.","7","4","0","0.63636","303","201","102","James ""Boots"" Donnelly"
"1996","Middle Tennessee St.","6","5","0","0.54545","220","206","14","James ""Boots"" Donnelly"
"1997","Middle Tennessee St.","4","6","0","0.4","292","244","48","James ""Boots"" Donnelly"
"1998","Middle Tennessee St.","5","5","0","0.5","250","256","-6","James ""Boots"" Donnelly"
"1999","Middle Tennessee St.","3","8","0","0.27273","272","379","-107","Andy McCollum"
"2000","Middle Tennessee St.","6","5","0","0.54545","350","316","34","Andy McCollum"
"2001","Middle Tennessee St.","8","3","0","0.72727","408","286","122","Andy McCollum"
"2002","Middle Tennessee St.","4","8","0","0.33333","297","332","-35","Andy McCollum"
"2003","Middle Tennessee St.","4","8","0","0.33333","332","375","-43","Andy McCollum"
"2004","Middle Tennessee St.","5","6","0","0.45455","269","293","-24","Andy McCollum"
"2005","Middle Tennessee St.","4","7","0","0.36364","210","206","4","Andy McCollum"
"2006","Middle Tennessee St.","7","6","0","0.53846","296","302","-6","Rick Stockstill"
"2007","Middle Tennessee St.","5","7","0","0.41667","308","339","-31","Rick Stockstill"
"2008","Middle Tennessee St.","5","7","0","0.41667","274","299","-25","Rick Stockstill"
"2009","Middle Tennessee St.","10","3","0","0.76923","416","308","108","Rick Stockstill"
"2010","Middle Tennessee St.","6","7","0","0.46154","344","365","-21","Rick Stockstill"
"2011","Middle Tennessee St.","2","10","0","0.16667","267","441","-174","Rick Stockstill"
"2012","Middle Tennessee St.","8","4","0","0.66667","319","336","-17","Rick Stockstill"
"2013","Middle Tennessee St.","8","5","0","0.61538","377","341","36","Rick Stockstill"
"2014","Middle Tennessee St.","6","6","0","0.5","379","378","1","Rick Stockstill"
"1917","Toledo (OH)","0","3","0","0","0","262","-262","John Brandeberry"
"1918","Toledo (OH)","1","1","0","0.5","36","43","-7","James Baxter"
"1919","Toledo (OH)","2","4","0","0.33333","31","73","-42","Walt Hobt"
"1920","Toledo (OH)","0","3","0","0","7","67","-60","Walt Hobt"
"1921","Toledo (OH)","3","5","0","0.375","93","103","-10","Joseph Dwyer"
"1922","Toledo (OH)","2","2","3","0.5","17","19","-2","Joseph Dwyer"
"1923","Toledo (OH)","6","4","0","0.6","257","105","152","Joseph Dwyer"
"1924","Toledo (OH)","5","3","0","0.625","84","127","-43","Joseph Dwyer"
"1925","Toledo (OH)","1","8","0","0.11111","28","172","-144","Joseph Dwyer"
"1926","Toledo (OH)","3","5","0","0.375","81","154","-73","Boni Petcoff"
"1927","Toledo (OH)","5","2","0","0.71429","88","64","24","Boni Petcoff"
"1928","Toledo (OH)","1","6","0","0.14286","46","130","-84","Boni Petcoff"
"1929","Toledo (OH)","4","2","1","0.64286","68","70","-2","Boni Petcoff"
"1930","Toledo (OH)","2","5","1","0.3125","50","138","-88","Jim Nicholson"
"1932","Toledo (OH)","3","4","0","0.42857","42","40","2","Jim Nicholson"
"1933","Toledo (OH)","4","2","2","0.625","100","66","34","Jim Nicholson"
"1934","Toledo (OH)","5","3","0","0.625","123","55","68","Jim Nicholson"
"1935","Toledo (OH)","6","2","1","0.72222","185","32","153","Jim Nicholson"
"1936","Toledo (OH)","2","6","0","0.25","94","58","36","Clarence W. ""Doc"" Spears"
"1937","Toledo (OH)","6","3","0","0.66667","128","96","32","Clarence W. ""Doc"" Spears"
"1938","Toledo (OH)","6","3","1","0.65","156","83","73","Clarence W. ""Doc"" Spears"
"1939","Toledo (OH)","7","3","0","0.7","180","59","121","Clarence W. ""Doc"" Spears"
"1940","Toledo (OH)","6","3","0","0.66667","146","78","68","Clarence W. ""Doc"" Spears"
"1941","Toledo (OH)","7","4","0","0.63636","195","122","73","Clarence W. ""Doc"" Spears"
"1942","Toledo (OH)","4","4","1","0.5","91","114","-23","Clarence W. ""Doc"" Spears"
"1946","Toledo (OH)","6","2","2","0.7","200","132","68","Bill Orwig"
"1947","Toledo (OH)","9","2","0","0.81818","255","115","140","Bill Orwig"
"1948","Toledo (OH)","5","6","0","0.45455","206","225","-19","J. Neil ""Skip"" Stahley"
"1949","Toledo (OH)","6","4","0","0.6","318","210","108","J. Neil ""Skip"" Stahley"
"1950","Toledo (OH)","4","5","0","0.44444","200","234","-34","Robert Snyder"
"1951","Toledo (OH)","4","3","0","0.57143","203","127","76","Don Greenwood"
"1951","Toledo (OH)","2","1","0","0.66667","57","51","6","Clair Dunn"
"1952","Toledo (OH)","4","5","0","0.44444","132","151","-19","Clair Dunn"
"1953","Toledo (OH)","3","6","0","0.33333","113","305","-192","Clair Dunn"
"1954","Toledo (OH)","6","2","1","0.72222","205","113","92","Forrest W. England"
"1955","Toledo (OH)","3","5","1","0.38889","77","213","-136","Forrest W. England"
"1956","Toledo (OH)","1","7","1","0.16667","118","250","-132","Jack Morton"
"1957","Toledo (OH)","5","4","0","0.55556","136","147","-11","Harry Larche"
"1958","Toledo (OH)","4","5","0","0.44444","122","168","-46","Harry Larche"
"1959","Toledo (OH)","2","6","1","0.27778","123","200","-77","Harry Larche"
"1960","Toledo (OH)","2","7","0","0.22222","126","192","-66","Clive H. Rush"
"1961","Toledo (OH)","3","7","0","0.3","146","170","-24","Clive H. Rush"
"1962","Toledo (OH)","3","6","0","0.33333","133","176","-43","Clive H. Rush"
"1963","Toledo (OH)","2","7","0","0.22222","118","176","-58","Frank X. Lauterbur"
"1964","Toledo (OH)","2","8","0","0.2","127","218","-91","Frank X. Lauterbur"
"1965","Toledo (OH)","5","5","0","0.5","104","96","8","Frank X. Lauterbur"
"1966","Toledo (OH)","2","7","1","0.25","137","162","-25","Frank X. Lauterbur"
"1967","Toledo (OH)","9","1","0","0.9","266","83","183","Frank X. Lauterbur"
"1968","Toledo (OH)","5","4","1","0.55","230","156","74","Frank X. Lauterbur"
"1969","Toledo (OH)","11","0","0","1","385","160","225","Frank X. Lauterbur"
"1970","Toledo (OH)","12","0","0","1","384","88","296","Frank X. Lauterbur"
"1971","Toledo (OH)","12","0","0","1","383","96","287","John A. Murphy"
"1972","Toledo (OH)","6","5","0","0.54545","196","210","-14","John A. Murphy"
"1973","Toledo (OH)","3","8","0","0.27273","229","288","-59","John A. Murphy"
"1974","Toledo (OH)","6","5","0","0.54545","262","270","-8","John A. Murphy"
"1975","Toledo (OH)","5","6","0","0.45455","244","277","-33","John A. Murphy"
"1976","Toledo (OH)","3","8","0","0.27273","185","232","-47","John A. Murphy"
"1977","Toledo (OH)","2","9","0","0.18182","112","287","-175","Charles R. ""Chuck"" Stobart"
"1978","Toledo (OH)","2","9","0","0.18182","144","256","-112","Charles R. ""Chuck"" Stobart"
"1979","Toledo (OH)","8","2","1","0.77273","213","190","23","Charles R. ""Chuck"" Stobart"
"1980","Toledo (OH)","4","7","0","0.36364","187","190","-3","Charles R. ""Chuck"" Stobart"
"1981","Toledo (OH)","9","3","0","0.75","270","170","100","Charles R. ""Chuck"" Stobart"
"1982","Toledo (OH)","6","5","0","0.54545","184","162","22","Dan Simrell"
"1983","Toledo (OH)","9","2","0","0.81818","276","167","109","Dan Simrell"
"1984","Toledo (OH)","8","3","1","0.70833","187","164","23","Dan Simrell"
"1985","Toledo (OH)","4","7","0","0.36364","135","187","-52","Dan Simrell"
"1986","Toledo (OH)","7","4","0","0.63636","216","197","19","Dan Simrell"
"1987","Toledo (OH)","3","7","1","0.31818","165","245","-80","Dan Simrell"
"1988","Toledo (OH)","6","5","0","0.54545","244","221","23","Dan Simrell"
"1989","Toledo (OH)","6","5","0","0.54545","254","272","-18","Dan Simrell"
"1990","Toledo (OH)","9","2","0","0.81818","284","178","106","Nick L. Saban"
"1991","Toledo (OH)","5","5","1","0.5","187","209","-22","Gary Pinkel"
"1992","Toledo (OH)","8","3","0","0.72727","269","153","116","Gary Pinkel"
"1993","Toledo (OH)","4","7","0","0.36364","252","270","-18","Gary Pinkel"
"1994","Toledo (OH)","6","4","1","0.59091","352","324","28","Gary Pinkel"
"1995","Toledo (OH)","11","0","1","0.95833","411","264","147","Gary Pinkel"
"1996","Toledo (OH)","7","4","0","0.63636","210","259","-49","Gary Pinkel"
"1997","Toledo (OH)","9","3","0","0.75","356","268","88","Gary Pinkel"
"1998","Toledo (OH)","7","5","0","0.58333","229","216","13","Gary Pinkel"
"1999","Toledo (OH)","6","5","0","0.54545","293","229","64","Gary Pinkel"
"2000","Toledo (OH)","10","1","0","0.90909","400","125","275","Gary Pinkel"
"2001","Toledo (OH)","10","2","0","0.83333","407","297","110","Tom Amstutz"
"2002","Toledo (OH)","9","5","0","0.64286","495","378","117","Tom Amstutz"
"2003","Toledo (OH)","8","4","0","0.66667","389","285","104","Tom Amstutz"
"2004","Toledo (OH)","9","4","0","0.69231","432","404","28","Tom Amstutz"
"2005","Toledo (OH)","9","3","0","0.75","429","261","168","Tom Amstutz"
"2006","Toledo (OH)","5","7","0","0.41667","281","332","-51","Tom Amstutz"
"2007","Toledo (OH)","5","7","0","0.41667","395","470","-75","Tom Amstutz"
"2008","Toledo (OH)","3","9","0","0.25","269","377","-108","Tom Amstutz"
"2009","Toledo (OH)","5","7","0","0.41667","356","452","-96","Tim Beckman"
"2010","Toledo (OH)","8","5","0","0.61538","363","371","-8","Tim Beckman"
"2011","Toledo (OH)","8","4","0","0.66667","507","371","136","Tim Beckman"
"2011","Toledo (OH)","1","0","0","1","42","41","1","Matt Campbell"
"2012","Toledo (OH)","9","4","0","0.69231","410","369","41","Matt Campbell"
"2013","Toledo (OH)","7","5","0","0.58333","396","343","53","Matt Campbell"
"2014","Toledo (OH)","9","4","0","0.69231","476","396","80","Matt Campbell"
"1913","Western Kentucky","1","0","0","1","20","0","20","M.A. Leiper & Roy Manchester"
"1914","Western Kentucky","1","2","0","0.33333","24","81","-57","J.L. Arthur"
"1915","Western Kentucky","1","3","2","0.33333","20","111","-91","J.L. Arthur"
"1916","Western Kentucky","3","2","0","0.6","28","29","-1","J.L. Arthur"
"1920","Western Kentucky","0","1","0","0","0","13","-13","L.T. Smith"
"1921","Western Kentucky","2","4","1","0.35714","47","86","-39","L.T. Smith"
"1922","Western Kentucky","9","1","1","0.86364","291","38","253","E.A. Diddle"
"1923","Western Kentucky","5","4","0","0.55556","120","173","-53","E.A. Diddle"
"1924","Western Kentucky","4","5","0","0.44444","224","119","105","E.A. Diddle"
"1925","Western Kentucky","3","5","1","0.38889","52","91","-39","E.A. Diddle"
"1926","Western Kentucky","4","4","1","0.5","155","69","86","E.A. Diddle"
"1927","Western Kentucky","5","4","0","0.55556","140","94","46","E.A. Diddle"
"1928","Western Kentucky","8","1","0","0.88889","171","7","164","E.A. Diddle"
"1930","Western Kentucky","8","1","1","0.85","184","58","126","James Elam"
"1931","Western Kentucky","8","4","0","0.66667","172","126","46","James Elam"
"1932","Western Kentucky","7","1","0","0.875","220","40","180","Ernest R. ""Ernie"" Miller"
"1929","Western Kentucky","7","3","0","0.7","185","32","153","Carl ""Swede"" Anderson"
"1934","Western Kentucky","4","2","2","0.625","128","43","85","Carl ""Swede"" Anderson"
"1935","Western Kentucky","7","3","0","0.7","194","57","137","Carl ""Swede"" Anderson"
"1936","Western Kentucky","6","3","0","0.66667","123","55","68","Carl ""Swede"" Anderson"
"1937","Western Kentucky","7","1","1","0.83333","146","20","126","Carl ""Swede"" Anderson"
"1938","Western Kentucky","7","2","0","0.77778","217","46","171","William L. ""Gander"" Terry"
"1939","Western Kentucky","7","1","1","0.83333","132","52","80","William L. ""Gander"" Terry"
"1940","Western Kentucky","7","1","1","0.83333","115","20","95","William L. ""Gander"" Terry"
"1941","Western Kentucky","4","5","1","0.45","128","149","-21","William L. ""Gander"" Terry"
"1942","Western Kentucky","3","4","1","0.4375","70","167","-97","Arnold Winkenhofer"
"1933","Western Kentucky","6","2","0","0.75","181","39","142","Jesse Thomas (1)"
"1946","Western Kentucky","2","6","0","0.25","85","213","-128","Jesse Thomas (1)"
"1947","Western Kentucky","3","4","2","0.44444","82","145","-63","Jesse Thomas (1)"
"1948","Western Kentucky","5","4","0","0.55556","152","130","22","Jack Clayton"
"1949","Western Kentucky","5","4","0","0.55556","103","121","-18","Jack Clayton"
"1950","Western Kentucky","6","2","2","0.7","199","176","23","Jack Clayton"
"1951","Western Kentucky","4","5","0","0.44444","204","161","43","Jack Clayton"
"1952","Western Kentucky","9","1","0","0.9","336","119","217","Jack Clayton"
"1953","Western Kentucky","6","4","0","0.6","203","130","73","Jack Clayton"
"1954","Western Kentucky","7","3","0","0.7","171","125","46","Jack Clayton"
"1955","Western Kentucky","3","6","0","0.33333","119","140","-21","Jack Clayton"
"1956","Western Kentucky","5","4","0","0.55556","120","151","-31","Jack Clayton"
"1957","Western Kentucky","5","3","1","0.61111","123","139","-16","Nick Denes"
"1958","Western Kentucky","4","5","0","0.44444","104","87","17","Nick Denes"
"1959","Western Kentucky","5","4","0","0.55556","123","145","-22","Nick Denes"
"1960","Western Kentucky","2","6","1","0.27778","107","163","-56","Nick Denes"
"1961","Western Kentucky","6","3","0","0.66667","126","88","38","Nick Denes"
"1962","Western Kentucky","5","3","0","0.625","108","92","16","Nick Denes"
"1963","Western Kentucky","10","0","1","0.95455","309","79","230","Nick Denes"
"1964","Western Kentucky","6","3","1","0.65","169","79","90","Nick Denes"
"1965","Western Kentucky","2","6","2","0.3","119","236","-117","Nick Denes"
"1966","Western Kentucky","5","5","0","0.5","208","185","23","Nick Denes"
"1967","Western Kentucky","7","1","1","0.83333","276","98","178","Nick Denes"
"1968","Western Kentucky","7","2","1","0.75","281","70","211","Jimmy Feix"
"1969","Western Kentucky","6","3","1","0.65","253","140","113","Jimmy Feix"
"1970","Western Kentucky","8","1","1","0.85","244","76","168","Jimmy Feix"
"1971","Western Kentucky","8","2","0","0.8","262","100","162","Jimmy Feix"
"1972","Western Kentucky","7","3","0","0.7","194","97","97","Jimmy Feix"
"1973","Western Kentucky","12","1","0","0.92308","430","132","298","Jimmy Feix"
"1974","Western Kentucky","7","3","0","0.7","260","95","165","Jimmy Feix"
"1975","Western Kentucky","11","2","0","0.84615","245","112","133","Jimmy Feix"
"1976","Western Kentucky","4","5","1","0.45","130","153","-23","Jimmy Feix"
"1977","Western Kentucky","1","8","1","0.15","124","252","-128","Jimmy Feix"
"1978","Western Kentucky","8","2","0","0.8","254","157","97","Jimmy Feix"
"1979","Western Kentucky","5","5","0","0.5","223","217","6","Jimmy Feix"
"1980","Western Kentucky","9","1","0","0.9","228","157","71","Jimmy Feix"
"1981","Western Kentucky","6","5","0","0.54545","241","204","37","Jimmy Feix"
"1982","Western Kentucky","5","5","0","0.5","186","200","-14","Jimmy Feix"
"1983","Western Kentucky","2","8","1","0.22727","147","203","-56","Jimmy Feix"
"1984","Western Kentucky","2","9","0","0.18182","193","345","-152","Dave Roberts"
"1985","Western Kentucky","4","7","0","0.36364","232","313","-81","Dave Roberts"
"1986","Western Kentucky","4","6","1","0.40909","228","258","-30","Dave Roberts"
"1987","Western Kentucky","7","4","0","0.63636","263","217","46","Dave Roberts"
"1988","Western Kentucky","9","4","0","0.69231","311","220","91","Dave Roberts"
"1989","Western Kentucky","6","5","0","0.54545","279","238","41","Jack Harbaugh"
"1990","Western Kentucky","2","8","0","0.2","159","234","-75","Jack Harbaugh"
"1991","Western Kentucky","3","8","0","0.27273","235","301","-66","Jack Harbaugh"
"1992","Western Kentucky","4","6","0","0.4","243","258","-15","Jack Harbaugh"
"1993","Western Kentucky","8","3","0","0.72727","310","228","82","Jack Harbaugh"
"1994","Western Kentucky","5","6","0","0.45455","255","291","-36","Jack Harbaugh"
"1995","Western Kentucky","2","8","0","0.2","229","341","-112","Jack Harbaugh"
"1996","Western Kentucky","7","4","0","0.63636","304","251","53","Jack Harbaugh"
"1997","Western Kentucky","10","2","0","0.83333","429","243","186","Jack Harbaugh"
"1998","Western Kentucky","7","4","0","0.63636","396","310","86","Jack Harbaugh"
"1999","Western Kentucky","6","5","0","0.54545","270","245","25","Jack Harbaugh"
"2000","Western Kentucky","11","2","0","0.84615","404","145","259","Jack Harbaugh"
"2001","Western Kentucky","8","4","0","0.66667","318","146","172","Jack Harbaugh"
"2002","Western Kentucky","12","3","0","0.8","432","246","186","Jack Harbaugh"
"2003","Western Kentucky","9","4","0","0.69231","427","219","208","David Elson"
"2004","Western Kentucky","9","3","0","0.75","350","227","123","David Elson"
"2005","Western Kentucky","6","5","0","0.54545","339","292","47","David Elson"
"2006","Western Kentucky","6","5","0","0.54545","258","263","-5","David Elson"
"2007","Western Kentucky","7","5","0","0.58333","398","250","148","David Elson"
"2008","Western Kentucky","2","10","0","0.16667","210","326","-116","David Elson"
"2009","Western Kentucky","0","12","0","0","245","475","-230","David Elson"
"2010","Western Kentucky","2","10","0","0.16667","274","398","-124","Willie Taggart"
"2011","Western Kentucky","7","5","0","0.58333","275","298","-23","Willie Taggart"
"2012","Western Kentucky","7","5","0","0.58333","345","307","38","Willie Taggart"
"2012","Western Kentucky","0","1","0","0","21","24","-3","Lance Guidry"
"2013","Western Kentucky","8","4","0","0.66667","370","295","75","Bobby ""Bob"" Petrino"
"2014","Western Kentucky","8","5","0","0.61538","577","519","58","Jeff Brohm"
"1892","Alabama","2","2","0","0.5","96","37","59","Eugene Beauharnais Beaumont"
"1893","Alabama","0","4","0","0","24","74","-50","Eli Abbott"
"1894","Alabama","3","1","0","0.75","60","16","44","Eli Abbott"
"1895","Alabama","0","4","0","0","12","112","-100","Eli Abbott"
"1902","Alabama","4","4","0","0.5","191","49","142","Eli Abbott"
"1896","Alabama","2","1","0","0.66667","56","10","46","Otto Wagonhurst"
"1897","Alabama","1","0","0","1","6","0","6","Allen McCants"
"1899","Alabama","3","1","0","0.75","34","31","3","W.A. Martin"
"1900","Alabama","2","3","0","0.4","52","99","-47","M. Griffin"
"1901","Alabama","2","1","2","0.6","92","23","69","Michael Smith ""Mike"" Harvey"
"1903","Alabama","3","4","0","0.42857","60","114","-54","Winton B. Blount"
"1904","Alabama","7","3","0","0.7","104","67","37","Winton B. Blount"
"1905","Alabama","6","4","0","0.6","178","113","65","Jack Leavenworth"
"1906","Alabama","5","1","0","0.83333","97","82","15","J.W.H. Pollard"
"1907","Alabama","5","1","2","0.75","70","64","6","J.W.H. Pollard"
"1908","Alabama","6","1","1","0.8125","108","31","77","J.W.H. Pollard"
"1909","Alabama","5","1","2","0.75","68","17","51","J.W.H. Pollard"
"1910","Alabama","4","4","0","0.5","65","107","-42","Guy Summer Lowman"
"1911","Alabama","5","2","2","0.66667","153","31","122","D.V. Graves"
"1912","Alabama","5","3","1","0.61111","156","55","101","D.V. Graves"
"1913","Alabama","6","3","0","0.66667","188","40","148","D.V. Graves"
"1914","Alabama","5","4","0","0.55556","211","64","147","D.V. Graves"
"1915","Alabama","6","2","0","0.75","250","51","199","Thomas ""Tom"" Kelley"
"1916","Alabama","6","3","0","0.66667","156","62","94","Thomas ""Tom"" Kelley"
"1917","Alabama","5","2","1","0.6875","168","29","139","Thomas ""Tom"" Kelley"
"1919","Alabama","8","1","0","0.88889","280","22","258","Xenophon ""Xen"" Cole Scott"
"1920","Alabama","10","1","0","0.90909","377","35","342","Xenophon ""Xen"" Cole Scott"
"1921","Alabama","5","4","2","0.54545","241","104","137","Xenophon ""Xen"" Cole Scott"
"1922","Alabama","6","3","1","0.65","300","81","219","Xenophon ""Xen"" Cole Scott"
"1923","Alabama","7","2","1","0.75","222","50","172","Wallace W. Wade"
"1924","Alabama","8","1","0","0.88889","290","24","266","Wallace W. Wade"
"1925","Alabama","10","0","0","1","297","26","271","Wallace W. Wade"
"1926","Alabama","9","0","1","0.95","249","27","222","Wallace W. Wade"
"1927","Alabama","5","4","1","0.55","154","73","81","Wallace W. Wade"
"1928","Alabama","6","3","0","0.66667","187","75","112","Wallace W. Wade"
"1929","Alabama","6","3","0","0.66667","196","58","138","Wallace W. Wade"
"1930","Alabama","10","0","0","1","271","13","258","Wallace W. Wade"
"1931","Alabama","9","1","0","0.9","360","57","303","Frank W. Thomas"
"1932","Alabama","8","2","0","0.8","200","51","149","Frank W. Thomas"
"1933","Alabama","7","1","1","0.83333","130","17","113","Frank W. Thomas"
"1934","Alabama","10","0","0","1","316","45","271","Frank W. Thomas"
"1935","Alabama","6","2","1","0.72222","185","55","130","Frank W. Thomas"
"1936","Alabama","8","0","1","0.94444","168","35","133","Frank W. Thomas"
"1937","Alabama","9","1","0","0.9","225","33","192","Frank W. Thomas"
"1938","Alabama","7","1","1","0.83333","149","40","109","Frank W. Thomas"
"1939","Alabama","5","3","1","0.61111","101","53","48","Frank W. Thomas"
"1940","Alabama","7","2","0","0.77778","166","80","86","Frank W. Thomas"
"1941","Alabama","9","2","0","0.81818","263","85","178","Frank W. Thomas"
"1942","Alabama","8","3","0","0.72727","246","97","149","Frank W. Thomas"
"1944","Alabama","5","2","2","0.66667","272","83","189","Frank W. Thomas"
"1945","Alabama","10","0","0","1","430","80","350","Frank W. Thomas"
"1946","Alabama","7","4","0","0.63636","186","110","76","Frank W. Thomas"
"1947","Alabama","8","3","0","0.72727","210","101","109","Harold D. ""Red"" Drew"
"1948","Alabama","6","4","1","0.59091","228","170","58","Harold D. ""Red"" Drew"
"1949","Alabama","6","3","1","0.65","227","130","97","Harold D. ""Red"" Drew"
"1950","Alabama","9","2","0","0.81818","328","107","221","Harold D. ""Red"" Drew"
"1951","Alabama","5","6","0","0.45455","263","188","75","Harold D. ""Red"" Drew"
"1952","Alabama","10","2","0","0.83333","325","139","186","Harold D. ""Red"" Drew"
"1953","Alabama","6","3","3","0.625","178","152","26","Harold D. ""Red"" Drew"
"1954","Alabama","4","5","2","0.45455","123","104","19","Harold D. ""Red"" Drew"
"1955","Alabama","0","10","0","0","48","256","-208","Jennings B. ""Ears"" Whitworth"
"1956","Alabama","2","7","1","0.25","85","208","-123","Jennings B. ""Ears"" Whitworth"
"1957","Alabama","2","7","1","0.25","69","173","-104","Jennings B. ""Ears"" Whitworth"
"1958","Alabama","5","4","1","0.55","106","75","31","Paul W. ""Bear"" Bryant"
"1959","Alabama","7","2","2","0.72727","95","59","36","Paul W. ""Bear"" Bryant"
"1960","Alabama","8","1","2","0.81818","183","56","127","Paul W. ""Bear"" Bryant"
"1961","Alabama","11","0","0","1","297","25","272","Paul W. ""Bear"" Bryant"
"1962","Alabama","10","1","0","0.90909","289","39","250","Paul W. ""Bear"" Bryant"
"1963","Alabama","9","2","0","0.81818","227","95","132","Paul W. ""Bear"" Bryant"
"1964","Alabama","10","1","0","0.90909","250","88","162","Paul W. ""Bear"" Bryant"
"1965","Alabama","9","1","1","0.86364","256","107","149","Paul W. ""Bear"" Bryant"
"1966","Alabama","11","0","0","1","301","44","257","Paul W. ""Bear"" Bryant"
"1967","Alabama","8","2","1","0.77273","204","131","73","Paul W. ""Bear"" Bryant"
"1968","Alabama","8","3","0","0.72727","184","139","45","Paul W. ""Bear"" Bryant"
"1969","Alabama","6","5","0","0.54545","314","268","46","Paul W. ""Bear"" Bryant"
"1970","Alabama","6","5","1","0.54167","334","264","70","Paul W. ""Bear"" Bryant"
"1971","Alabama","11","1","0","0.91667","368","122","246","Paul W. ""Bear"" Bryant"
"1972","Alabama","10","2","0","0.83333","406","150","256","Paul W. ""Bear"" Bryant"
"1973","Alabama","11","1","0","0.91667","477","113","364","Paul W. ""Bear"" Bryant"
"1974","Alabama","11","1","0","0.91667","329","96","233","Paul W. ""Bear"" Bryant"
"1975","Alabama","11","1","0","0.91667","374","72","302","Paul W. ""Bear"" Bryant"
"1976","Alabama","9","3","0","0.75","327","140","187","Paul W. ""Bear"" Bryant"
"1977","Alabama","11","1","0","0.91667","380","139","241","Paul W. ""Bear"" Bryant"
"1978","Alabama","11","1","0","0.91667","345","168","177","Paul W. ""Bear"" Bryant"
"1979","Alabama","12","0","0","1","383","67","316","Paul W. ""Bear"" Bryant"
"1980","Alabama","10","2","0","0.83333","352","98","254","Paul W. ""Bear"" Bryant"
"1981","Alabama","9","2","1","0.79167","296","151","145","Paul W. ""Bear"" Bryant"
"1982","Alabama","8","4","0","0.66667","338","216","122","Paul W. ""Bear"" Bryant"
"1983","Alabama","8","4","0","0.66667","366","229","137","Ray Perkins"
"1984","Alabama","5","6","0","0.45455","226","208","18","Ray Perkins"
"1985","Alabama","9","2","1","0.79167","318","181","137","Ray Perkins"
"1986","Alabama","10","3","0","0.76923","351","163","188","Ray Perkins"
"1987","Alabama","7","5","0","0.58333","268","213","55","Bill Curry"
"1988","Alabama","9","3","0","0.75","317","188","129","Bill Curry"
"1989","Alabama","10","2","0","0.83333","357","217","140","Bill Curry"
"1990","Alabama","7","5","0","0.58333","260","161","99","Gene Stallings"
"1991","Alabama","11","1","0","0.91667","324","143","181","Gene Stallings"
"1992","Alabama","13","0","0","1","366","122","244","Gene Stallings"
"1993","Alabama","1","12","0","0.07692","340","168","172","Gene Stallings"
"1994","Alabama","12","1","0","0.92308","305","190","115","Gene Stallings"
"1995","Alabama","8","3","0","0.72727","260","188","72","Gene Stallings"
"1996","Alabama","10","3","0","0.76923","316","195","121","Gene Stallings"
"1997","Alabama","4","7","0","0.36364","246","248","-2","Mike DuBose"
"1998","Alabama","7","5","0","0.58333","251","287","-36","Mike DuBose"
"1999","Alabama","10","3","0","0.76923","378","265","113","Mike DuBose"
"2000","Alabama","3","8","0","0.27273","228","246","-18","Mike DuBose"
"2001","Alabama","7","5","0","0.58333","318","232","86","Dennis Franchione"
"2002","Alabama","10","3","0","0.76923","367","200","167","Dennis Franchione"
"2003","Alabama","4","9","0","0.30769","331","333","-2","Mike Shula"
"2004","Alabama","6","6","0","0.5","295","189","106","Mike Shula"
"2005","Alabama","0","2","0","0","263","128","135","Mike Shula"
"2006","Alabama","0","6","0","0","267","216","51","Mike Shula"
"2006","Alabama","0","1","0","0","31","34","-3","Joe Kines"
"2007","Alabama","2","6","0","0.25","352","286","66","Nick L. Saban"
"2008","Alabama","12","2","0","0.85714","422","200","222","Nick L. Saban"
"2009","Alabama","14","0","0","1","449","164","285","Nick L. Saban"
"2010","Alabama","10","3","0","0.76923","464","176","288","Nick L. Saban"
"2011","Alabama","12","1","0","0.92308","453","106","347","Nick L. Saban"
"2012","Alabama","13","1","0","0.92857","542","153","389","Nick L. Saban"
"2013","Alabama","11","2","0","0.84615","496","181","315","Nick L. Saban"
"2014","Alabama","12","2","0","0.85714","517","258","259","Nick L. Saban"
"1892","Auburn (AL)","1","0","0","1","32","22","10","D.M. Balliet"
"1891","Auburn (AL)","1","0","0","1","10","0","10","George Petrie"
"1892","Auburn (AL)","1","2","0","0.33333","32","98","-66","George Petrie"
"1893","Auburn (AL)","2","0","2","0.75","84","40","44","G.H. Harvey"
"1894","Auburn (AL)","1","3","0","0.25","106","48","58","F.M. Hall"
"1895","Auburn (AL)","2","1","0","0.66667","70","15","55","John W. Heisman"
"1896","Auburn (AL)","3","1","0","0.75","135","18","117","John W. Heisman"
"1897","Auburn (AL)","2","0","1","0.83333","40","4","36","John W. Heisman"
"1898","Auburn (AL)","2","1","0","0.66667","47","47","0","John W. Heisman"
"1899","Auburn (AL)","3","1","1","0.7","148","11","137","John W. Heisman"
"1900","Auburn (AL)","4","0","0","1","148","5","143","Walter Hudson ""Billy"" Watkins"
"1902","Auburn (AL)","2","2","1","0.5","41","17","24","Robert S. Kent"
"1902","Auburn (AL)","0","2","0","0","5","28","-23","Michael Smith ""Mike"" Harvey"
"1903","Auburn (AL)","4","3","0","0.57143","125","92","33","William Penn ""Billy"" Bates"
"1907","Auburn (AL)","6","2","1","0.72222","185","30","155","William S. ""Willis"" Keinholz"
"1904","Auburn (AL)","7","0","0","1","170","11","159","Mike Donahue"
"1905","Auburn (AL)","4","4","0","0.5","148","96","52","Mike Donahue"
"1906","Auburn (AL)","1","5","1","0.21429","24","41","-17","Mike Donahue"
"1908","Auburn (AL)","6","1","0","0.85714","158","10","148","Mike Donahue"
"1909","Auburn (AL)","6","2","0","0.75","140","39","101","Mike Donahue"
"1910","Auburn (AL)","6","1","0","0.85714","176","9","167","Mike Donahue"
"1911","Auburn (AL)","5","2","1","0.6875","103","45","58","Mike Donahue"
"1912","Auburn (AL)","7","1","1","0.83333","194","45","149","Mike Donahue"
"1913","Auburn (AL)","8","0","0","1","224","13","211","Mike Donahue"
"1914","Auburn (AL)","8","0","1","0.94444","193","0","193","Mike Donahue"
"1915","Auburn (AL)","6","2","0","0.75","182","24","158","Mike Donahue"
"1916","Auburn (AL)","6","2","0","0.75","191","56","135","Mike Donahue"
"1917","Auburn (AL)","6","2","1","0.72222","199","102","97","Mike Donahue"
"1918","Auburn (AL)","2","5","0","0.28571","84","116","-32","Mike Donahue"
"1919","Auburn (AL)","8","1","0","0.88889","132","33","99","Mike Donahue"
"1920","Auburn (AL)","7","2","0","0.77778","332","49","283","Mike Donahue"
"1921","Auburn (AL)","6","3","0","0.66667","211","55","156","Mike Donahue"
"1922","Auburn (AL)","8","2","0","0.8","276","48","228","Mike Donahue"
"1923","Auburn (AL)","3","3","3","0.5","96","58","38","Boozer Pitts"
"1924","Auburn (AL)","4","4","1","0.5","46","40","6","Boozer Pitts"
"1927","Auburn (AL)","0","4","2","0.16667","24","82","-58","Boozer Pitts"
"1925","Auburn (AL)","5","3","1","0.61111","81","114","-33","David B. Morey"
"1926","Auburn (AL)","5","4","0","0.55556","122","85","37","David B. Morey"
"1927","Auburn (AL)","0","3","0","0","6","42","-36","David B. Morey"
"1928","Auburn (AL)","1","8","0","0.11111","37","154","-117","George M. Bohler"
"1929","Auburn (AL)","2","3","0","0.4","22","86","-64","George M. Bohler"
"1929","Auburn (AL)","0","4","0","0","6","122","-116","Johnny ""Red"" Floyd"
"1930","Auburn (AL)","3","7","0","0.3","101","135","-34","Chet A. Wynne"
"1931","Auburn (AL)","5","3","1","0.61111","114","78","36","Chet A. Wynne"
"1932","Auburn (AL)","9","0","1","0.95","275","54","221","Chet A. Wynne"
"1933","Auburn (AL)","5","5","0","0.5","133","104","29","Chet A. Wynne"
"1934","Auburn (AL)","2","8","0","0.2","58","107","-49","John F. ""Jack"" Meagher"
"1935","Auburn (AL)","8","2","0","0.8","201","46","155","John F. ""Jack"" Meagher"
"1936","Auburn (AL)","7","2","2","0.72727","160","63","97","John F. ""Jack"" Meagher"
"1937","Auburn (AL)","6","2","3","0.68182","127","36","91","John F. ""Jack"" Meagher"
"1938","Auburn (AL)","4","5","1","0.45","110","88","22","John F. ""Jack"" Meagher"
"1939","Auburn (AL)","5","5","1","0.5","71","69","2","John F. ""Jack"" Meagher"
"1940","Auburn (AL)","6","4","1","0.59091","170","153","17","John F. ""Jack"" Meagher"
"1941","Auburn (AL)","4","5","1","0.45","123","115","8","John F. ""Jack"" Meagher"
"1942","Auburn (AL)","6","4","1","0.59091","174","133","41","John F. ""Jack"" Meagher"
"1944","Auburn (AL)","4","4","0","0.5","181","137","44","Carl M. Voyles"
"1945","Auburn (AL)","5","5","0","0.5","172","129","43","Carl M. Voyles"
"1946","Auburn (AL)","4","6","0","0.4","132","210","-78","Carl M. Voyles"
"1947","Auburn (AL)","2","7","0","0.22222","78","204","-126","Carl M. Voyles"
"1948","Auburn (AL)","1","8","1","0.15","68","262","-194","Earl M. Brown"
"1949","Auburn (AL)","2","4","3","0.38889","134","188","-54","Earl M. Brown"
"1950","Auburn (AL)","0","10","0","0","31","255","-224","Earl M. Brown"
"1951","Auburn (AL)","5","5","0","0.5","180","212","-32","Ralph ""Shug"" Jordan"
"1952","Auburn (AL)","2","8","0","0.2","139","208","-69","Ralph ""Shug"" Jordan"
"1953","Auburn (AL)","7","3","1","0.68182","270","173","97","Ralph ""Shug"" Jordan"
"1954","Auburn (AL)","8","3","0","0.72727","276","86","190","Ralph ""Shug"" Jordan"
"1955","Auburn (AL)","8","2","1","0.77273","224","123","101","Ralph ""Shug"" Jordan"
"1956","Auburn (AL)","7","3","0","0.7","174","117","57","Ralph ""Shug"" Jordan"
"1957","Auburn (AL)","10","0","0","1","207","28","179","Ralph ""Shug"" Jordan"
"1958","Auburn (AL)","9","0","1","0.95","173","62","111","Ralph ""Shug"" Jordan"
"1959","Auburn (AL)","7","3","0","0.7","174","58","116","Ralph ""Shug"" Jordan"
"1960","Auburn (AL)","8","2","0","0.8","155","80","75","Ralph ""Shug"" Jordan"
"1961","Auburn (AL)","6","4","0","0.6","174","137","37","Ralph ""Shug"" Jordan"
"1962","Auburn (AL)","6","3","1","0.65","173","168","5","Ralph ""Shug"" Jordan"
"1963","Auburn (AL)","9","2","0","0.81818","196","116","80","Ralph ""Shug"" Jordan"
"1964","Auburn (AL)","6","4","0","0.6","123","91","32","Ralph ""Shug"" Jordan"
"1965","Auburn (AL)","5","5","1","0.5","172","175","-3","Ralph ""Shug"" Jordan"
"1966","Auburn (AL)","4","6","0","0.4","104","162","-58","Ralph ""Shug"" Jordan"
"1967","Auburn (AL)","6","4","0","0.6","237","123","114","Ralph ""Shug"" Jordan"
"1968","Auburn (AL)","7","4","0","0.63636","257","159","98","Ralph ""Shug"" Jordan"
"1969","Auburn (AL)","8","3","0","0.72727","370","173","197","Ralph ""Shug"" Jordan"
"1970","Auburn (AL)","9","2","0","0.81818","390","177","213","Ralph ""Shug"" Jordan"
"1971","Auburn (AL)","9","2","0","0.81818","335","182","153","Ralph ""Shug"" Jordan"
"1972","Auburn (AL)","10","1","0","0.90909","209","141","68","Ralph ""Shug"" Jordan"
"1973","Auburn (AL)","6","6","0","0.5","170","193","-23","Ralph ""Shug"" Jordan"
"1974","Auburn (AL)","10","2","0","0.83333","287","122","165","Ralph ""Shug"" Jordan"
"1975","Auburn (AL)","4","6","1","0.40909","174","243","-69","Ralph ""Shug"" Jordan"
"1976","Auburn (AL)","4","7","0","0.36364","194","267","-73","Doug Barfield"
"1977","Auburn (AL)","6","5","0","0.54545","204","243","-39","Doug Barfield"
"1978","Auburn (AL)","6","4","1","0.59091","238","191","47","Doug Barfield"
"1979","Auburn (AL)","8","3","0","0.72727","330","238","92","Doug Barfield"
"1980","Auburn (AL)","5","6","0","0.45455","235","238","-3","Doug Barfield"
"1981","Auburn (AL)","5","6","0","0.45455","186","166","20","Pat Dye"
"1982","Auburn (AL)","9","3","0","0.75","274","197","77","Pat Dye"
"1983","Auburn (AL)","11","1","0","0.91667","311","186","125","Pat Dye"
"1984","Auburn (AL)","9","4","0","0.69231","360","254","106","Pat Dye"
"1985","Auburn (AL)","8","4","0","0.66667","344","208","136","Pat Dye"
"1986","Auburn (AL)","10","2","0","0.83333","395","122","273","Pat Dye"
"1987","Auburn (AL)","9","1","2","0.83333","314","132","182","Pat Dye"
"1988","Auburn (AL)","10","2","0","0.83333","338","92","246","Pat Dye"
"1989","Auburn (AL)","10","2","0","0.83333","284","131","153","Pat Dye"
"1990","Auburn (AL)","8","3","1","0.70833","283","216","67","Pat Dye"
"1991","Auburn (AL)","5","6","0","0.45455","233","214","19","Pat Dye"
"1992","Auburn (AL)","5","5","1","0.5","228","205","23","Pat Dye"
"1993","Auburn (AL)","11","0","0","1","353","192","161","Terry Bowden"
"1994","Auburn (AL)","9","1","1","0.86364","359","199","160","Terry Bowden"
"1995","Auburn (AL)","8","4","0","0.66667","438","283","155","Terry Bowden"
"1996","Auburn (AL)","8","4","0","0.66667","398","277","121","Terry Bowden"
"1997","Auburn (AL)","10","3","0","0.76923","340","250","90","Terry Bowden"
"1998","Auburn (AL)","1","5","0","0.16667","69","129","-60","Terry Bowden"
"1998","Auburn (AL)","2","3","0","0.4","97","106","-9","Bill ""Brother"" Oliver"
"1999","Auburn (AL)","5","6","0","0.45455","233","236","-3","Tommy Tuberville"
"2000","Auburn (AL)","9","4","0","0.69231","316","266","50","Tommy Tuberville"
"2001","Auburn (AL)","7","5","0","0.58333","254","281","-27","Tommy Tuberville"
"2002","Auburn (AL)","9","4","0","0.69231","388","231","157","Tommy Tuberville"
"2003","Auburn (AL)","8","5","0","0.61538","342","212","130","Tommy Tuberville"
"2004","Auburn (AL)","13","0","0","1","417","147","270","Tommy Tuberville"
"2005","Auburn (AL)","9","3","0","0.75","386","186","200","Tommy Tuberville"
"2006","Auburn (AL)","11","2","0","0.84615","322","181","141","Tommy Tuberville"
"2007","Auburn (AL)","9","4","0","0.69231","315","220","95","Tommy Tuberville"
"2008","Auburn (AL)","5","7","0","0.41667","208","216","-8","Tommy Tuberville"
"2009","Auburn (AL)","8","5","0","0.61538","433","358","75","Gene Chizik"
"2010","Auburn (AL)","14","0","0","1","577","337","240","Gene Chizik"
"2011","Auburn (AL)","8","5","0","0.61538","334","376","-42","Gene Chizik"
"2012","Auburn (AL)","3","9","0","0.25","224","340","-116","Gene Chizik"
"2013","Auburn (AL)","12","2","0","0.85714","553","346","207","Gus Malzahn"
"2014","Auburn (AL)","8","5","0","0.61538","461","347","114","Gus Malzahn"
"1896","Central Michigan","3","1","0","0.75","62","22","40","Pete McCormick"
"1897","Central Michigan","2","1","0","0.66667","16","18","-2","Carl Pray"
"1898","Central Michigan","1","2","0","0.33333","37","32","5","Carl Pray"
"1899","Central Michigan","3","2","0","0.6","35","22","13","Carl Pray"
"1902","Central Michigan","4","0","0","1","82","0","82","Charles Tambling"
"1903","Central Michigan","6","0","0","1","69","11","58","Charles Tambling"
"1904","Central Michigan","0","2","0","0","6","66","-60","Charles Tambling"
"1905","Central Michigan","6","1","0","0.85714","126","14","112","Charles Tambling"
"1918","Central Michigan","1","0","0","1","41","6","35","Charles Tambling"
"1907","Central Michigan","2","4","0","0.33333","18","164","-146","Ralph W. Thacker"
"1908","Central Michigan","4","2","0","0.66667","38","16","22","Hugh Sutherland"
"1909","Central Michigan","4","3","0","0.57143","63","58","5","Harry W. Helmer"
"1910","Central Michigan","6","1","1","0.8125","112","33","79","Harry W. Helmer"
"1911","Central Michigan","3","3","0","0.5","26","29","-3","Harry W. Helmer"
"1912","Central Michigan","1","2","2","0.4","6","112","-106","Harry W. Helmer"
"1916","Central Michigan","1","5","0","0.16667","39","139","-100","Blake Miller"
"1917","Central Michigan","1","2","0","0.33333","7","70","-63","Frederick ""Fred"" Johnson"
"1919","Central Michigan","2","2","3","0.5","88","89","-1","Garland Nevitt"
"1920","Central Michigan","4","3","1","0.5625","166","41","125","Joe Simmons"
"1921","Central Michigan","6","1","1","0.8125","161","7","154","Wallace Parker"
"1922","Central Michigan","6","0","2","0.875","179","11","168","Wallace Parker"
"1923","Central Michigan","5","1","2","0.75","160","24","136","Wallace Parker"
"1926","Central Michigan","3","4","1","0.4375","66","90","-24","Wallace Parker"
"1927","Central Michigan","7","1","0","0.875","124","37","87","Wallace Parker"
"1928","Central Michigan","6","3","0","0.66667","126","63","63","Wallace Parker"
"1924","Central Michigan","7","1","0","0.875","158","19","139","Lester Barnard"
"1925","Central Michigan","4","1","3","0.6875","93","20","73","Lester Barnard"
"1929","Central Michigan","2","3","2","0.42857","71","80","-9","A.J. Nowak"
"1930","Central Michigan","6","2","0","0.75","108","81","27","A.J. Nowak"
"1931","Central Michigan","4","3","0","0.57143","95","58","37","George Van Bibber"
"1932","Central Michigan","3","4","1","0.4375","95","66","29","George Van Bibber"
"1933","Central Michigan","5","2","1","0.6875","164","58","106","George Van Bibber"
"1934","Central Michigan","5","3","0","0.625","81","82","-1","Alex Yunevich"
"1935","Central Michigan","1","6","0","0.14286","32","101","-69","Alex Yunevich"
"1936","Central Michigan","3","4","1","0.4375","89","129","-40","Alex Yunevich"
"1937","Central Michigan","6","2","0","0.75","202","41","161","Ron Finch"
"1938","Central Michigan","7","1","0","0.875","270","44","226","Ron Finch"
"1939","Central Michigan","8","1","0","0.88889","167","40","127","Ron Finch"
"1940","Central Michigan","4","3","1","0.5625","88","60","28","Ron Finch"
"1941","Central Michigan","4","3","0","0.57143","44","76","-32","Ron Finch"
"1942","Central Michigan","6","0","0","1","93","21","72","Ron Finch"
"1943","Central Michigan","2","3","0","0.4","20","69","-49","Ron Finch"
"1944","Central Michigan","5","2","0","0.71429","150","106","44","Ron Finch"
"1945","Central Michigan","6","1","0","0.85714","98","26","72","Ron Finch"
"1946","Central Michigan","6","2","0","0.75","240","67","173","Ron Finch"
"1947","Central Michigan","2","5","1","0.3125","136","105","31","Lyle Bennett"
"1948","Central Michigan","3","6","0","0.33333","127","139","-12","Lyle Bennett"
"1949","Central Michigan","3","4","0","0.42857","106","109","-3","Lyle Bennett"
"1950","Central Michigan","6","4","0","0.6","209","125","84","Warren Schmakel"
"1951","Central Michigan","5","3","0","0.625","231","158","73","Kenneth A. ""Bill"" Kelly"
"1952","Central Michigan","7","2","0","0.77778","285","85","200","Kenneth A. ""Bill"" Kelly"
"1953","Central Michigan","7","1","1","0.83333","244","129","115","Kenneth A. ""Bill"" Kelly"
"1954","Central Michigan","8","2","0","0.8","321","107","214","Kenneth A. ""Bill"" Kelly"
"1955","Central Michigan","8","1","0","0.88889","327","79","248","Kenneth A. ""Bill"" Kelly"
"1956","Central Michigan","9","0","0","1","313","92","221","Kenneth A. ""Bill"" Kelly"
"1957","Central Michigan","4","6","0","0.4","220","222","-2","Kenneth A. ""Bill"" Kelly"
"1958","Central Michigan","7","3","0","0.7","216","204","12","Kenneth A. ""Bill"" Kelly"
"1959","Central Michigan","7","3","0","0.7","233","155","78","Kenneth A. ""Bill"" Kelly"
"1960","Central Michigan","3","5","0","0.375","161","165","-4","Kenneth A. ""Bill"" Kelly"
"1961","Central Michigan","2","8","0","0.2","95","214","-119","Kenneth A. ""Bill"" Kelly"
"1962","Central Michigan","6","4","0","0.6","191","171","20","Kenneth A. ""Bill"" Kelly"
"1963","Central Michigan","4","5","1","0.45","209","195","14","Kenneth A. ""Bill"" Kelly"
"1964","Central Michigan","4","5","0","0.44444","117","148","-31","Kenneth A. ""Bill"" Kelly"
"1965","Central Michigan","5","5","0","0.5","193","144","49","Kenneth A. ""Bill"" Kelly"
"1966","Central Michigan","5","5","0","0.5","213","159","54","Kenneth A. ""Bill"" Kelly"
"1967","Central Michigan","8","2","0","0.8","207","84","123","Roy Kramer"
"1968","Central Michigan","7","2","0","0.77778","256","132","124","Roy Kramer"
"1969","Central Michigan","7","3","0","0.7","254","147","107","Roy Kramer"
"1970","Central Michigan","7","3","0","0.7","263","190","73","Roy Kramer"
"1971","Central Michigan","5","5","0","0.5","183","181","2","Roy Kramer"
"1972","Central Michigan","5","5","1","0.5","265","190","75","Roy Kramer"
"1973","Central Michigan","7","4","0","0.63636","197","151","46","Roy Kramer"
"1974","Central Michigan","12","1","0","0.92308","450","127","323","Roy Kramer"
"1975","Central Michigan","8","2","1","0.77273","309","102","207","Roy Kramer"
"1976","Central Michigan","7","4","0","0.63636","223","219","4","Roy Kramer"
"1977","Central Michigan","10","1","0","0.90909","317","155","162","Roy Kramer"
"1978","Central Michigan","9","2","0","0.81818","331","119","212","Herb Deromedi"
"1979","Central Michigan","10","0","1","0.95455","291","133","158","Herb Deromedi"
"1980","Central Michigan","9","2","0","0.81818","218","127","91","Herb Deromedi"
"1981","Central Michigan","7","4","0","0.63636","223","131","92","Herb Deromedi"
"1982","Central Michigan","6","4","1","0.59091","228","199","29","Herb Deromedi"
"1983","Central Michigan","8","3","0","0.72727","257","136","121","Herb Deromedi"
"1984","Central Michigan","8","2","1","0.77273","282","141","141","Herb Deromedi"
"1985","Central Michigan","7","3","0","0.7","194","143","51","Herb Deromedi"
"1986","Central Michigan","5","5","0","0.5","258","284","-26","Herb Deromedi"
"1987","Central Michigan","5","5","1","0.5","222","203","19","Herb Deromedi"
"1988","Central Michigan","7","4","0","0.63636","287","176","111","Herb Deromedi"
"1989","Central Michigan","5","5","1","0.5","228","182","46","Herb Deromedi"
"1990","Central Michigan","8","3","1","0.70833","283","146","137","Herb Deromedi"
"1991","Central Michigan","6","1","4","0.72727","205","157","48","Herb Deromedi"
"1992","Central Michigan","5","6","0","0.45455","247","170","77","Herb Deromedi"
"1993","Central Michigan","5","6","0","0.45455","275","244","31","Herb Deromedi"
"1994","Central Michigan","9","3","0","0.75","400","315","85","Dick Flynn"
"1995","Central Michigan","4","7","0","0.36364","255","276","-21","Dick Flynn"
"1996","Central Michigan","5","6","0","0.45455","351","353","-2","Dick Flynn"
"1997","Central Michigan","2","9","0","0.18182","282","479","-197","Dick Flynn"
"1998","Central Michigan","6","5","0","0.54545","229","253","-24","Dick Flynn"
"1999","Central Michigan","4","7","0","0.36364","229","344","-115","Dick Flynn"
"2000","Central Michigan","2","9","0","0.18182","137","376","-239","Mike DeBord"
"2001","Central Michigan","3","8","0","0.27273","251","346","-95","Mike DeBord"
"2002","Central Michigan","4","8","0","0.33333","267","384","-117","Mike DeBord"
"2003","Central Michigan","3","9","0","0.25","277","428","-151","Mike DeBord"
"2006","Central Michigan","1","0","0","1","31","14","17","Jeff Quinn"
"2004","Central Michigan","4","7","0","0.36364","260","378","-118","Brian Kelly"
"2005","Central Michigan","6","5","0","0.54545","260","260","0","Brian Kelly"
"2006","Central Michigan","10","4","0","0.71429","412","322","90","Brian Kelly"
"2007","Central Michigan","8","6","0","0.57143","487","517","-30","Butch Jones"
"2008","Central Michigan","8","5","0","0.61538","384","393","-9","Butch Jones"
"2009","Central Michigan","11","2","0","0.84615","431","224","207","Butch Jones"
"2009","Central Michigan","1","0","0","1","44","41","3","Steve Stripling"
"2010","Central Michigan","3","9","0","0.25","293","312","-19","Dan Enos"
"2011","Central Michigan","3","9","0","0.25","271","400","-129","Dan Enos"
"2012","Central Michigan","7","6","0","0.53846","375","421","-46","Dan Enos"
"2013","Central Michigan","6","6","0","0.5","279","343","-64","Dan Enos"
"2014","Central Michigan","7","6","0","0.53846","350","327","23","Dan Enos"
"1932","East Carolina (NC)","0","5","0","0","0","187","-187","Kenneth Beatty"
"1933","East Carolina (NC)","1","5","0","0.16667","6","99","-93","Kenneth Beatty"
"1934","East Carolina (NC)","1","4","1","0.25","18","87","-69","G.L. ""Doc"" Mathis"
"1935","East Carolina (NC)","3","3","0","0.5","78","32","46","G.L. ""Doc"" Mathis"
"1936","East Carolina (NC)","3","2","0","0.6","64","19","45","Bo Farley"
"1937","East Carolina (NC)","2","5","0","0.28571","65","78","-13","J.D. ""Swede"" Alexander"
"1938","East Carolina (NC)","1","6","1","0.1875","40","127","-87","J.D. ""Swede"" Alexander"
"1939","East Carolina (NC)","0","8","0","0","18","168","-150","O.A. Hankner"
"1940","East Carolina (NC)","5","3","0","0.625","143","70","73","John B. Christenbury"
"1941","East Carolina (NC)","7","0","0","1","159","20","139","John B. Christenbury"
"1946","East Carolina (NC)","5","3","1","0.61111","158","58","100","Jim Johnson (1)"
"1947","East Carolina (NC)","3","6","0","0.33333","66","141","-75","Jim Johnson (1)"
"1948","East Carolina (NC)","0","9","0","0","38","206","-168","Jim Johnson (1)"
"1949","East Carolina (NC)","4","5","1","0.45","207","177","30","William ""Bill"" Dole"
"1950","East Carolina (NC)","7","3","0","0.7","252","137","115","William ""Bill"" Dole"
"1951","East Carolina (NC)","4","6","0","0.4","184","220","-36","William ""Bill"" Dole"
"1952","East Carolina (NC)","6","3","2","0.63636","225","132","93","Jack Boone"
"1953","East Carolina (NC)","8","2","0","0.8","292","81","211","Jack Boone"
"1954","East Carolina (NC)","5","4","1","0.55","144","105","39","Jack Boone"
"1955","East Carolina (NC)","4","5","0","0.44444","93","103","-10","Jack Boone"
"1956","East Carolina (NC)","2","6","1","0.27778","99","245","-146","Jack Boone"
"1957","East Carolina (NC)","1","8","0","0.11111","73","218","-145","Jack Boone"
"1958","East Carolina (NC)","6","4","0","0.6","142","144","-2","Jack Boone"
"1959","East Carolina (NC)","5","6","0","0.45455","279","171","108","Jack Boone"
"1960","East Carolina (NC)","7","3","0","0.7","144","92","52","Jack Boone"
"1961","East Carolina (NC)","5","4","1","0.55","154","144","10","Jack Boone"
"1962","East Carolina (NC)","5","4","0","0.55556","217","136","81","Clarence Stasavich"
"1963","East Carolina (NC)","9","1","0","0.9","230","54","176","Clarence Stasavich"
"1964","East Carolina (NC)","9","1","0","0.9","279","108","171","Clarence Stasavich"
"1965","East Carolina (NC)","9","1","0","0.9","299","83","216","Clarence Stasavich"
"1966","East Carolina (NC)","4","5","1","0.45","144","175","-31","Clarence Stasavich"
"1967","East Carolina (NC)","8","2","0","0.8","253","178","75","Clarence Stasavich"
"1968","East Carolina (NC)","4","6","0","0.4","175","244","-69","Clarence Stasavich"
"1969","East Carolina (NC)","2","7","0","0.22222","108","204","-96","Clarence Stasavich"
"1970","East Carolina (NC)","3","8","0","0.27273","136","253","-117","Mike McGee"
"1971","East Carolina (NC)","4","6","0","0.4","181","300","-119","Sonny Randle"
"1972","East Carolina (NC)","9","2","0","0.81818","269","176","93","Sonny Randle"
"1973","East Carolina (NC)","9","2","0","0.81818","352","151","201","Sonny Randle"
"1974","East Carolina (NC)","7","4","0","0.63636","250","167","83","Pat Dye"
"1975","East Carolina (NC)","8","3","0","0.72727","296","154","142","Pat Dye"
"1976","East Carolina (NC)","9","2","0","0.81818","278","116","162","Pat Dye"
"1977","East Carolina (NC)","8","3","0","0.72727","268","154","114","Pat Dye"
"1978","East Carolina (NC)","9","3","0","0.75","287","136","151","Pat Dye"
"1979","East Carolina (NC)","7","3","1","0.68182","380","193","187","Pat Dye"
"1980","East Carolina (NC)","4","7","0","0.36364","192","312","-120","Ed Emory"
"1981","East Carolina (NC)","5","6","0","0.45455","242","290","-48","Ed Emory"
"1982","East Carolina (NC)","7","4","0","0.63636","259","228","31","Ed Emory"
"1983","East Carolina (NC)","8","3","0","0.72727","271","179","92","Ed Emory"
"1984","East Carolina (NC)","2","9","0","0.18182","210","309","-99","Ed Emory"
"1985","East Carolina (NC)","2","9","0","0.18182","161","281","-120","Art Baker"
"1986","East Carolina (NC)","3","8","0","0.27273","187","364","-177","Art Baker"
"1987","East Carolina (NC)","5","6","0","0.45455","229","330","-101","Art Baker"
"1988","East Carolina (NC)","3","8","0","0.27273","281","325","-44","Art Baker"
"1989","East Carolina (NC)","6","5","0","0.54545","301","286","15","Bill Lewis"
"1990","East Carolina (NC)","5","6","0","0.45455","254","267","-13","Bill Lewis"
"1991","East Carolina (NC)","11","1","0","0.91667","409","277","132","Bill Lewis"
"1992","East Carolina (NC)","5","6","0","0.45455","289","367","-78","Steve Logan"
"1993","East Carolina (NC)","2","9","0","0.18182","175","329","-154","Steve Logan"
"1994","East Carolina (NC)","7","5","0","0.58333","303","263","40","Steve Logan"
"1995","East Carolina (NC)","9","3","0","0.75","274","226","48","Steve Logan"
"1996","East Carolina (NC)","8","3","0","0.72727","316","214","102","Steve Logan"
"1997","East Carolina (NC)","5","6","0","0.45455","214","298","-84","Steve Logan"
"1998","East Carolina (NC)","6","5","0","0.54545","274","297","-23","Steve Logan"
"1999","East Carolina (NC)","9","3","0","0.75","333","225","108","Steve Logan"
"2000","East Carolina (NC)","8","4","0","0.66667","370","256","114","Steve Logan"
"2001","East Carolina (NC)","6","6","0","0.5","421","360","61","Steve Logan"
"2002","East Carolina (NC)","4","8","0","0.33333","335","399","-64","Steve Logan"
"2003","East Carolina (NC)","1","11","0","0.08333","217","428","-211","John Thompson"
"2004","East Carolina (NC)","2","9","0","0.18182","231","439","-208","John Thompson"
"2005","East Carolina (NC)","5","6","0","0.45455","267","317","-50","Skip Holtz"
"2006","East Carolina (NC)","7","6","0","0.53846","280","270","10","Skip Holtz"
"2007","East Carolina (NC)","8","5","0","0.61538","403","395","8","Skip Holtz"
"2008","East Carolina (NC)","9","5","0","0.64286","328","295","33","Skip Holtz"
"2009","East Carolina (NC)","9","5","0","0.64286","378","307","71","Skip Holtz"
"2010","East Carolina (NC)","6","7","0","0.46154","478","572","-94","Ruffin McNeill"
"2011","East Carolina (NC)","5","7","0","0.41667","315","387","-72","Ruffin McNeill"
"2012","East Carolina (NC)","8","5","0","0.61538","409","411","-2","Ruffin McNeill"
"2013","East Carolina (NC)","10","3","0","0.76923","522","322","200","Ruffin McNeill"
"2014","East Carolina (NC)","8","5","0","0.61538","466","336","130","Ruffin McNeill"
"1946","Houston (TX)","4","6","0","0.4","140","136","4","Jewell Wallace"
"1947","Houston (TX)","3","8","0","0.27273","95","214","-119","Jewell Wallace"
"1948","Houston (TX)","5","6","0","0.45455","149","182","-33","Clyde Lee"
"1949","Houston (TX)","5","4","1","0.55","229","169","60","Clyde Lee"
"1950","Houston (TX)","4","6","0","0.4","233","190","43","Clyde Lee"
"1951","Houston (TX)","6","5","0","0.54545","247","228","19","Clyde Lee"
"1952","Houston (TX)","8","2","0","0.8","180","80","100","Clyde Lee"
"1953","Houston (TX)","4","4","1","0.5","189","185","4","Clyde Lee"
"1954","Houston (TX)","5","5","0","0.5","125","203","-78","Clyde Lee"
"1955","Houston (TX)","6","4","0","0.6","176","139","37","William M. ""Bill"" Meek"
"1956","Houston (TX)","7","2","1","0.75","185","90","95","William M. ""Bill"" Meek"
"1957","Houston (TX)","5","4","1","0.55","113","141","-28","Harold W. Lahar"
"1958","Houston (TX)","5","4","0","0.55556","209","161","48","Harold W. Lahar"
"1959","Houston (TX)","3","7","0","0.3","105","170","-65","Harold W. Lahar"
"1960","Houston (TX)","6","4","0","0.6","141","150","-9","Harold W. Lahar"
"1961","Houston (TX)","5","4","1","0.55","144","138","6","Harold W. Lahar"
"1962","Houston (TX)","7","4","0","0.63636","198","171","27","Bill Yeoman"
"1963","Houston (TX)","2","8","0","0.2","149","208","-59","Bill Yeoman"
"1964","Houston (TX)","2","6","1","0.27778","115","174","-59","Bill Yeoman"
"1965","Houston (TX)","4","5","1","0.45","159","174","-15","Bill Yeoman"
"1966","Houston (TX)","8","2","0","0.8","335","125","210","Bill Yeoman"
"1967","Houston (TX)","7","3","0","0.7","322","122","200","Bill Yeoman"
"1968","Houston (TX)","6","2","2","0.7","425","154","271","Bill Yeoman"
"1969","Houston (TX)","9","2","0","0.81818","422","208","214","Bill Yeoman"
"1970","Houston (TX)","8","3","0","0.72727","307","160","147","Bill Yeoman"
"1971","Houston (TX)","9","3","0","0.75","339","199","140","Bill Yeoman"
"1972","Houston (TX)","6","4","1","0.59091","325","202","123","Bill Yeoman"
"1973","Houston (TX)","11","1","0","0.91667","363","142","221","Bill Yeoman"
"1974","Houston (TX)","8","3","1","0.70833","280","185","95","Bill Yeoman"
"1975","Houston (TX)","2","8","0","0.2","185","245","-60","Bill Yeoman"
"1976","Houston (TX)","10","2","0","0.83333","343","188","155","Bill Yeoman"
"1977","Houston (TX)","6","5","0","0.54545","282","259","23","Bill Yeoman"
"1978","Houston (TX)","9","3","0","0.75","364","213","151","Bill Yeoman"
"1979","Houston (TX)","11","1","0","0.91667","295","135","160","Bill Yeoman"
"1980","Houston (TX)","7","5","0","0.58333","236","190","46","Bill Yeoman"
"1981","Houston (TX)","7","4","1","0.625","238","174","64","Bill Yeoman"
"1982","Houston (TX)","5","5","1","0.5","215","262","-47","Bill Yeoman"
"1983","Houston (TX)","4","7","0","0.36364","225","294","-69","Bill Yeoman"
"1984","Houston (TX)","7","5","0","0.58333","266","267","-1","Bill Yeoman"
"1985","Houston (TX)","4","7","0","0.36364","253","339","-86","Bill Yeoman"
"1986","Houston (TX)","1","10","0","0.09091","125","267","-142","Bill Yeoman"
"1987","Houston (TX)","4","6","1","0.40909","284","292","-8","Jack Pardee"
"1988","Houston (TX)","9","3","0","0.75","474","219","255","Jack Pardee"
"1989","Houston (TX)","9","2","0","0.81818","589","150","439","Jack Pardee"
"1990","Houston (TX)","10","1","0","0.90909","511","303","208","John Jenkins"
"1991","Houston (TX)","4","7","0","0.36364","353","344","9","John Jenkins"
"1992","Houston (TX)","4","7","0","0.36364","378","386","-8","John Jenkins"
"1993","Houston (TX)","1","9","1","0.13636","171","392","-221","Kim Helton"
"1994","Houston (TX)","1","10","0","0.09091","115","402","-287","Kim Helton"
"1995","Houston (TX)","2","9","0","0.18182","188","360","-172","Kim Helton"
"1996","Houston (TX)","7","5","0","0.58333","361","341","20","Kim Helton"
"1997","Houston (TX)","3","8","0","0.27273","216","410","-194","Kim Helton"
"1998","Houston (TX)","3","8","0","0.27273","254","317","-63","Kim Helton"
"1999","Houston (TX)","7","4","0","0.63636","254","211","43","Kim Helton"
"2000","Houston (TX)","3","8","0","0.27273","211","370","-159","Dana Dimel"
"2001","Houston (TX)","0","11","0","0","190","432","-242","Dana Dimel"
"2002","Houston (TX)","5","7","0","0.41667","320","393","-73","Dana Dimel"
"2003","Houston (TX)","7","6","0","0.53846","448","468","-20","Art Briles"
"2004","Houston (TX)","3","8","0","0.27273","230","354","-124","Art Briles"
"2005","Houston (TX)","6","6","0","0.5","337","324","13","Art Briles"
"2006","Houston (TX)","10","4","0","0.71429","462","329","133","Art Briles"
"2007","Houston (TX)","8","4","0","0.66667","436","359","77","Art Briles"
"2007","Houston (TX)","0","1","0","0","13","20","-7","Chris Thurmond"
"2008","Houston (TX)","8","5","0","0.61538","528","402","126","Kevin Sumlin"
"2009","Houston (TX)","10","4","0","0.71429","591","421","170","Kevin Sumlin"
"2010","Houston (TX)","5","7","0","0.41667","452","386","66","Kevin Sumlin"
"2011","Houston (TX)","12","1","0","0.92308","660","300","360","Kevin Sumlin"
"2011","Houston (TX)","1","0","0","1","30","14","16","Tony Levine"
"2012","Houston (TX)","5","7","0","0.41667","389","432","-43","Tony Levine"
"2013","Houston (TX)","8","5","0","0.61538","431","283","148","Tony Levine"
"2014","Houston (TX)","8","5","0","0.61538","387","268","119","Tony Levine"
"1896","Kansas St.","0","1","1","0.25","6","20","-14","Ira Pratt"
"1897","Kansas St.","1","2","1","0.375","4","40","-36","A.W. ""Jub"" Ehrsam"
"1898","Kansas St.","1","1","2","0.5","32","16","16","W.P. Williamson"
"1899","Kansas St.","2","3","0","0.4","23","72","-49","Albert Hanson"
"1900","Kansas St.","2","4","0","0.33333","47","100","-53","F.G. Moulton"
"1901","Kansas St.","3","4","1","0.4375","65","87","-22","Wade Moore"
"1902","Kansas St.","2","6","0","0.25","46","121","-75","C.E. Dietz"
"1903","Kansas St.","3","4","1","0.4375","56","103","-47","G.O. Dietz"
"1904","Kansas St.","1","6","0","0.14286","48","186","-138","A.A. Booth"
"1905","Kansas St.","6","2","0","0.75","140","51","89","Mike F. Ahearn"
"1906","Kansas St.","5","2","0","0.71429","103","37","66","Mike F. Ahearn"
"1907","Kansas St.","5","3","0","0.625","135","56","79","Mike F. Ahearn"
"1908","Kansas St.","6","2","0","0.75","182","74","108","Mike F. Ahearn"
"1909","Kansas St.","7","2","0","0.77778","320","11","309","Mike F. Ahearn"
"1910","Kansas St.","10","1","0","0.90909","336","28","308","Mike F. Ahearn"
"1911","Kansas St.","5","4","1","0.55","47","87","-40","Guy Summer Lowman"
"1912","Kansas St.","8","2","0","0.8","204","103","101","Guy Summer Lowman"
"1913","Kansas St.","3","4","1","0.4375","97","122","-25","Guy Summer Lowman"
"1914","Kansas St.","1","5","1","0.21429","44","150","-106","Guy Summer Lowman"
"1915","Kansas St.","3","4","1","0.4375","43","84","-41","John R. ""Chief"" Bender"
"1916","Kansas St.","6","1","1","0.8125","154","36","118","Zora G. Clevenger"
"1917","Kansas St.","6","2","0","0.75","215","25","190","Zora G. Clevenger"
"1918","Kansas St.","4","1","0","0.8","95","29","66","Zora G. Clevenger"
"1919","Kansas St.","3","5","1","0.38889","72","109","-37","Zora G. Clevenger"
"1920","Kansas St.","3","3","3","0.5","93","55","38","Charles W. Bachman"
"1921","Kansas St.","5","3","0","0.625","84","64","20","Charles W. Bachman"
"1922","Kansas St.","5","1","2","0.75","154","61","93","Charles W. Bachman"
"1923","Kansas St.","4","2","2","0.625","107","72","35","Charles W. Bachman"
"1924","Kansas St.","3","4","1","0.4375","68","79","-11","Charles W. Bachman"
"1925","Kansas St.","5","2","1","0.6875","70","43","27","Charles W. Bachman"
"1926","Kansas St.","5","3","0","0.625","85","42","43","Charles W. Bachman"
"1927","Kansas St.","3","5","0","0.375","101","146","-45","Charles W. Bachman"
"1928","Kansas St.","3","5","0","0.375","94","94","0","Alvin N. ""Bo"" McMillin"
"1929","Kansas St.","3","5","0","0.375","55","102","-47","Alvin N. ""Bo"" McMillin"
"1930","Kansas St.","5","3","0","0.625","91","66","25","Alvin N. ""Bo"" McMillin"
"1931","Kansas St.","8","2","0","0.8","162","39","123","Alvin N. ""Bo"" McMillin"
"1932","Kansas St.","4","4","0","0.5","160","80","80","Alvin N. ""Bo"" McMillin"
"1933","Kansas St.","6","2","1","0.72222","105","29","76","Alvin N. ""Bo"" McMillin"
"1934","Kansas St.","7","2","1","0.75","149","81","68","Lynn O. ""Pappy"" Waldorf"
"1935","Kansas St.","2","4","3","0.38889","40","49","-9","Wesley L. Fry"
"1936","Kansas St.","4","3","2","0.55556","137","89","48","Wesley L. Fry"
"1937","Kansas St.","4","5","0","0.44444","76","84","-8","Wesley L. Fry"
"1938","Kansas St.","4","4","1","0.5","108","134","-26","Wesley L. Fry"
"1939","Kansas St.","4","5","0","0.44444","117","108","9","Wesley L. Fry"
"1940","Kansas St.","2","7","0","0.22222","73","145","-72","Hobbs Adams"
"1941","Kansas St.","2","5","2","0.33333","67","168","-101","Hobbs Adams"
"1946","Kansas St.","0","9","0","0","41","233","-192","Hobbs Adams"
"1942","Kansas St.","3","8","0","0.27273","79","334","-255","Ward H. Haylett"
"1943","Kansas St.","1","7","0","0.125","48","209","-161","Ward H. Haylett"
"1944","Kansas St.","2","5","2","0.33333","45","215","-170","Ward H. Haylett"
"1945","Kansas St.","1","7","0","0.125","71","268","-197","Lud Fiser"
"1947","Kansas St.","0","10","0","0","71","283","-212","Sam Francis"
"1948","Kansas St.","1","9","0","0.1","78","323","-245","Ralph M. Graham"
"1949","Kansas St.","2","8","0","0.2","191","257","-66","Ralph M. Graham"
"1950","Kansas St.","1","9","1","0.13636","122","355","-233","Ralph M. Graham"
"1951","Kansas St.","0","9","0","0","73","228","-155","William M. ""Bill"" Meek"
"1952","Kansas St.","1","9","0","0.1","81","255","-174","William M. ""Bill"" Meek"
"1953","Kansas St.","6","3","1","0.65","198","116","82","William M. ""Bill"" Meek"
"1954","Kansas St.","7","3","0","0.7","191","154","37","William M. ""Bill"" Meek"
"1955","Kansas St.","4","6","0","0.4","165","191","-26","Bernard ""Bus"" Mertes"
"1956","Kansas St.","3","7","0","0.3","143","259","-116","Bernard ""Bus"" Mertes"
"1957","Kansas St.","3","6","1","0.35","124","166","-42","Bernard ""Bus"" Mertes"
"1958","Kansas St.","3","7","0","0.3","110","192","-82","Bernard ""Bus"" Mertes"
"1959","Kansas St.","2","8","0","0.2","109","266","-157","Bernard ""Bus"" Mertes"
"1960","Kansas St.","1","9","0","0.1","78","316","-238","Doug Weaver"
"1961","Kansas St.","2","8","0","0.2","58","232","-174","Doug Weaver"
"1962","Kansas St.","0","10","0","0","39","283","-244","Doug Weaver"
"1963","Kansas St.","2","7","0","0.22222","91","222","-131","Doug Weaver"
"1964","Kansas St.","3","7","0","0.3","64","186","-122","Doug Weaver"
"1965","Kansas St.","0","10","0","0","43","296","-253","Doug Weaver"
"1966","Kansas St.","0","9","1","0.05","66","226","-160","Doug Weaver"
"1967","Kansas St.","1","9","0","0.1","90","263","-173","Vince Gibson"
"1968","Kansas St.","4","6","0","0.4","194","247","-53","Vince Gibson"
"1969","Kansas St.","5","5","0","0.5","316","233","83","Vince Gibson"
"1970","Kansas St.","6","5","0","0.54545","190","218","-28","Vince Gibson"
"1971","Kansas St.","5","6","0","0.45455","219","296","-77","Vince Gibson"
"1972","Kansas St.","3","8","0","0.27273","169","407","-238","Vince Gibson"
"1973","Kansas St.","5","6","0","0.45455","176","260","-84","Vince Gibson"
"1974","Kansas St.","4","7","0","0.36364","193","283","-90","Vince Gibson"
"1975","Kansas St.","3","8","0","0.27273","89","248","-159","Ellis Rainsberger"
"1976","Kansas St.","1","10","0","0.09091","155","347","-192","Ellis Rainsberger"
"1977","Kansas St.","2","9","0","0.18182","131","286","-155","Ellis Rainsberger"
"1978","Kansas St.","4","7","0","0.36364","201","342","-141","Jim Dickey"
"1979","Kansas St.","3","8","0","0.27273","154","225","-71","Jim Dickey"
"1980","Kansas St.","3","8","0","0.27273","129","212","-83","Jim Dickey"
"1981","Kansas St.","2","9","0","0.18182","164","297","-133","Jim Dickey"
"1982","Kansas St.","6","5","1","0.54167","230","180","50","Jim Dickey"
"1983","Kansas St.","3","8","0","0.27273","186","343","-157","Jim Dickey"
"1984","Kansas St.","3","7","1","0.31818","185","330","-145","Jim Dickey"
"1985","Kansas St.","1","10","0","0.09091","101","295","-194","Jim Dickey"
"1986","Kansas St.","2","9","0","0.18182","134","343","-209","Stan Parrish"
"1987","Kansas St.","0","10","1","0.04545","135","421","-286","Stan Parrish"
"1988","Kansas St.","0","11","0","0","171","448","-277","Stan Parrish"
"1989","Kansas St.","1","10","0","0.09091","134","349","-215","Bill Snyder"
"1990","Kansas St.","5","6","0","0.45455","255","293","-38","Bill Snyder"
"1991","Kansas St.","7","4","0","0.63636","263","226","37","Bill Snyder"
"1992","Kansas St.","5","6","0","0.45455","195","233","-38","Bill Snyder"
"1993","Kansas St.","9","2","1","0.79167","340","227","113","Bill Snyder"
"1994","Kansas St.","9","3","0","0.75","312","168","144","Bill Snyder"
"1995","Kansas St.","10","2","0","0.83333","456","166","290","Bill Snyder"
"1996","Kansas St.","9","3","0","0.75","340","191","149","Bill Snyder"
"1997","Kansas St.","11","1","0","0.91667","418","177","241","Bill Snyder"
"1998","Kansas St.","11","2","0","0.84615","610","197","413","Bill Snyder"
"1999","Kansas St.","11","1","0","0.91667","457","164","293","Bill Snyder"
"2000","Kansas St.","11","3","0","0.78571","549","261","288","Bill Snyder"
"2001","Kansas St.","6","6","0","0.5","330","205","125","Bill Snyder"
"2002","Kansas St.","11","2","0","0.84615","582","154","428","Bill Snyder"
"2003","Kansas St.","11","4","0","0.73333","549","244","305","Bill Snyder"
"2004","Kansas St.","4","7","0","0.36364","326","337","-11","Bill Snyder"
"2005","Kansas St.","5","6","0","0.45455","289","305","-16","Bill Snyder"
"2009","Kansas St.","6","6","0","0.5","276","280","-4","Bill Snyder"
"2010","Kansas St.","7","6","0","0.53846","437","378","59","Bill Snyder"
"2011","Kansas St.","10","3","0","0.76923","413","363","50","Bill Snyder"
"2012","Kansas St.","11","2","0","0.84615","505","288","217","Bill Snyder"
"2013","Kansas St.","8","5","0","0.61538","432","298","134","Bill Snyder"
"2014","Kansas St.","9","4","0","0.69231","465","301","164","Bill Snyder"
"2006","Kansas St.","7","6","0","0.53846","296","309","-13","Ron Prince"
"2007","Kansas St.","5","7","0","0.41667","422","370","52","Ron Prince"
"2008","Kansas St.","5","7","0","0.41667","419","430","-11","Ron Prince"
"1928","Michigan St.","3","4","1","0.4375","153","66","87","Harry G. Kipke"
"1929","Michigan St.","5","3","0","0.625","244","104","140","James H. ""Jim"" Crowley"
"1930","Michigan St.","5","1","2","0.75","151","32","119","James H. ""Jim"" Crowley"
"1931","Michigan St.","5","3","1","0.61111","291","61","230","James H. ""Jim"" Crowley"
"1932","Michigan St.","7","1","0","0.875","220","64","156","James H. ""Jim"" Crowley"
"1933","Michigan St.","4","2","2","0.625","73","49","24","Charles W. Bachman"
"1934","Michigan St.","8","1","0","0.88889","153","56","97","Charles W. Bachman"
"1935","Michigan St.","6","2","0","0.75","207","57","150","Charles W. Bachman"
"1936","Michigan St.","6","1","2","0.77778","143","40","103","Charles W. Bachman"
"1937","Michigan St.","8","2","0","0.8","117","42","75","Charles W. Bachman"
"1938","Michigan St.","6","3","0","0.66667","133","59","74","Charles W. Bachman"
"1939","Michigan St.","4","4","1","0.5","102","92","10","Charles W. Bachman"
"1940","Michigan St.","3","4","1","0.4375","108","76","32","Charles W. Bachman"
"1941","Michigan St.","5","3","1","0.61111","150","77","73","Charles W. Bachman"
"1942","Michigan St.","4","3","2","0.55556","120","99","21","Charles W. Bachman"
"1944","Michigan St.","6","1","0","0.85714","167","31","136","Charles W. Bachman"
"1945","Michigan St.","5","3","1","0.61111","120","128","-8","Charles W. Bachman"
"1946","Michigan St.","5","5","0","0.5","181","202","-21","Charles W. Bachman"
"1947","Michigan St.","7","2","0","0.77778","167","101","66","Clarence L. ""Biggie"" Munn"
"1948","Michigan St.","6","2","2","0.7","359","130","229","Clarence L. ""Biggie"" Munn"
"1949","Michigan St.","6","3","0","0.66667","309","107","202","Clarence L. ""Biggie"" Munn"
"1950","Michigan St.","8","1","0","0.88889","243","107","136","Clarence L. ""Biggie"" Munn"
"1951","Michigan St.","9","0","0","1","270","114","156","Clarence L. ""Biggie"" Munn"
"1952","Michigan St.","9","0","0","1","312","84","228","Clarence L. ""Biggie"" Munn"
"1953","Michigan St.","9","1","0","0.9","240","110","130","Clarence L. ""Biggie"" Munn"
"1954","Michigan St.","3","6","0","0.33333","177","149","28","Hugh Duffy Daugherty"
"1955","Michigan St.","9","1","0","0.9","253","83","170","Hugh Duffy Daugherty"
"1956","Michigan St.","7","2","0","0.77778","239","87","152","Hugh Duffy Daugherty"
"1957","Michigan St.","8","1","0","0.88889","264","75","189","Hugh Duffy Daugherty"
"1958","Michigan St.","3","5","1","0.38889","117","123","-6","Hugh Duffy Daugherty"
"1959","Michigan St.","5","4","0","0.55556","149","118","31","Hugh Duffy Daugherty"
"1960","Michigan St.","6","2","1","0.72222","193","118","75","Hugh Duffy Daugherty"
"1961","Michigan St.","7","2","0","0.77778","192","50","142","Hugh Duffy Daugherty"
"1962","Michigan St.","5","4","0","0.55556","189","96","93","Hugh Duffy Daugherty"
"1963","Michigan St.","6","2","1","0.72222","148","63","85","Hugh Duffy Daugherty"
"1964","Michigan St.","4","5","0","0.44444","136","141","-5","Hugh Duffy Daugherty"
"1965","Michigan St.","10","1","0","0.90909","263","76","187","Hugh Duffy Daugherty"
"1966","Michigan St.","9","0","1","0.95","293","99","194","Hugh Duffy Daugherty"
"1967","Michigan St.","3","7","0","0.3","173","193","-20","Hugh Duffy Daugherty"
"1968","Michigan St.","5","5","0","0.5","202","151","51","Hugh Duffy Daugherty"
"1969","Michigan St.","4","6","0","0.4","202","231","-29","Hugh Duffy Daugherty"
"1970","Michigan St.","4","6","0","0.4","190","215","-25","Hugh Duffy Daugherty"
"1971","Michigan St.","6","5","0","0.54545","225","169","56","Hugh Duffy Daugherty"
"1972","Michigan St.","5","5","1","0.5","158","156","2","Hugh Duffy Daugherty"
"1973","Michigan St.","5","6","0","0.45455","114","164","-50","Dennis E. ""Denny"" Stolz"
"1974","Michigan St.","7","3","1","0.68182","270","196","74","Dennis E. ""Denny"" Stolz"
"1975","Michigan St.","7","4","0","0.63636","222","167","55","Dennis E. ""Denny"" Stolz"
"1976","Michigan St.","4","6","1","0.40909","236","278","-42","Darryl D. Rogers"
"1977","Michigan St.","7","3","1","0.68182","260","162","98","Darryl D. Rogers"
"1978","Michigan St.","8","3","0","0.72727","411","170","241","Darryl D. Rogers"
"1979","Michigan St.","5","6","0","0.45455","240","253","-13","Darryl D. Rogers"
"1980","Michigan St.","3","8","0","0.27273","221","279","-58","Frank ""Muddy"" Waters"
"1981","Michigan St.","5","6","0","0.45455","263","249","14","Frank ""Muddy"" Waters"
"1982","Michigan St.","2","9","0","0.18182","202","242","-40","Frank ""Muddy"" Waters"
"1983","Michigan St.","4","6","1","0.40909","162","233","-71","George J. Perles"
"1984","Michigan St.","6","6","0","0.5","193","203","-10","George J. Perles"
"1985","Michigan St.","7","5","0","0.58333","258","219","39","George J. Perles"
"1986","Michigan St.","6","5","0","0.54545","285","197","88","George J. Perles"
"1987","Michigan St.","9","2","1","0.79167","261","153","108","George J. Perles"
"1988","Michigan St.","6","5","1","0.54167","269","177","92","George J. Perles"
"1989","Michigan St.","8","4","0","0.66667","356","163","193","George J. Perles"
"1990","Michigan St.","8","3","1","0.70833","312","223","89","George J. Perles"
"1991","Michigan St.","3","8","0","0.27273","162","272","-110","George J. Perles"
"1992","Michigan St.","5","6","0","0.45455","238","261","-23","George J. Perles"
"1993","Michigan St.","6","6","0","0.5","277","289","-12","George J. Perles"
"1994","Michigan St.","0","11","0","0","280","267","13","George J. Perles"
"1995","Michigan St.","6","5","1","0.54167","287","338","-51","Nick L. Saban"
"1996","Michigan St.","6","6","0","0.5","358","302","56","Nick L. Saban"
"1997","Michigan St.","7","5","0","0.58333","342","237","105","Nick L. Saban"
"1998","Michigan St.","6","6","0","0.5","336","294","42","Nick L. Saban"
"1999","Michigan St.","9","2","0","0.81818","341","211","130","Nick L. Saban"
"1999","Michigan St.","1","0","0","1","37","34","3","Bobby Williams"
"2000","Michigan St.","5","6","0","0.45455","197","233","-36","Bobby Williams"
"2001","Michigan St.","7","5","0","0.58333","374","311","63","Bobby Williams"
"2002","Michigan St.","3","6","0","0.33333","211","271","-60","Bobby Williams"
"2002","Michigan St.","1","2","0","0.33333","105","127","-22","Morris Watts"
"2003","Michigan St.","8","5","0","0.61538","363","293","70","John L. Smith"
"2004","Michigan St.","5","7","0","0.41667","353","326","27","John L. Smith"
"2005","Michigan St.","5","6","0","0.45455","372","316","56","John L. Smith"
"2006","Michigan St.","4","8","0","0.33333","302","341","-39","John L. Smith"
"2007","Michigan St.","7","6","0","0.53846","430","346","84","Mark Dantonio"
"2008","Michigan St.","9","4","0","0.69231","326","287","39","Mark Dantonio"
"2009","Michigan St.","6","7","0","0.46154","386","342","44","Mark Dantonio"
"2010","Michigan St.","11","2","0","0.84615","383","290","93","Mark Dantonio"
"2011","Michigan St.","11","3","0","0.78571","434","257","177","Mark Dantonio"
"2012","Michigan St.","7","6","0","0.53846","260","212","48","Mark Dantonio"
"2013","Michigan St.","13","1","0","0.92857","411","185","226","Mark Dantonio"
"2014","Michigan St.","11","2","0","0.84615","559","280","279","Mark Dantonio"
"1890","Nebraska","2","0","0","1","28","0","28","Dr. Langdon Frothingham"
"1891","Nebraska","1","1","0","0.5","28","26","2","T.U. Lyman"
"1892","Nebraska","1","0","0","1","6","0","6","J.S. Williams"
"1893","Nebraska","3","2","1","0.58333","80","80","0","Frank Crawford"
"1894","Nebraska","7","2","0","0.77778","120","42","78","Frank Crawford"
"1895","Nebraska","6","3","0","0.66667","138","62","76","Charles Thomas"
"1896","Nebraska","6","3","1","0.65","102","64","38","Edward N. Robinson"
"1897","Nebraska","5","1","0","0.83333","84","15","69","Edward N. Robinson"
"1898","Nebraska","8","3","0","0.72727","270","78","192","Fielding H. ""Hurry Up"" Yost"
"1899","Nebraska","2","7","1","0.25","49","164","-115","Alonzo Edwin Branch"
"1900","Nebraska","7","1","2","0.8","129","20","109","Walter C. ""Bummy"" Booth"
"1901","Nebraska","7","2","0","0.77778","171","52","119","Walter C. ""Bummy"" Booth"
"1902","Nebraska","10","1","0","0.90909","191","41","150","Walter C. ""Bummy"" Booth"
"1903","Nebraska","11","0","0","1","291","17","274","Walter C. ""Bummy"" Booth"
"1904","Nebraska","9","3","0","0.75","339","58","281","Walter C. ""Bummy"" Booth"
"1905","Nebraska","9","2","0","0.81818","316","83","233","Walter C. ""Bummy"" Booth"
"1906","Nebraska","6","4","0","0.6","164","73","91","Amos P. Foster"
"1907","Nebraska","8","2","0","0.8","323","69","254","William C. ""King"" Cole"
"1908","Nebraska","7","2","1","0.75","165","93","72","William C. ""King"" Cole"
"1909","Nebraska","3","3","2","0.5","69","53","16","William C. ""King"" Cole"
"1910","Nebraska","7","1","0","0.875","260","36","224","William C. ""King"" Cole"
"1911","Nebraska","5","1","2","0.75","281","33","248","Ewald O. ""Jumbo"" Stiehm"
"1912","Nebraska","7","1","0","0.875","220","37","183","Ewald O. ""Jumbo"" Stiehm"
"1913","Nebraska","8","0","0","1","138","28","110","Ewald O. ""Jumbo"" Stiehm"
"1914","Nebraska","7","0","1","0.9375","174","28","146","Ewald O. ""Jumbo"" Stiehm"
"1915","Nebraska","8","0","0","1","282","39","243","Ewald O. ""Jumbo"" Stiehm"
"1916","Nebraska","6","2","0","0.75","145","51","94","Edward J. ""Doc"" Stewart"
"1917","Nebraska","5","2","0","0.71429","228","33","195","Edward J. ""Doc"" Stewart"
"1918","Nebraska","3","3","1","0.5","65","55","10","William G. Kline"
"1919","Nebraska","3","3","2","0.5","56","60","-4","Henry F. Schulte"
"1920","Nebraska","5","3","1","0.61111","151","84","67","Henry F. Schulte"
"1921","Nebraska","7","1","0","0.875","283","17","266","Fred T. Dawson"
"1922","Nebraska","7","1","0","0.875","276","28","248","Fred T. Dawson"
"1923","Nebraska","4","2","2","0.625","112","71","41","Fred T. Dawson"
"1924","Nebraska","5","3","0","0.625","120","77","43","Fred T. Dawson"
"1925","Nebraska","4","2","2","0.625","69","29","40","Ernest E. Bearg"
"1926","Nebraska","6","2","0","0.75","123","46","77","Ernest E. Bearg"
"1927","Nebraska","6","2","0","0.75","211","59","152","Ernest E. Bearg"
"1928","Nebraska","7","1","1","0.83333","144","31","113","Ernest E. Bearg"
"1929","Nebraska","4","1","3","0.6875","93","62","31","Dana X. Bible"
"1930","Nebraska","4","3","2","0.55556","119","61","58","Dana X. Bible"
"1931","Nebraska","8","2","0","0.8","136","82","54","Dana X. Bible"
"1932","Nebraska","7","1","1","0.83333","105","52","53","Dana X. Bible"
"1933","Nebraska","8","1","0","0.88889","138","19","119","Dana X. Bible"
"1934","Nebraska","6","3","0","0.66667","106","89","17","Dana X. Bible"
"1935","Nebraska","6","2","1","0.72222","138","71","67","Dana X. Bible"
"1936","Nebraska","7","2","0","0.77778","185","49","136","Dana X. Bible"
"1937","Nebraska","6","1","2","0.77778","99","42","57","Lawrence M. ""Biff"" Jones"
"1938","Nebraska","3","5","1","0.38889","68","84","-16","Lawrence M. ""Biff"" Jones"
"1939","Nebraska","7","1","1","0.83333","115","70","45","Lawrence M. ""Biff"" Jones"
"1940","Nebraska","8","2","0","0.8","183","75","108","Lawrence M. ""Biff"" Jones"
"1941","Nebraska","4","5","0","0.44444","93","81","12","Lawrence M. ""Biff"" Jones"
"1942","Nebraska","3","7","0","0.3","55","158","-103","Glenn E. Presnell"
"1943","Nebraska","2","6","0","0.25","79","261","-182","Adolph J. Lewandowski"
"1944","Nebraska","2","6","0","0.25","83","210","-127","Adolph J. Lewandowski"
"1945","Nebraska","4","5","0","0.44444","145","200","-55","George M. ""Potsy"" Clark"
"1948","Nebraska","2","8","0","0.2","137","273","-136","George M. ""Potsy"" Clark"
"1946","Nebraska","3","6","0","0.33333","126","161","-35","Bernard E. ""Bernie"" Masterson"
"1947","Nebraska","2","7","0","0.22222","73","191","-118","Bernard E. ""Bernie"" Masterson"
"1949","Nebraska","4","5","0","0.44444","124","172","-48","J. William ""Bill"" Glassford"
"1950","Nebraska","6","2","1","0.72222","267","217","50","J. William ""Bill"" Glassford"
"1951","Nebraska","2","8","0","0.2","121","259","-138","J. William ""Bill"" Glassford"
"1952","Nebraska","5","4","1","0.55","173","123","50","J. William ""Bill"" Glassford"
"1953","Nebraska","3","6","1","0.35","119","184","-65","J. William ""Bill"" Glassford"
"1954","Nebraska","6","5","0","0.54545","233","202","31","J. William ""Bill"" Glassford"
"1955","Nebraska","5","5","0","0.5","127","176","-49","J. William ""Bill"" Glassford"
"1956","Nebraska","4","6","0","0.4","125","206","-81","Peter R. Elliott"
"1957","Nebraska","1","9","0","0.1","67","243","-176","Bill Jennings"
"1958","Nebraska","3","7","0","0.3","71","235","-164","Bill Jennings"
"1959","Nebraska","4","6","0","0.4","108","160","-52","Bill Jennings"
"1960","Nebraska","4","6","0","0.4","95","164","-69","Bill Jennings"
"1961","Nebraska","3","6","1","0.35","119","135","-16","Bill Jennings"
"1962","Nebraska","9","2","0","0.81818","293","161","132","Robert S. ""Bob"" Devaney"
"1963","Nebraska","10","1","0","0.90909","273","114","159","Robert S. ""Bob"" Devaney"
"1964","Nebraska","9","2","0","0.81818","256","85","171","Robert S. ""Bob"" Devaney"
"1965","Nebraska","10","1","0","0.90909","349","129","220","Robert S. ""Bob"" Devaney"
"1966","Nebraska","9","2","0","0.81818","223","118","105","Robert S. ""Bob"" Devaney"
"1967","Nebraska","6","4","0","0.6","127","83","44","Robert S. ""Bob"" Devaney"
"1968","Nebraska","6","4","0","0.6","155","161","-6","Robert S. ""Bob"" Devaney"
"1969","Nebraska","9","2","0","0.81818","254","119","135","Robert S. ""Bob"" Devaney"
"1970","Nebraska","11","0","1","0.95833","426","189","237","Robert S. ""Bob"" Devaney"
"1971","Nebraska","13","0","0","1","507","104","403","Robert S. ""Bob"" Devaney"
"1972","Nebraska","9","2","1","0.79167","501","97","404","Robert S. ""Bob"" Devaney"
"1973","Nebraska","9","2","1","0.79167","306","163","143","Tom Osborne"
"1974","Nebraska","9","3","0","0.75","373","132","241","Tom Osborne"
"1975","Nebraska","10","2","0","0.83333","367","137","230","Tom Osborne"
"1976","Nebraska","9","3","1","0.73077","416","181","235","Tom Osborne"
"1977","Nebraska","9","3","0","0.75","315","200","115","Tom Osborne"
"1978","Nebraska","9","3","0","0.75","444","216","228","Tom Osborne"
"1979","Nebraska","10","2","0","0.83333","380","131","249","Tom Osborne"
"1980","Nebraska","10","2","0","0.83333","470","110","360","Tom Osborne"
"1981","Nebraska","9","3","0","0.75","364","125","239","Tom Osborne"
"1982","Nebraska","12","1","0","0.92308","514","167","347","Tom Osborne"
"1983","Nebraska","12","1","0","0.92308","654","217","437","Tom Osborne"
"1984","Nebraska","10","2","0","0.83333","387","115","272","Tom Osborne"
"1985","Nebraska","9","3","0","0.75","421","163","258","Tom Osborne"
"1986","Nebraska","10","2","0","0.83333","446","165","281","Tom Osborne"
"1987","Nebraska","10","2","0","0.83333","451","164","287","Tom Osborne"
"1988","Nebraska","11","2","0","0.84615","477","205","272","Tom Osborne"
"1989","Nebraska","10","2","0","0.83333","509","215","294","Tom Osborne"
"1990","Nebraska","9","3","0","0.75","434","192","242","Tom Osborne"
"1991","Nebraska","9","2","1","0.79167","454","230","224","Tom Osborne"
"1992","Nebraska","9","3","0","0.75","441","199","242","Tom Osborne"
"1993","Nebraska","11","1","0","0.91667","437","194","243","Tom Osborne"
"1994","Nebraska","13","0","0","1","459","162","297","Tom Osborne"
"1995","Nebraska","12","0","0","1","638","174","464","Tom Osborne"
"1996","Nebraska","11","2","0","0.84615","553","174","379","Tom Osborne"
"1997","Nebraska","13","0","0","1","607","214","393","Tom Osborne"
"1998","Nebraska","9","4","0","0.69231","403","206","197","Frank Solich"
"1999","Nebraska","12","1","0","0.92308","442","171","271","Frank Solich"
"2000","Nebraska","10","2","0","0.83333","522","230","292","Frank Solich"
"2001","Nebraska","11","2","0","0.84615","463","226","237","Frank Solich"
"2002","Nebraska","7","7","0","0.5","383","335","48","Frank Solich"
"2003","Nebraska","9","3","0","0.75","305","185","120","Frank Solich"
"2004","Nebraska","5","6","0","0.45455","275","298","-23","Bill Callahan"
"2005","Nebraska","8","4","0","0.66667","296","252","44","Bill Callahan"
"2006","Nebraska","9","5","0","0.64286","428","256","172","Bill Callahan"
"2007","Nebraska","5","7","0","0.41667","401","455","-54","Bill Callahan"
"2003","Nebraska","1","0","0","1","17","3","14","Bo Pelini"
"2008","Nebraska","9","4","0","0.69231","460","371","89","Bo Pelini"
"2009","Nebraska","10","4","0","0.71429","352","146","206","Bo Pelini"
"2010","Nebraska","10","4","0","0.71429","432","243","189","Bo Pelini"
"2011","Nebraska","9","4","0","0.69231","379","304","75","Bo Pelini"
"2012","Nebraska","10","4","0","0.71429","487","386","101","Bo Pelini"
"2013","Nebraska","9","4","0","0.69231","415","323","92","Bo Pelini"
"2014","Nebraska","9","3","0","0.75","449","298","151","Bo Pelini"
"2014","Nebraska","0","1","0","0","42","45","-3","Barney Cotton"
"1913","North Texas","0","1","0","0","0","13","-13","J.W. Pender"
"1914","North Texas","3","3","0","0.5","56","87","-31","J.W. Pender"
"1915","North Texas","5","1","1","0.78571","160","6","154","J.W. St. Clair"
"1916","North Texas","4","3","1","0.5625","125","74","51","J.W. St. Clair"
"1917","North Texas","6","1","0","0.85714","146","42","104","J.W. St. Clair"
"1918","North Texas","1","2","1","0.375","39","58","-19","J.W. St. Clair"
"1919","North Texas","5","3","0","0.625","233","64","169","J.W. St. Clair"
"1920","North Texas","7","1","0","0.875","227","44","183","Theron J. Fouts"
"1921","North Texas","3","3","0","0.5","135","57","78","Theron J. Fouts"
"1922","North Texas","5","2","1","0.6875","85","156","-71","Theron J. Fouts"
"1923","North Texas","3","5","0","0.375","64","161","-97","Theron J. Fouts"
"1924","North Texas","5","3","1","0.61111","72","64","8","Theron J. Fouts"
"1925","North Texas","6","4","0","0.6","128","131","-3","John B. Reid"
"1926","North Texas","5","3","1","0.61111","99","104","-5","John B. Reid"
"1927","North Texas","1","6","2","0.22222","31","224","-193","John B. Reid"
"1928","North Texas","4","5","0","0.44444","88","171","-83","John B. Reid"
"1929","North Texas","4","3","2","0.55556","179","76","103","Jack Sisco"
"1930","North Texas","5","4","1","0.55","86","136","-50","Jack Sisco"
"1931","North Texas","8","3","0","0.72727","171","72","99","Jack Sisco"
"1932","North Texas","8","1","1","0.85","180","26","154","Jack Sisco"
"1933","North Texas","3","4","2","0.44444","49","50","-1","Jack Sisco"
"1934","North Texas","5","4","1","0.55","57","86","-29","Jack Sisco"
"1935","North Texas","5","3","1","0.61111","134","103","31","Jack Sisco"
"1936","North Texas","6","2","1","0.72222","120","38","82","Jack Sisco"
"1937","North Texas","4","4","2","0.5","74","83","-9","Jack Sisco"
"1938","North Texas","7","4","0","0.63636","184","92","92","Jack Sisco"
"1939","North Texas","6","1","0","0.85714","116","42","74","Jack Sisco"
"1940","North Texas","6","3","0","0.66667","199","79","120","Jack Sisco"
"1941","North Texas","7","1","0","0.875","165","77","88","Jack Sisco"
"1942","North Texas","3","5","0","0.375","123","129","-6","Lloyd Russell"
"1946","North Texas","7","3","1","0.68182","127","102","25","Odus Mitchell"
"1947","North Texas","10","2","0","0.83333","256","77","179","Odus Mitchell"
"1948","North Texas","6","4","0","0.6","249","133","116","Odus Mitchell"
"1949","North Texas","8","4","0","0.66667","336","192","144","Odus Mitchell"
"1950","North Texas","7","2","1","0.75","266","174","92","Odus Mitchell"
"1951","North Texas","8","4","0","0.66667","434","132","302","Odus Mitchell"
"1952","North Texas","7","3","0","0.7","276","137","139","Odus Mitchell"
"1953","North Texas","3","6","1","0.35","167","167","0","Odus Mitchell"
"1954","North Texas","4","6","0","0.4","151","176","-25","Odus Mitchell"
"1955","North Texas","5","4","1","0.55","197","159","38","Odus Mitchell"
"1956","North Texas","7","2","1","0.75","188","131","57","Odus Mitchell"
"1957","North Texas","5","5","0","0.5","191","150","41","Odus Mitchell"
"1958","North Texas","7","2","1","0.75","197","93","104","Odus Mitchell"
"1959","North Texas","9","2","0","0.81818","303","103","200","Odus Mitchell"
"1960","North Texas","2","6","1","0.27778","107","208","-101","Odus Mitchell"
"1961","North Texas","5","4","1","0.55","162","206","-44","Odus Mitchell"
"1962","North Texas","6","4","0","0.6","174","182","-8","Odus Mitchell"
"1963","North Texas","3","6","0","0.33333","109","195","-86","Odus Mitchell"
"1964","North Texas","2","7","1","0.25","78","172","-94","Odus Mitchell"
"1965","North Texas","3","7","0","0.3","181","312","-131","Odus Mitchell"
"1966","North Texas","8","2","0","0.8","298","141","157","Odus Mitchell"
"1967","North Texas","7","1","1","0.83333","278","148","130","Rod Rust"
"1968","North Texas","8","2","0","0.8","297","184","113","Rod Rust"
"1969","North Texas","7","3","0","0.7","316","174","142","Rod Rust"
"1970","North Texas","3","8","0","0.27273","173","227","-54","Rod Rust"
"1971","North Texas","3","8","0","0.27273","155","321","-166","Rod Rust"
"1972","North Texas","1","10","0","0.09091","148","354","-206","Rod Rust"
"1973","North Texas","5","5","1","0.5","153","243","-90","Hayden Fry"
"1974","North Texas","2","7","2","0.27273","134","248","-114","Hayden Fry"
"1975","North Texas","7","4","0","0.63636","200","210","-10","Hayden Fry"
"1976","North Texas","7","4","0","0.63636","232","145","87","Hayden Fry"
"1977","North Texas","10","1","0","0.90909","320","179","141","Hayden Fry"
"1978","North Texas","9","2","0","0.81818","275","150","125","Hayden Fry"
"1979","North Texas","5","6","0","0.45455","182","235","-53","Jerry Moore"
"1980","North Texas","6","5","0","0.54545","268","252","16","Jerry Moore"
"1981","North Texas","2","9","0","0.18182","111","235","-124","Bob Tyler"
"1982","North Texas","2","9","0","0.18182","179","283","-104","Corky Nelson"
"1983","North Texas","8","4","0","0.66667","276","137","139","Corky Nelson"
"1984","North Texas","2","9","0","0.18182","86","211","-125","Corky Nelson"
"1985","North Texas","4","6","1","0.40909","150","203","-53","Corky Nelson"
"1986","North Texas","6","4","0","0.6","222","204","18","Corky Nelson"
"1987","North Texas","7","5","0","0.58333","242","247","-5","Corky Nelson"
"1988","North Texas","8","4","0","0.66667","330","174","156","Corky Nelson"
"1989","North Texas","5","6","0","0.45455","217","253","-36","Corky Nelson"
"1990","North Texas","6","5","0","0.54545","223","211","12","Corky Nelson"
"1991","North Texas","3","7","1","0.31818","137","325","-188","Dennis Parker"
"1992","North Texas","4","7","0","0.36364","243","264","-21","Dennis Parker"
"1993","North Texas","4","7","0","0.36364","328","365","-37","Dennis Parker"
"1994","North Texas","7","4","1","0.625","343","261","82","Matt Simon"
"1995","North Texas","2","9","0","0.18182","200","424","-224","Matt Simon"
"1996","North Texas","5","6","0","0.45455","161","293","-132","Matt Simon"
"1997","North Texas","4","7","0","0.36364","232","331","-99","Matt Simon"
"1998","North Texas","3","8","0","0.27273","173","297","-124","Darrell Dickey"
"1999","North Texas","2","9","0","0.18182","118","291","-173","Darrell Dickey"
"2000","North Texas","3","8","0","0.27273","162","300","-138","Darrell Dickey"
"2001","North Texas","5","7","0","0.41667","275","293","-18","Darrell Dickey"
"2002","North Texas","8","5","0","0.61538","249","192","57","Darrell Dickey"
"2003","North Texas","9","4","0","0.69231","358","285","73","Darrell Dickey"
"2004","North Texas","7","5","0","0.58333","309","358","-49","Darrell Dickey"
"2005","North Texas","2","9","0","0.18182","157","346","-189","Darrell Dickey"
"2006","North Texas","3","9","0","0.25","154","304","-150","Darrell Dickey"
"2007","North Texas","2","10","0","0.16667","298","541","-243","Todd Dodge"
"2008","North Texas","1","11","0","0.08333","240","571","-331","Todd Dodge"
"2009","North Texas","2","10","0","0.16667","319","427","-108","Todd Dodge"
"2010","North Texas","1","6","0","0.14286","118","194","-76","Todd Dodge"
"2010","North Texas","2","3","0","0.4","169","162","7","Mike Canales"
"2011","North Texas","5","7","0","0.41667","298","368","-70","Dan McCarney"
"2012","North Texas","4","8","0","0.33333","251","334","-83","Dan McCarney"
"2013","North Texas","9","4","0","0.69231","414","231","183","Dan McCarney"
"2014","North Texas","4","8","0","0.33333","326","358","-32","Dan McCarney"
"1893","Oregon","1","0","0","1","44","2","42","Cal Young"
"1894","Oregon","0","2","1","0.16667","0","28","-28","J.A. Church"
"1895","Oregon","4","0","0","1","64","8","56","Percy Benson"
"1896","Oregon","2","1","0","0.66667","20","20","0","J.F. Frick"
"1897","Oregon","1","1","0","0.5","18","26","-8","Joe Smith"
"1898","Oregon","3","1","0","0.75","167","21","146","Frank W. Simpson"
"1899","Oregon","4","2","1","0.64286","108","17","91","Frank W. Simpson"
"1900","Oregon","3","3","1","0.5","66","44","22","Lawrence Kaarsberg"
"1901","Oregon","3","4","1","0.4375","33","44","-11","Warren W. Smith"
"1903","Oregon","4","2","1","0.64286","75","18","57","Warren W. Smith"
"1902","Oregon","3","1","4","0.625","87","16","71","Marion F. Dolph"
"1904","Oregon","5","3","0","0.625","64","59","5","Richard Shore ""Dick"" Smith"
"1925","Oregon","1","5","1","0.21429","53","108","-55","Richard Shore ""Dick"" Smith"
"1905","Oregon","4","2","2","0.625","65","39","26","Bruce C. Shorts"
"1907","Oregon","5","1","0","0.83333","100","14","86","Gordon B. Frost"
"1908","Oregon","5","2","0","0.71429","74","52","22","Robert W. Forbes"
"1909","Oregon","4","2","0","0.66667","72","29","43","Robert W. Forbes"
"1910","Oregon","4","1","0","0.8","172","11","161","William J. ""Bill"" Warner"
"1911","Oregon","3","2","0","0.6","59","51","8","William J. ""Bill"" Warner"
"1912","Oregon","3","4","0","0.42857","39","77","-38","Louis Pinkham"
"1906","Oregon","5","0","1","0.91667","50","10","40","Hugo F. Bezdek"
"1913","Oregon","3","3","1","0.5","132","54","78","Hugo F. Bezdek"
"1914","Oregon","4","2","1","0.64286","113","30","83","Hugo F. Bezdek"
"1915","Oregon","6","2","0","0.75","169","53","116","Hugo F. Bezdek"
"1916","Oregon","7","0","1","0.9375","244","17","227","Hugo F. Bezdek"
"1917","Oregon","4","3","0","0.57143","73","74","-1","Hugo F. Bezdek"
"1918","Oregon","4","2","0","0.66667","81","35","46","Charles A. ""Shy"" Huntington"
"1919","Oregon","5","2","0","0.71429","104","40","64","Charles A. ""Shy"" Huntington"
"1920","Oregon","3","2","1","0.58333","37","38","-1","Charles A. ""Shy"" Huntington"
"1921","Oregon","5","1","3","0.72222","145","75","70","Charles A. ""Shy"" Huntington"
"1922","Oregon","6","1","1","0.8125","99","26","73","Charles A. ""Shy"" Huntington"
"1923","Oregon","3","4","1","0.4375","113","66","47","Charles A. ""Shy"" Huntington"
"1924","Oregon","4","3","2","0.55556","94","66","28","Joseph H. ""Joe"" Maddock"
"1926","Oregon","2","4","1","0.35714","86","88","-2","John J. McEwan"
"1927","Oregon","2","4","1","0.35714","45","69","-24","John J. McEwan"
"1928","Oregon","9","2","0","0.81818","235","59","176","John J. McEwan"
"1929","Oregon","7","3","0","0.7","209","91","118","John J. McEwan"
"1930","Oregon","7","2","0","0.77778","131","35","96","Clarence W. ""Doc"" Spears"
"1931","Oregon","6","2","2","0.7","90","87","3","Clarence W. ""Doc"" Spears"
"1932","Oregon","6","3","1","0.65","109","70","39","Prince G. ""Prink"" Callison"
"1933","Oregon","9","1","0","0.9","165","50","115","Prince G. ""Prink"" Callison"
"1934","Oregon","6","4","0","0.6","108","98","10","Prince G. ""Prink"" Callison"
"1935","Oregon","6","3","0","0.66667","70","63","7","Prince G. ""Prink"" Callison"
"1936","Oregon","2","6","1","0.27778","34","96","-62","Prince G. ""Prink"" Callison"
"1937","Oregon","4","6","0","0.4","114","158","-44","Prince G. ""Prink"" Callison"
"1938","Oregon","4","5","0","0.44444","69","138","-69","Gerald A. ""Tex"" Oliver"
"1939","Oregon","3","4","1","0.4375","101","74","27","Gerald A. ""Tex"" Oliver"
"1940","Oregon","4","4","1","0.5","100","58","42","Gerald A. ""Tex"" Oliver"
"1941","Oregon","5","5","0","0.5","136","184","-48","Gerald A. ""Tex"" Oliver"
"1945","Oregon","3","6","0","0.33333","116","124","-8","Gerald A. ""Tex"" Oliver"
"1946","Oregon","4","4","1","0.5","81","118","-37","Gerald A. ""Tex"" Oliver"
"1942","Oregon","2","6","0","0.25","67","138","-71","John A. Warren"
"1947","Oregon","7","3","0","0.7","174","121","53","James W. ""Jim"" Aiken"
"1948","Oregon","9","2","0","0.81818","207","103","104","James W. ""Jim"" Aiken"
"1949","Oregon","4","6","0","0.4","250","219","31","James W. ""Jim"" Aiken"
"1950","Oregon","1","9","0","0.1","97","214","-117","James W. ""Jim"" Aiken"
"1951","Oregon","2","8","0","0.2","130","317","-187","Leonard J. ""Len"" Casanova"
"1952","Oregon","2","7","1","0.25","112","234","-122","Leonard J. ""Len"" Casanova"
"1953","Oregon","4","5","1","0.45","91","85","6","Leonard J. ""Len"" Casanova"
"1954","Oregon","6","4","0","0.6","218","159","59","Leonard J. ""Len"" Casanova"
"1955","Oregon","6","4","0","0.6","204","158","46","Leonard J. ""Len"" Casanova"
"1956","Oregon","4","4","2","0.5","133","102","31","Leonard J. ""Len"" Casanova"
"1957","Oregon","7","4","0","0.63636","160","97","63","Leonard J. ""Len"" Casanova"
"1958","Oregon","4","6","0","0.4","93","50","43","Leonard J. ""Len"" Casanova"
"1959","Oregon","8","2","0","0.8","209","113","96","Leonard J. ""Len"" Casanova"
"1960","Oregon","7","3","1","0.68182","206","130","76","Leonard J. ""Len"" Casanova"
"1961","Oregon","4","6","0","0.4","152","112","40","Leonard J. ""Len"" Casanova"
"1962","Oregon","6","3","1","0.65","229","156","73","Leonard J. ""Len"" Casanova"
"1963","Oregon","8","3","0","0.72727","274","153","121","Leonard J. ""Len"" Casanova"
"1964","Oregon","7","2","1","0.75","170","107","63","Leonard J. ""Len"" Casanova"
"1965","Oregon","4","5","1","0.45","165","186","-21","Leonard J. ""Len"" Casanova"
"1966","Oregon","3","7","0","0.3","118","129","-11","Leonard J. ""Len"" Casanova"
"1967","Oregon","2","8","0","0.2","104","193","-89","Jerry Frei"
"1968","Oregon","4","6","0","0.4","132","201","-69","Jerry Frei"
"1969","Oregon","5","5","1","0.5","271","242","29","Jerry Frei"
"1970","Oregon","6","4","1","0.59091","285","256","29","Jerry Frei"
"1971","Oregon","5","6","0","0.45455","235","286","-51","Jerry Frei"
"1972","Oregon","4","7","0","0.36364","194","285","-91","Dick Enright"
"1973","Oregon","2","9","0","0.18182","205","239","-34","Dick Enright"
"1974","Oregon","2","9","0","0.18182","116","330","-214","Don Read"
"1975","Oregon","3","8","0","0.27273","146","266","-120","Don Read"
"1976","Oregon","4","7","0","0.36364","144","271","-127","Don Read"
"1977","Oregon","3","8","0","0.27273","164","377","-213","Rich Brooks"
"1978","Oregon","1","10","0","0.09091","173","212","-39","Rich Brooks"
"1979","Oregon","4","7","0","0.36364","200","212","-12","Rich Brooks"
"1980","Oregon","6","3","2","0.63636","263","193","70","Rich Brooks"
"1981","Oregon","2","9","0","0.18182","155","247","-92","Rich Brooks"
"1982","Oregon","2","8","1","0.22727","103","223","-120","Rich Brooks"
"1983","Oregon","4","6","1","0.40909","152","224","-72","Rich Brooks"
"1984","Oregon","6","5","0","0.54545","241","247","-6","Rich Brooks"
"1985","Oregon","5","6","0","0.45455","273","300","-27","Rich Brooks"
"1986","Oregon","5","6","0","0.45455","235","338","-103","Rich Brooks"
"1987","Oregon","6","5","0","0.54545","230","228","2","Rich Brooks"
"1988","Oregon","6","6","0","0.5","296","247","49","Rich Brooks"
"1989","Oregon","8","4","0","0.66667","379","251","128","Rich Brooks"
"1990","Oregon","8","4","0","0.66667","341","221","120","Rich Brooks"
"1991","Oregon","3","8","0","0.27273","186","248","-62","Rich Brooks"
"1992","Oregon","6","6","0","0.5","265","222","43","Rich Brooks"
"1993","Oregon","5","6","0","0.45455","278","276","2","Rich Brooks"
"1994","Oregon","9","4","0","0.69231","349","250","99","Rich Brooks"
"1995","Oregon","9","3","0","0.75","326","272","54","Mike Bellotti"
"1996","Oregon","6","5","0","0.54545","378","356","22","Mike Bellotti"
"1997","Oregon","7","5","0","0.58333","380","350","30","Mike Bellotti"
"1998","Oregon","8","4","0","0.66667","473","328","145","Mike Bellotti"
"1999","Oregon","9","3","0","0.75","410","284","126","Mike Bellotti"
"2000","Oregon","10","2","0","0.83333","351","249","102","Mike Bellotti"
"2001","Oregon","11","1","0","0.91667","412","256","156","Mike Bellotti"
"2002","Oregon","7","6","0","0.53846","417","362","55","Mike Bellotti"
"2003","Oregon","8","5","0","0.61538","356","348","8","Mike Bellotti"
"2004","Oregon","5","6","0","0.45455","282","282","0","Mike Bellotti"
"2005","Oregon","10","2","0","0.83333","414","278","136","Mike Bellotti"
"2006","Oregon","7","6","0","0.53846","383","345","38","Mike Bellotti"
"2007","Oregon","9","4","0","0.69231","496","307","189","Mike Bellotti"
"2008","Oregon","10","3","0","0.76923","545","367","178","Mike Bellotti"
"2009","Oregon","10","3","0","0.76923","469","309","160","Chip Kelly"
"2010","Oregon","12","1","0","0.92308","611","243","368","Chip Kelly"
"2011","Oregon","12","2","0","0.85714","645","345","300","Chip Kelly"
"2012","Oregon","12","1","0","0.92308","645","281","364","Chip Kelly"
"2013","Oregon","11","2","0","0.84615","591","266","325","Mark Helfrich"
"2014","Oregon","13","2","0","0.86667","681","354","327","Mark Helfrich"
"1921","San Diego St. (CA)","4","6","0","0.4","60","100","-40","C.E. Peterson"
"1922","San Diego St. (CA)","6","4","0","0.6","190","104","86","C.E. Peterson"
"1923","San Diego St. (CA)","8","2","0","0.8","207","82","125","C.E. Peterson"
"1924","San Diego St. (CA)","7","1","2","0.8","249","53","196","C.E. Peterson"
"1925","San Diego St. (CA)","5","3","1","0.61111","108","59","49","C.E. Peterson"
"1926","San Diego St. (CA)","3","4","1","0.4375","78","150","-72","C.E. Peterson"
"1927","San Diego St. (CA)","4","3","0","0.57143","190","79","111","C.E. Peterson"
"1928","San Diego St. (CA)","3","3","0","0.5","111","105","6","C.E. Peterson"
"1929","San Diego St. (CA)","3","5","0","0.375","81","96","-15","C.E. Peterson"
"1930","San Diego St. (CA)","5","4","0","0.55556","112","71","41","W.B. Herreid"
"1931","San Diego St. (CA)","5","3","2","0.6","71","45","26","W.B. Herreid"
"1932","San Diego St. (CA)","3","5","1","0.38889","80","72","8","W.B. Herreid"
"1933","San Diego St. (CA)","4","4","1","0.5","59","72","-13","W.B. Herreid"
"1934","San Diego St. (CA)","3","5","1","0.38889","61","106","-45","W.B. Herreid"
"1935","San Diego St. (CA)","3","4","1","0.4375","56","83","-27","Leo B. Calland"
"1936","San Diego St. (CA)","6","1","1","0.8125","118","62","56","Leo B. Calland"
"1937","San Diego St. (CA)","7","1","0","0.875","90","16","74","Leo B. Calland"
"1938","San Diego St. (CA)","5","2","1","0.6875","82","69","13","Leo B. Calland"
"1939","San Diego St. (CA)","2","7","0","0.22222","60","148","-88","Leo B. Calland"
"1940","San Diego St. (CA)","5","3","1","0.61111","128","87","41","Leo B. Calland"
"1941","San Diego St. (CA)","6","4","0","0.6","105","87","18","Leo B. Calland"
"1942","San Diego St. (CA)","0","6","1","0.07143","50","211","-161","John Eubank"
"1945","San Diego St. (CA)","2","5","0","0.28571","65","163","-98","Bob Breitbard"
"1946","San Diego St. (CA)","6","4","0","0.6","152","105","47","William L. ""Gander"" Terry"
"1947","San Diego St. (CA)","7","3","1","0.68182","191","156","35","Bill Schutte"
"1948","San Diego St. (CA)","4","7","0","0.36364","158","190","-32","Bill Schutte"
"1949","San Diego St. (CA)","6","3","0","0.66667","195","200","-5","Bill Schutte"
"1950","San Diego St. (CA)","5","3","1","0.61111","212","186","26","Bill Schutte"
"1951","San Diego St. (CA)","10","0","1","0.95455","386","133","253","Bill Schutte"
"1952","San Diego St. (CA)","4","5","0","0.44444","238","267","-29","Bill Schutte"
"1953","San Diego St. (CA)","5","3","1","0.61111","230","142","88","Bill Schutte"
"1954","San Diego St. (CA)","5","4","0","0.55556","177","141","36","Bill Schutte"
"1955","San Diego St. (CA)","2","8","0","0.2","65","231","-166","Bill Schutte"
"1956","San Diego St. (CA)","4","3","2","0.55556","149","217","-68","Paul Governali"
"1957","San Diego St. (CA)","2","7","0","0.22222","77","243","-166","Paul Governali"
"1958","San Diego St. (CA)","3","5","0","0.375","84","200","-116","Paul Governali"
"1959","San Diego St. (CA)","1","6","1","0.1875","74","208","-134","Paul Governali"
"1960","San Diego St. (CA)","1","6","1","0.1875","53","207","-154","Paul Governali"
"1961","San Diego St. (CA)","7","2","1","0.75","231","154","77","Don Coryell"
"1962","San Diego St. (CA)","8","2","0","0.8","294","135","159","Don Coryell"
"1963","San Diego St. (CA)","7","2","0","0.77778","317","118","199","Don Coryell"
"1964","San Diego St. (CA)","8","2","0","0.8","423","71","352","Don Coryell"
"1965","San Diego St. (CA)","8","2","0","0.8","353","87","266","Don Coryell"
"1966","San Diego St. (CA)","11","0","0","1","317","105","212","Don Coryell"
"1967","San Diego St. (CA)","10","1","0","0.90909","319","135","184","Don Coryell"
"1968","San Diego St. (CA)","9","0","1","0.95","377","155","222","Don Coryell"
"1969","San Diego St. (CA)","11","0","0","1","492","194","298","Don Coryell"
"1970","San Diego St. (CA)","9","2","0","0.81818","364","123","241","Don Coryell"
"1971","San Diego St. (CA)","6","5","0","0.54545","245","230","15","Don Coryell"
"1972","San Diego St. (CA)","10","1","0","0.90909","266","143","123","Don Coryell"
"1973","San Diego St. (CA)","9","1","1","0.86364","321","129","192","Claude Gilbert"
"1974","San Diego St. (CA)","8","2","1","0.77273","291","170","121","Claude Gilbert"
"1975","San Diego St. (CA)","8","3","0","0.72727","320","145","175","Claude Gilbert"
"1976","San Diego St. (CA)","10","1","0","0.90909","197","125","72","Claude Gilbert"
"1977","San Diego St. (CA)","10","1","0","0.90909","349","165","184","Claude Gilbert"
"1978","San Diego St. (CA)","4","7","0","0.36364","242","257","-15","Claude Gilbert"
"1979","San Diego St. (CA)","8","3","0","0.72727","286","276","10","Claude Gilbert"
"1980","San Diego St. (CA)","4","8","0","0.33333","161","294","-133","Claude Gilbert"
"1981","San Diego St. (CA)","6","5","0","0.54545","279","227","52","Doug Scovil"
"1982","San Diego St. (CA)","7","5","0","0.58333","308","320","-12","Doug Scovil"
"1983","San Diego St. (CA)","2","9","1","0.20833","221","352","-131","Doug Scovil"
"1984","San Diego St. (CA)","4","7","1","0.375","265","250","15","Doug Scovil"
"1985","San Diego St. (CA)","5","6","1","0.45833","342","317","25","Doug Scovil"
"1986","San Diego St. (CA)","8","4","0","0.66667","292","279","13","Dennis E. ""Denny"" Stolz"
"1987","San Diego St. (CA)","5","7","0","0.41667","357","428","-71","Dennis E. ""Denny"" Stolz"
"1988","San Diego St. (CA)","3","8","0","0.27273","204","384","-180","Dennis E. ""Denny"" Stolz"
"1989","San Diego St. (CA)","6","5","1","0.54167","368","378","-10","Al Luginbill"
"1990","San Diego St. (CA)","6","5","0","0.54545","459","386","73","Al Luginbill"
"1991","San Diego St. (CA)","8","4","1","0.65385","420","365","55","Al Luginbill"
"1992","San Diego St. (CA)","5","5","1","0.5","334","338","-4","Al Luginbill"
"1993","San Diego St. (CA)","6","6","0","0.5","413","392","21","Al Luginbill"
"1994","San Diego St. (CA)","4","7","0","0.36364","332","339","-7","Ted Tollner"
"1995","San Diego St. (CA)","8","4","0","0.66667","401","283","118","Ted Tollner"
"1996","San Diego St. (CA)","8","3","0","0.72727","428","303","125","Ted Tollner"
"1997","San Diego St. (CA)","5","7","0","0.41667","257","333","-76","Ted Tollner"
"1998","San Diego St. (CA)","7","5","0","0.58333","243","244","-1","Ted Tollner"
"1999","San Diego St. (CA)","5","6","0","0.45455","272","226","46","Ted Tollner"
"2000","San Diego St. (CA)","3","8","0","0.27273","170","273","-103","Ted Tollner"
"2001","San Diego St. (CA)","3","8","0","0.27273","184","290","-106","Ted Tollner"
"2002","San Diego St. (CA)","4","9","0","0.30769","309","411","-102","Tom Craft"
"2003","San Diego St. (CA)","6","6","0","0.5","224","207","17","Tom Craft"
"2004","San Diego St. (CA)","4","7","0","0.36364","234","282","-48","Tom Craft"
"2005","San Diego St. (CA)","5","7","0","0.41667","323","325","-2","Tom Craft"
"2006","San Diego St. (CA)","3","9","0","0.25","170","325","-155","Chuck Long"
"2007","San Diego St. (CA)","4","8","0","0.33333","301","413","-112","Chuck Long"
"2008","San Diego St. (CA)","2","10","0","0.16667","231","446","-215","Chuck Long"
"2009","San Diego St. (CA)","4","8","0","0.33333","280","366","-86","Brady Hoke"
"2010","San Diego St. (CA)","9","4","0","0.69231","455","287","168","Brady Hoke"
"2011","San Diego St. (CA)","8","5","0","0.61538","387","325","62","Rocky Long"
"2012","San Diego St. (CA)","9","4","0","0.69231","427","317","110","Rocky Long"
"2013","San Diego St. (CA)","8","5","0","0.61538","387","412","-25","Rocky Long"
"2014","San Diego St. (CA)","7","6","0","0.53846","325","258","67","Rocky Long"
"1894","Temple (PA)","4","1","0","0.8","70","32","38","Charles M. Williams"
"1895","Temple (PA)","1","4","1","0.25","30","89","-59","Charles M. Williams"
"1896","Temple (PA)","3","2","0","0.6","50","32","18","Charles M. Williams"
"1897","Temple (PA)","3","3","0","0.5","100","85","15","Charles M. Williams"
"1898","Temple (PA)","2","5","0","0.28571","32","133","-101","Charles M. Williams"
"1899","Temple (PA)","1","4","1","0.25","27","127","-100","John T. Rogers"
"1900","Temple (PA)","3","4","1","0.4375","95","69","26","John T. Rogers"
"1901","Temple (PA)","3","2","0","0.6","37","65","-28","H. Shindle Wingert"
"1902","Temple (PA)","1","4","1","0.25","29","62","-33","H. Shindle Wingert"
"1903","Temple (PA)","4","1","0","0.8","56","18","38","H. Shindle Wingert"
"1904","Temple (PA)","3","2","0","0.6","65","23","42","H. Shindle Wingert"
"1905","Temple (PA)","2","0","1","0.83333","48","12","36","H. Shindle Wingert"
"1907","Temple (PA)","4","0","2","0.83333","82","40","42","Horace Butterworth"
"1908","Temple (PA)","3","3","1","0.5","55","109","-54","Dr. Frank W. White"
"1909","Temple (PA)","0","4","1","0.1","0","99","-99","William J. Schatz"
"1910","Temple (PA)","3","4","0","0.42857","64","140","-76","William J. Schatz"
"1911","Temple (PA)","6","1","0","0.85714","90","54","36","William J. Schatz"
"1912","Temple (PA)","3","4","0","0.42857","44","119","-75","William J. Schatz"
"1913","Temple (PA)","1","5","2","0.25","31","110","-79","William J. Schatz"
"1914","Temple (PA)","5","5","1","0.5","163","92","71","William Nicholai"
"1915","Temple (PA)","3","1","1","0.7","32","40","-8","William Nicholai"
"1916","Temple (PA)","4","1","2","0.71429","67","14","53","William Nicholai"
"1917","Temple (PA)","0","6","1","0.07143","6","12","-6","Elwood Geiges"
"1922","Temple (PA)","1","4","1","0.25","26","123","-97","Milton Francois D'Eliscu"
"1923","Temple (PA)","0","5","0","0","13","101","-88","Milton Francois D'Eliscu"
"1924","Temple (PA)","1","4","0","0.2","15","106","-91","Albert Barron"
"1925","Temple (PA)","5","2","2","0.66667","104","39","65","Henry J. Miller"
"1926","Temple (PA)","5","3","0","0.625","89","93","-4","Henry J. Miller"
"1927","Temple (PA)","7","1","0","0.875","351","60","291","Henry J. Miller"
"1928","Temple (PA)","7","1","2","0.8","224","23","201","Henry J. Miller"
"1929","Temple (PA)","6","3","1","0.65","141","65","76","Henry J. Miller"
"1930","Temple (PA)","7","3","0","0.7","224","110","114","Henry J. Miller"
"1931","Temple (PA)","8","1","1","0.85","158","42","116","Henry J. Miller"
"1932","Temple (PA)","5","1","2","0.75","105","53","52","Henry J. Miller"
"1933","Temple (PA)","5","3","0","0.625","110","96","14","Glenn Scobey ""Pop"" Warner"
"1934","Temple (PA)","7","1","2","0.8","220","57","163","Glenn Scobey ""Pop"" Warner"
"1935","Temple (PA)","7","3","0","0.7","181","68","113","Glenn Scobey ""Pop"" Warner"
"1936","Temple (PA)","6","3","2","0.63636","117","66","51","Glenn Scobey ""Pop"" Warner"
"1937","Temple (PA)","3","2","4","0.55556","38","59","-21","Glenn Scobey ""Pop"" Warner"
"1938","Temple (PA)","3","6","1","0.35","97","170","-73","Glenn Scobey ""Pop"" Warner"
"1939","Temple (PA)","2","7","0","0.22222","51","96","-45","Fred H. Swan"
"1940","Temple (PA)","4","4","1","0.5","155","113","42","J. Ray Morrison"
"1941","Temple (PA)","7","2","0","0.77778","176","146","30","J. Ray Morrison"
"1942","Temple (PA)","2","5","3","0.35","48","135","-87","J. Ray Morrison"
"1943","Temple (PA)","2","6","0","0.25","65","163","-98","J. Ray Morrison"
"1944","Temple (PA)","2","4","2","0.375","93","96","-3","J. Ray Morrison"
"1945","Temple (PA)","7","1","0","0.875","198","51","147","J. Ray Morrison"
"1946","Temple (PA)","2","4","2","0.375","61","114","-53","J. Ray Morrison"
"1947","Temple (PA)","3","6","0","0.33333","91","128","-37","J. Ray Morrison"
"1948","Temple (PA)","2","6","1","0.27778","95","182","-87","J. Ray Morrison"
"1949","Temple (PA)","5","4","0","0.55556","156","225","-69","Albert P. Kawal"
"1950","Temple (PA)","4","4","1","0.5","173","132","41","Albert P. Kawal"
"1951","Temple (PA)","6","4","0","0.6","168","176","-8","Albert P. Kawal"
"1952","Temple (PA)","2","7","1","0.25","128","221","-93","Albert P. Kawal"
"1953","Temple (PA)","4","4","1","0.5","134","157","-23","Albert P. Kawal"
"1954","Temple (PA)","3","5","0","0.375","95","148","-53","Albert P. Kawal"
"1955","Temple (PA)","0","8","0","0","49","223","-174","Josh C. Cody"
"1956","Temple (PA)","3","5","0","0.375","94","126","-32","Peter P. Stevens"
"1957","Temple (PA)","1","6","0","0.14286","62","210","-148","Peter P. Stevens"
"1958","Temple (PA)","0","8","0","0","56","251","-195","Peter P. Stevens"
"1959","Temple (PA)","0","9","0","0","73","270","-197","Peter P. Stevens"
"1960","Temple (PA)","2","7","0","0.22222","113","137","-24","George Makris"
"1961","Temple (PA)","2","5","2","0.33333","86","129","-43","George Makris"
"1962","Temple (PA)","3","6","0","0.33333","133","115","18","George Makris"
"1963","Temple (PA)","5","3","1","0.61111","209","130","79","George Makris"
"1964","Temple (PA)","7","2","0","0.77778","247","128","119","George Makris"
"1965","Temple (PA)","5","5","0","0.5","203","210","-7","George Makris"
"1966","Temple (PA)","6","3","0","0.66667","266","196","70","George Makris"
"1967","Temple (PA)","7","2","0","0.77778","201","224","-23","George Makris"
"1968","Temple (PA)","4","6","0","0.4","240","241","-1","George Makris"
"1969","Temple (PA)","4","5","1","0.45","180","144","36","George Makris"
"1970","Temple (PA)","7","3","0","0.7","190","151","39","Wayne Hardin"
"1971","Temple (PA)","6","2","1","0.72222","248","136","112","Wayne Hardin"
"1972","Temple (PA)","5","4","0","0.55556","164","176","-12","Wayne Hardin"
"1973","Temple (PA)","9","1","0","0.9","353","167","186","Wayne Hardin"
"1974","Temple (PA)","8","2","0","0.8","335","142","193","Wayne Hardin"
"1975","Temple (PA)","6","5","0","0.54545","289","225","64","Wayne Hardin"
"1976","Temple (PA)","4","6","0","0.4","196","216","-20","Wayne Hardin"
"1977","Temple (PA)","5","5","1","0.5","229","286","-57","Wayne Hardin"
"1978","Temple (PA)","7","3","1","0.68182","280","203","77","Wayne Hardin"
"1979","Temple (PA)","10","2","0","0.83333","399","198","201","Wayne Hardin"
"1980","Temple (PA)","4","7","0","0.36364","170","262","-92","Wayne Hardin"
"1981","Temple (PA)","5","5","0","0.5","181","195","-14","Wayne Hardin"
"1982","Temple (PA)","4","7","0","0.36364","220","202","18","Wayne Hardin"
"1983","Temple (PA)","4","7","0","0.36364","170","241","-71","Bruce Arians"
"1984","Temple (PA)","6","5","0","0.54545","226","180","46","Bruce Arians"
"1985","Temple (PA)","4","7","0","0.36364","233","223","10","Bruce Arians"
"1986","Temple (PA)","0","11","0","0","308","271","37","Bruce Arians"
"1987","Temple (PA)","3","8","0","0.27273","154","251","-97","Bruce Arians"
"1988","Temple (PA)","4","7","0","0.36364","207","317","-110","Bruce Arians"
"1989","Temple (PA)","1","10","0","0.09091","141","387","-246","Jerry Berndt"
"1990","Temple (PA)","7","4","0","0.63636","261","269","-8","Jerry Berndt"
"1991","Temple (PA)","2","9","0","0.18182","145","290","-145","Jerry Berndt"
"1992","Temple (PA)","1","10","0","0.09091","132","383","-251","Jerry Berndt"
"1993","Temple (PA)","1","10","0","0.09091","115","527","-412","Ron Dickerson, Sr."
"1994","Temple (PA)","2","9","0","0.18182","244","417","-173","Ron Dickerson, Sr."
"1995","Temple (PA)","1","10","0","0.09091","187","358","-171","Ron Dickerson, Sr."
"1996","Temple (PA)","1","10","0","0.09091","218","386","-168","Ron Dickerson, Sr."
"1997","Temple (PA)","3","8","0","0.27273","212","371","-159","Ron Dickerson, Sr."
"1998","Temple (PA)","2","9","0","0.18182","198","360","-162","Bobby Wallace"
"1999","Temple (PA)","2","9","0","0.18182","153","366","-213","Bobby Wallace"
"2000","Temple (PA)","4","7","0","0.36364","224","269","-45","Bobby Wallace"
"2001","Temple (PA)","4","7","0","0.36364","198","311","-113","Bobby Wallace"
"2002","Temple (PA)","4","8","0","0.33333","242","351","-109","Bobby Wallace"
"2003","Temple (PA)","1","11","0","0.08333","235","393","-158","Bobby Wallace"
"2004","Temple (PA)","2","9","0","0.18182","238","399","-161","Bobby Wallace"
"2005","Temple (PA)","0","11","0","0","107","498","-391","Bobby Wallace"
"2006","Temple (PA)","1","11","0","0.08333","131","496","-365","Al Golden"
"2007","Temple (PA)","4","8","0","0.33333","197","315","-118","Al Golden"
"2008","Temple (PA)","5","7","0","0.41667","281","277","4","Al Golden"
"2009","Temple (PA)","9","4","0","0.69231","384","290","94","Al Golden"
"2010","Temple (PA)","8","4","0","0.66667","300","229","71","Al Golden"
"2011","Temple (PA)","9","4","0","0.69231","398","181","217","Steve Addazio"
"2012","Temple (PA)","4","7","0","0.36364","272","343","-71","Steve Addazio"
"2013","Temple (PA)","2","10","0","0.16667","299","358","-59","Matt Rhule"
"2014","Temple (PA)","6","6","0","0.5","277","210","67","Matt Rhule"
"1890","Vanderbilt (TN)","1","0","0","1","40","0","40","Elliott H. Jones"
"1891","Vanderbilt (TN)","3","1","0","0.75","58","28","30","Elliott H. Jones"
"1892","Vanderbilt (TN)","4","4","0","0.5","114","106","8","Elliott H. Jones"
"1893","Vanderbilt (TN)","6","1","0","0.85714","181","50","131","W.J. Keller"
"1894","Vanderbilt (TN)","7","1","0","0.875","238","20","218","Henry Thornton"
"1895","Vanderbilt (TN)","5","3","1","0.61111","67","50","17","C.L. Upton"
"1896","Vanderbilt (TN)","3","2","2","0.57143","58","76","-18","R.G. Acton"
"1897","Vanderbilt (TN)","6","0","1","0.92857","141","0","141","R.G. Acton"
"1898","Vanderbilt (TN)","1","5","0","0.16667","9","61","-52","R.G. Acton"
"1899","Vanderbilt (TN)","7","2","0","0.77778","109","42","67","James L. Crane"
"1900","Vanderbilt (TN)","4","4","1","0.5","90","92","-2","James L. Crane"
"1901","Vanderbilt (TN)","8","4","2","0.64286","228","86","142","Walter Hudson ""Billy"" Watkins"
"1902","Vanderbilt (TN)","8","1","0","0.88889","214","60","154","Walter Hudson ""Billy"" Watkins"
"1903","Vanderbilt (TN)","6","1","1","0.8125","192","16","176","James H. ""Jimmy"" Henry"
"1904","Vanderbilt (TN)","8","0","0","1","452","4","448","Dan McGugin"
"1905","Vanderbilt (TN)","7","1","0","0.875","372","22","350","Dan McGugin"
"1906","Vanderbilt (TN)","8","1","0","0.88889","278","16","262","Dan McGugin"
"1907","Vanderbilt (TN)","5","1","1","0.78571","242","36","206","Dan McGugin"
"1908","Vanderbilt (TN)","7","2","1","0.75","207","61","146","Dan McGugin"
"1909","Vanderbilt (TN)","7","3","0","0.7","210","32","178","Dan McGugin"
"1910","Vanderbilt (TN)","8","0","1","0.94444","166","8","158","Dan McGugin"
"1911","Vanderbilt (TN)","8","1","0","0.88889","259","9","250","Dan McGugin"
"1912","Vanderbilt (TN)","8","1","1","0.85","391","19","372","Dan McGugin"
"1913","Vanderbilt (TN)","5","3","0","0.625","218","100","118","Dan McGugin"
"1914","Vanderbilt (TN)","3","6","0","0.33333","166","95","71","Dan McGugin"
"1915","Vanderbilt (TN)","9","1","0","0.9","513","38","475","Dan McGugin"
"1916","Vanderbilt (TN)","7","1","1","0.83333","328","25","303","Dan McGugin"
"1917","Vanderbilt (TN)","5","3","0","0.625","142","170","-28","Dan McGugin"
"1919","Vanderbilt (TN)","5","1","2","0.75","110","68","42","Dan McGugin"
"1920","Vanderbilt (TN)","5","3","1","0.61111","169","124","45","Dan McGugin"
"1921","Vanderbilt (TN)","7","0","1","0.9375","161","21","140","Dan McGugin"
"1922","Vanderbilt (TN)","8","0","1","0.94444","177","16","161","Dan McGugin"
"1923","Vanderbilt (TN)","5","2","1","0.6875","137","33","104","Dan McGugin"
"1924","Vanderbilt (TN)","6","3","1","0.65","150","53","97","Dan McGugin"
"1925","Vanderbilt (TN)","6","3","0","0.66667","158","63","95","Dan McGugin"
"1926","Vanderbilt (TN)","8","1","0","0.88889","241","42","199","Dan McGugin"
"1927","Vanderbilt (TN)","8","1","2","0.81818","295","93","202","Dan McGugin"
"1928","Vanderbilt (TN)","8","2","0","0.8","152","57","95","Dan McGugin"
"1929","Vanderbilt (TN)","7","2","0","0.77778","187","56","131","Dan McGugin"
"1930","Vanderbilt (TN)","8","2","0","0.8","225","45","180","Dan McGugin"
"1931","Vanderbilt (TN)","5","4","0","0.55556","192","109","83","Dan McGugin"
"1932","Vanderbilt (TN)","6","1","2","0.77778","128","46","82","Dan McGugin"
"1933","Vanderbilt (TN)","4","3","3","0.55","126","107","19","Dan McGugin"
"1934","Vanderbilt (TN)","6","3","0","0.66667","105","100","5","Dan McGugin"
"1918","Vanderbilt (TN)","4","2","0","0.66667","176","31","145","J. Ray Morrison"
"1935","Vanderbilt (TN)","7","3","0","0.7","179","68","111","J. Ray Morrison"
"1936","Vanderbilt (TN)","3","5","1","0.38889","115","87","28","J. Ray Morrison"
"1937","Vanderbilt (TN)","7","2","0","0.77778","121","42","79","J. Ray Morrison"
"1938","Vanderbilt (TN)","6","3","0","0.66667","86","49","37","J. Ray Morrison"
"1939","Vanderbilt (TN)","2","7","1","0.25","96","165","-69","J. Ray Morrison"
"1940","Vanderbilt (TN)","3","6","1","0.35","101","98","3","Harry R. ""Red"" Sanders"
"1941","Vanderbilt (TN)","8","2","0","0.8","260","89","171","Harry R. ""Red"" Sanders"
"1942","Vanderbilt (TN)","6","4","0","0.6","232","113","119","Harry R. ""Red"" Sanders"
"1946","Vanderbilt (TN)","5","4","0","0.55556","108","43","65","Harry R. ""Red"" Sanders"
"1947","Vanderbilt (TN)","6","4","0","0.6","182","85","97","Harry R. ""Red"" Sanders"
"1948","Vanderbilt (TN)","8","2","1","0.77273","328","73","255","Harry R. ""Red"" Sanders"
"1943","Vanderbilt (TN)","5","0","0","1","143","33","110","Ernest Hayes Alley"
"1944","Vanderbilt (TN)","3","0","1","0.875","67","23","44","Doby Bartling"
"1945","Vanderbilt (TN)","3","6","0","0.33333","71","215","-144","Doby Bartling"
"1949","Vanderbilt (TN)","5","5","0","0.5","177","183","-6","Bill Edwards"
"1950","Vanderbilt (TN)","7","4","0","0.63636","252","216","36","Bill Edwards"
"1951","Vanderbilt (TN)","6","5","0","0.54545","201","195","6","Bill Edwards"
"1952","Vanderbilt (TN)","3","5","2","0.4","151","199","-48","Bill Edwards"
"1953","Vanderbilt (TN)","3","7","0","0.3","131","258","-127","Arthur L ""Art"" Guepe"
"1954","Vanderbilt (TN)","2","7","0","0.22222","134","169","-35","Arthur L ""Art"" Guepe"
"1955","Vanderbilt (TN)","8","3","0","0.72727","240","86","154","Arthur L ""Art"" Guepe"
"1956","Vanderbilt (TN)","5","5","0","0.5","147","113","34","Arthur L ""Art"" Guepe"
"1957","Vanderbilt (TN)","5","3","2","0.6","113","108","5","Arthur L ""Art"" Guepe"
"1958","Vanderbilt (TN)","5","2","3","0.65","131","71","60","Arthur L ""Art"" Guepe"
"1959","Vanderbilt (TN)","5","3","2","0.6","138","106","32","Arthur L ""Art"" Guepe"
"1960","Vanderbilt (TN)","3","7","0","0.3","74","193","-119","Arthur L ""Art"" Guepe"
"1961","Vanderbilt (TN)","2","8","0","0.2","95","220","-125","Arthur L ""Art"" Guepe"
"1962","Vanderbilt (TN)","1","9","0","0.1","62","215","-153","Arthur L ""Art"" Guepe"
"1963","Vanderbilt (TN)","1","7","2","0.2","73","146","-73","Jack Green"
"1964","Vanderbilt (TN)","3","6","1","0.35","79","122","-43","Jack Green"
"1965","Vanderbilt (TN)","2","7","1","0.25","85","180","-95","Jack Green"
"1966","Vanderbilt (TN)","1","9","0","0.1","72","237","-165","Jack Green"
"1967","Vanderbilt (TN)","2","7","1","0.25","165","241","-76","Bill Pace"
"1968","Vanderbilt (TN)","5","4","1","0.55","163","147","16","Bill Pace"
"1969","Vanderbilt (TN)","4","6","0","0.4","242","264","-22","Bill Pace"
"1970","Vanderbilt (TN)","4","7","0","0.36364","201","213","-12","Bill Pace"
"1971","Vanderbilt (TN)","4","6","1","0.40909","136","208","-72","Bill Pace"
"1972","Vanderbilt (TN)","3","8","0","0.27273","129","243","-114","Bill Pace"
"1973","Vanderbilt (TN)","5","6","0","0.45455","181","262","-81","Steve Sloan"
"1974","Vanderbilt (TN)","7","3","2","0.66667","313","199","114","Steve Sloan"
"1975","Vanderbilt (TN)","7","4","0","0.63636","119","200","-81","Fred Pancoast"
"1976","Vanderbilt (TN)","2","9","0","0.18182","131","282","-151","Fred Pancoast"
"1977","Vanderbilt (TN)","2","9","0","0.18182","141","276","-135","Fred Pancoast"
"1978","Vanderbilt (TN)","2","9","0","0.18182","164","418","-254","Fred Pancoast"
"1979","Vanderbilt (TN)","1","10","0","0.09091","179","418","-239","George MacIntyre"
"1980","Vanderbilt (TN)","2","9","0","0.18182","140","352","-212","George MacIntyre"
"1981","Vanderbilt (TN)","4","7","0","0.36364","211","281","-70","George MacIntyre"
"1982","Vanderbilt (TN)","8","4","0","0.66667","293","242","51","George MacIntyre"
"1983","Vanderbilt (TN)","2","9","0","0.18182","183","274","-91","George MacIntyre"
"1984","Vanderbilt (TN)","5","6","0","0.45455","276","277","-1","George MacIntyre"
"1985","Vanderbilt (TN)","3","7","1","0.31818","166","308","-142","George MacIntyre"
"1986","Vanderbilt (TN)","1","10","0","0.09091","193","347","-154","Watson Brown"
"1987","Vanderbilt (TN)","4","7","0","0.36364","286","355","-69","Watson Brown"
"1988","Vanderbilt (TN)","3","8","0","0.27273","202","277","-75","Watson Brown"
"1989","Vanderbilt (TN)","1","10","0","0.09091","162","265","-103","Watson Brown"
"1990","Vanderbilt (TN)","1","10","0","0.09091","227","457","-230","Watson Brown"
"1991","Vanderbilt (TN)","5","6","0","0.45455","205","267","-62","Gerry DiNardo"
"1992","Vanderbilt (TN)","4","7","0","0.36364","224","277","-53","Gerry DiNardo"
"1993","Vanderbilt (TN)","5","6","0","0.45455","137","290","-153","Gerry DiNardo"
"1994","Vanderbilt (TN)","5","6","0","0.45455","203","277","-74","Gerry DiNardo"
"1995","Vanderbilt (TN)","2","9","0","0.18182","122","281","-159","Rod Dowhower"
"1996","Vanderbilt (TN)","2","9","0","0.18182","122","234","-112","Rod Dowhower"
"1997","Vanderbilt (TN)","3","8","0","0.27273","138","204","-66","Woody Widenhofer"
"1998","Vanderbilt (TN)","2","9","0","0.18182","142","369","-227","Woody Widenhofer"
"1999","Vanderbilt (TN)","5","6","0","0.45455","252","256","-4","Woody Widenhofer"
"2000","Vanderbilt (TN)","3","8","0","0.27273","193","273","-80","Woody Widenhofer"
"2001","Vanderbilt (TN)","2","9","0","0.18182","226","402","-176","Woody Widenhofer"
"2002","Vanderbilt (TN)","2","10","0","0.16667","221","368","-147","Bobby Johnson"
"2003","Vanderbilt (TN)","2","10","0","0.16667","235","358","-123","Bobby Johnson"
"2004","Vanderbilt (TN)","2","9","0","0.18182","212","286","-74","Bobby Johnson"
"2005","Vanderbilt (TN)","5","6","0","0.45455","299","321","-22","Bobby Johnson"
"2006","Vanderbilt (TN)","4","8","0","0.33333","264","284","-20","Bobby Johnson"
"2007","Vanderbilt (TN)","5","7","0","0.41667","260","271","-11","Bobby Johnson"
"2008","Vanderbilt (TN)","7","6","0","0.53846","249","255","-6","Bobby Johnson"
"2009","Vanderbilt (TN)","2","10","0","0.16667","196","280","-84","Bobby Johnson"
"2010","Vanderbilt (TN)","2","10","0","0.16667","203","374","-171","Robbie Caldwell"
"2011","Vanderbilt (TN)","6","7","0","0.46154","347","281","66","James Franklin"
"2012","Vanderbilt (TN)","9","4","0","0.69231","390","243","147","James Franklin"
"2013","Vanderbilt (TN)","9","4","0","0.69231","391","320","71","James Franklin"
"2014","Vanderbilt (TN)","3","9","0","0.25","206","399","-193","Derek Mason"
"1891","West Virginia","0","1","0","0","0","72","-72","Frederick Lincoln Emory"
"1893","West Virginia","2","1","0","0.66667","24","60","-36","F. William ""John"" Rane"
"1894","West Virginia","2","2","0","0.5","28","52","-24","F. William ""John"" Rane"
"1895","West Virginia","5","1","0","0.83333","58","10","48","Harry McCrory"
"1896","West Virginia","3","7","2","0.33333","14","101","-87","Thomas Gawthrop ""Doggie"" Trenchard"
"1897","West Virginia","5","4","1","0.55","96","45","51","George R. Krebs"
"1934","West Virginia","6","4","0","0.6","117","113","4","Charles C. ""Trusty"" Tallman"
"1935","West Virginia","3","4","2","0.44444","129","96","33","Charles C. ""Trusty"" Tallman"
"1936","West Virginia","6","4","0","0.6","151","122","29","Charles C. ""Trusty"" Tallman"
"1937","West Virginia","8","1","1","0.85","183","39","144","Dr. Marshall ""Little Sleepy"" Glenn"
"1938","West Virginia","4","5","1","0.45","98","116","-18","Dr. Marshall ""Little Sleepy"" Glenn"
"1939","West Virginia","2","6","1","0.27778","70","94","-24","Dr. Marshall ""Little Sleepy"" Glenn"
"1940","West Virginia","4","4","1","0.5","127","94","33","William F. ""Bill"" Kern"
"1941","West Virginia","4","6","0","0.4","85","126","-41","William F. ""Bill"" Kern"
"1942","West Virginia","5","4","0","0.55556","119","91","28","William F. ""Bill"" Kern"
"1946","West Virginia","5","5","0","0.5","120","99","21","William F. ""Bill"" Kern"
"1947","West Virginia","6","4","0","0.6","252","84","168","William F. ""Bill"" Kern"
"1948","West Virginia","9","3","0","0.75","257","140","117","Dudley S. ""Dud"" DeGroot"
"1949","West Virginia","4","6","1","0.40909","227","275","-48","Dudley S. ""Dud"" DeGroot"
"1950","West Virginia","2","8","0","0.2","163","259","-96","Arthur ""Pappy"" Lewis"
"1951","West Virginia","5","5","0","0.5","225","190","35","Arthur ""Pappy"" Lewis"
"1952","West Virginia","7","2","0","0.77778","234","116","118","Arthur ""Pappy"" Lewis"
"1953","West Virginia","8","2","0","0.8","309","154","155","Arthur ""Pappy"" Lewis"
"1954","West Virginia","8","1","0","0.88889","209","74","135","Arthur ""Pappy"" Lewis"
"1955","West Virginia","8","2","0","0.8","285","104","181","Arthur ""Pappy"" Lewis"
"1956","West Virginia","6","4","0","0.6","130","106","24","Arthur ""Pappy"" Lewis"
"1957","West Virginia","7","2","1","0.75","179","118","61","Arthur ""Pappy"" Lewis"
"1958","West Virginia","4","5","1","0.45","268","200","68","Arthur ""Pappy"" Lewis"
"1959","West Virginia","3","7","0","0.3","74","204","-130","Arthur ""Pappy"" Lewis"
"1960","West Virginia","0","8","2","0.1","40","259","-219","Gene Corum"
"1961","West Virginia","4","6","0","0.4","134","145","-11","Gene Corum"
"1962","West Virginia","8","2","0","0.8","211","137","74","Gene Corum"
"1963","West Virginia","4","6","0","0.4","154","201","-47","Gene Corum"
"1964","West Virginia","7","4","0","0.63636","162","211","-49","Gene Corum"
"1965","West Virginia","6","4","0","0.6","279","264","15","Gene Corum"
"1966","West Virginia","3","5","2","0.4","158","197","-39","Jim Carlen"
"1967","West Virginia","5","4","1","0.55","188","117","71","Jim Carlen"
"1968","West Virginia","7","3","0","0.7","207","141","66","Jim Carlen"
"1969","West Virginia","10","1","0","0.90909","302","113","189","Jim Carlen"
"1970","West Virginia","8","3","0","0.72727","311","200","111","Bobby Bowden"
"1971","West Virginia","7","4","0","0.63636","280","220","60","Bobby Bowden"
"1972","West Virginia","8","4","0","0.66667","415","289","126","Bobby Bowden"
"1973","West Virginia","6","5","0","0.54545","212","266","-54","Bobby Bowden"
"1974","West Virginia","4","7","0","0.36364","210","224","-14","Bobby Bowden"
"1975","West Virginia","9","3","0","0.75","283","189","94","Bobby Bowden"
"1976","West Virginia","5","6","0","0.45455","184","202","-18","Frank Cignetti"
"1977","West Virginia","5","6","0","0.45455","244","264","-20","Frank Cignetti"
"1978","West Virginia","2","9","0","0.18182","167","364","-197","Frank Cignetti"
"1979","West Virginia","5","6","0","0.45455","185","279","-94","Frank Cignetti"
"1980","West Virginia","6","6","0","0.5","305","289","16","Don Nehlen"
"1981","West Virginia","9","3","0","0.75","284","155","129","Don Nehlen"
"1982","West Virginia","9","3","0","0.75","284","182","102","Don Nehlen"
"1983","West Virginia","9","3","0","0.75","322","189","133","Don Nehlen"
"1984","West Virginia","8","4","0","0.66667","259","170","89","Don Nehlen"
"1985","West Virginia","7","3","1","0.68182","189","158","31","Don Nehlen"
"1986","West Virginia","4","7","0","0.36364","210","286","-76","Don Nehlen"
"1987","West Virginia","6","6","0","0.5","330","212","118","Don Nehlen"
"1988","West Virginia","11","1","0","0.91667","493","208","285","Don Nehlen"
"1989","West Virginia","8","3","1","0.70833","339","221","118","Don Nehlen"
"1990","West Virginia","4","7","0","0.36364","217","238","-21","Don Nehlen"
"1991","West Virginia","6","5","0","0.54545","187","224","-37","Don Nehlen"
"1992","West Virginia","5","4","2","0.54545","286","238","48","Don Nehlen"
"1993","West Virginia","11","1","0","0.91667","408","212","196","Don Nehlen"
"1994","West Virginia","7","6","0","0.53846","296","286","10","Don Nehlen"
"1995","West Virginia","5","6","0","0.45455","253","210","43","Don Nehlen"
"1996","West Virginia","8","4","0","0.66667","271","156","115","Don Nehlen"
"1997","West Virginia","7","5","0","0.58333","360","285","75","Don Nehlen"
"1998","West Virginia","8","4","0","0.66667","410","267","143","Don Nehlen"
"1999","West Virginia","4","7","0","0.36364","292","289","3","Don Nehlen"
"2000","West Virginia","7","5","0","0.58333","356","363","-7","Don Nehlen"
"2001","West Virginia","3","8","0","0.27273","235","268","-33","Rich Rodriguez"
"2002","West Virginia","9","4","0","0.69231","396","302","94","Rich Rodriguez"
"2003","West Virginia","8","5","0","0.61538","376","297","79","Rich Rodriguez"
"2004","West Virginia","8","4","0","0.66667","361","246","115","Rich Rodriguez"
"2005","West Virginia","11","1","0","0.91667","385","214","171","Rich Rodriguez"
"2006","West Virginia","11","2","0","0.84615","505","282","223","Rich Rodriguez"
"2007","West Virginia","10","2","0","0.83333","467","207","260","Rich Rodriguez"
"2007","West Virginia","1","0","0","1","48","28","20","Bill Stewart"
"2008","West Virginia","9","4","0","0.69231","319","221","98","Bill Stewart"
"2009","West Virginia","9","4","0","0.69231","340","282","58","Bill Stewart"
"2010","West Virginia","9","4","0","0.69231","327","176","151","Bill Stewart"
"2011","West Virginia","10","3","0","0.76923","489","348","141","Dana Holgorsen"
"2012","West Virginia","7","6","0","0.53846","513","495","18","Dana Holgorsen"
"2013","West Virginia","4","8","0","0.33333","316","400","-84","Dana Holgorsen"
"2014","West Virginia","7","6","0","0.53846","435","359","76","Dana Holgorsen"
"1924","Ball St. (IN)","1","3","0","0.25000","11","87","-76","Paul ""Billy"" Williams"
"1925","Ball St. (IN)","2","5","0","0.28571","58","132","-74","Paul ""Billy"" Williams"
"1926","Ball St. (IN)","5","1","1","0.78571","127","53","74","Norman ""Happy"" Wann"
"1927","Ball St. (IN)","5","2","1","0.68750","152","109","43","Norman ""Happy"" Wann"
"1928","Ball St. (IN)","3","2","2","0.57143","88","50","38","Paul B. ""Shorty"" Parker"
"1929","Ball St. (IN)","0","7","0","0.00000","43","200","-157","Paul B. ""Shorty"" Parker"
"1930","Ball St. (IN)","6","1","0","0.85714","131","37","94","Lawrence McPhee"
"1931","Ball St. (IN)","2","6","0","0.25000","65","161","-96","Lawrence McPhee"
"1932","Ball St. (IN)","4","4","0","0.50000","102","90","12","Lawrence McPhee"
"1933","Ball St. (IN)","1","6","1","0.18750","20","90","-70","Lawrence McPhee"
"1934","Ball St. (IN)","2","6","0","0.25000","58","100","-42","Lawrence McPhee"
"1935","Ball St. (IN)","3","4","1","0.43750","77","66","11","John Magnabosco"
"1936","Ball St. (IN)","3","4","1","0.43750","78","55","23","John Magnabosco"
"1937","Ball St. (IN)","5","2","1","0.68750","135","38","97","John Magnabosco"
"1938","Ball St. (IN)","6","1","1","0.81250","131","48","83","John Magnabosco"
"1939","Ball St. (IN)","6","2","0","0.75000","112","69","43","John Magnabosco"
"1940","Ball St. (IN)","3","4","1","0.43750","78","69","9","John Magnabosco"
"1941","Ball St. (IN)","3","2","2","0.57143","98","26","72","John Magnabosco"
"1942","Ball St. (IN)","6","2","0","0.75000","178","58","120","John Magnabosco"
"1944","Ball St. (IN)","2","2","0","0.50000","58","45","13","John Magnabosco"
"1945","Ball St. (IN)","4","1","1","0.75000","119","27","92","John Magnabosco"
"1946","Ball St. (IN)","3","4","1","0.43750","101","67","34","John Magnabosco"
"1947","Ball St. (IN)","5","1","2","0.75000","99","53","46","John Magnabosco"
"1948","Ball St. (IN)","6","2","0","0.75000","155","73","82","John Magnabosco"
"1949","Ball St. (IN)","8","0","0","1.00000","276","61","215","John Magnabosco"
"1950","Ball St. (IN)","2","4","1","0.35714","74","122","-48","John Magnabosco"
"1951","Ball St. (IN)","0","6","1","0.07143","94","176","-82","John Magnabosco"
"1952","Ball St. (IN)","3","5","1","0.38889","164","167","-3","John Magnabosco"
"1953","Ball St. (IN)","5","2","1","0.68750","163","125","38","George Serdula"
"1954","Ball St. (IN)","6","2","0","0.75000","218","113","105","George Serdula"
"1955","Ball St. (IN)","3","5","0","0.37500","97","144","-47","George Serdula"
"1956","Ball St. (IN)","4","4","0","0.50000","116","203","-87","Jim Freeman"
"1957","Ball St. (IN)","2","5","1","0.31250","119","209","-90","Jim Freeman"
"1958","Ball St. (IN)","6","2","0","0.75000","140","69","71","Jim Freeman"
"1959","Ball St. (IN)","1","7","0","0.12500","66","172","-106","Jim Freeman"
"1960","Ball St. (IN)","3","5","0","0.37500","102","113","-11","Jim Freeman"
"1961","Ball St. (IN)","2","5","1","0.31250","68","179","-111","Jim Freeman"
"1962","Ball St. (IN)","4","3","1","0.56250","138","107","31","Ray Louthen"
"1963","Ball St. (IN)","5","3","0","0.62500","156","115","41","Ray Louthen"
"1964","Ball St. (IN)","5","3","0","0.62500","175","139","36","Ray Louthen"
"1965","Ball St. (IN)","9","0","1","0.95000","309","150","159","Ray Louthen"
"1966","Ball St. (IN)","7","1","1","0.83333","207","152","55","Ray Louthen"
"1967","Ball St. (IN)","7","3","0","0.70000","262","126","136","Ray Louthen"
"1968","Ball St. (IN)","5","4","0","0.55556","189","218","-29","Wave Myers"
"1969","Ball St. (IN)","5","5","0","0.50000","178","201","-23","Wave Myers"
"1970","Ball St. (IN)","5","5","0","0.50000","146","226","-80","Wave Myers"
"1971","Ball St. (IN)","4","5","1","0.45000","136","155","-19","Dave McClain"
"1972","Ball St. (IN)","5","4","1","0.55000","235","180","55","Dave McClain"
"1973","Ball St. (IN)","5","5","1","0.50000","226","201","25","Dave McClain"
"1974","Ball St. (IN)","6","4","0","0.60000","265","177","88","Dave McClain"
"1975","Ball St. (IN)","9","2","0","0.81818","244","171","73","Dave McClain"
"1976","Ball St. (IN)","8","3","0","0.72727","257","124","133","Dave McClain"
"1977","Ball St. (IN)","9","2","0","0.81818","377","169","208","Dave McClain"
"1978","Ball St. (IN)","10","1","0","0.90909","251","82","169","Dwight Wallace"
"1979","Ball St. (IN)","6","5","0","0.54545","272","191","81","Dwight Wallace"
"1980","Ball St. (IN)","6","5","0","0.54545","239","198","41","Dwight Wallace"
"1981","Ball St. (IN)","4","7","0","0.36364","157","218","-61","Dwight Wallace"
"1982","Ball St. (IN)","5","6","0","0.45455","177","207","-30","Dwight Wallace"
"1983","Ball St. (IN)","6","5","0","0.54545","247","302","-55","Dwight Wallace"
"1984","Ball St. (IN)","3","8","0","0.27273","134","275","-141","Dwight Wallace"
"1985","Ball St. (IN)","4","7","0","0.36364","203","283","-80","Paul Schudel"
"1986","Ball St. (IN)","6","5","0","0.54545","199","201","-2","Paul Schudel"
"1987","Ball St. (IN)","4","7","0","0.36364","226","255","-29","Paul Schudel"
"1988","Ball St. (IN)","8","3","0","0.72727","286","170","116","Paul Schudel"
"1989","Ball St. (IN)","7","3","2","0.66667","274","239","35","Paul Schudel"
"1990","Ball St. (IN)","7","4","0","0.63636","204","121","83","Paul Schudel"
"1991","Ball St. (IN)","6","5","0","0.54545","159","150","9","Paul Schudel"
"1992","Ball St. (IN)","5","6","0","0.45455","171","243","-72","Paul Schudel"
"1993","Ball St. (IN)","8","3","1","0.70833","301","265","36","Paul Schudel"
"1994","Ball St. (IN)","5","5","1","0.50000","276","296","-20","Paul Schudel"
"1995","Ball St. (IN)","7","4","0","0.63636","204","187","17","Bill Lynch"
"1996","Ball St. (IN)","8","4","0","0.66667","296","210","86","Bill Lynch"
"1997","Ball St. (IN)","5","6","0","0.45455","239","260","-21","Bill Lynch"
"1998","Ball St. (IN)","1","10","0","0.09091","150","343","-193","Bill Lynch"
"1999","Ball St. (IN)","0","11","0","0.00000","157","361","-204","Bill Lynch"
"2000","Ball St. (IN)","5","6","0","0.45455","212","349","-137","Bill Lynch"
"2001","Ball St. (IN)","5","6","0","0.45455","268","296","-28","Bill Lynch"
"2002","Ball St. (IN)","6","6","0","0.50000","278","333","-55","Bill Lynch"
"2003","Ball St. (IN)","4","8","0","0.33333","261","386","-125","Brady Hoke"
"2004","Ball St. (IN)","2","9","0","0.18182","225","405","-180","Brady Hoke"
"2005","Ball St. (IN)","4","7","0","0.36364","233","416","-183","Brady Hoke"
"2006","Ball St. (IN)","5","7","0","0.41667","326","309","17","Brady Hoke"
"2007","Ball St. (IN)","7","6","0","0.53846","409","368","41","Brady Hoke"
"2008","Ball St. (IN)","12","1","0","0.92308","476","242","234","Brady Hoke"
"2008","Ball St. (IN)","0","1","0","0.00000","13","45","-32","Stan Parrish"
"2009","Ball St. (IN)","2","10","0","0.16667","230","338","-108","Stan Parrish"
"2010","Ball St. (IN)","4","8","0","0.33333","264","365","-101","Stan Parrish"
"2011","Ball St. (IN)","6","6","0","0.50000","304","416","-112","Pete Lembo"
"2012","Ball St. (IN)","9","4","0","0.69231","437","416","21","Pete Lembo"
"2013","Ball St. (IN)","10","3","0","0.76923","501","321","180","Pete Lembo"
"2014","Ball St. (IN)","5","7","0","0.41667","332","326","6","Pete Lembo"
"1901","Marshall (WV)","18","40","4","0.32258","308","1022","-714","No Coach"
"1902","Marshall (WV)","3","2","2","0.57143","45","23","22","George Ford"
"1903","Marshall (WV)","3","2","1","0.58333","37","50","-13","George Ford"
"1904","Marshall (WV)","1","3","3","0.35714","16","26","-10","Alfred McCary"
"1905","Marshall (WV)","6","2","0","0.75000","40","98","-58","Alfred McCary"
"1906","Marshall (WV)","4","0","1","0.90000","56","5","51","Alfred McCary"
"1908","Marshall (WV)","2","6","0","0.25000","36","113","-77","W.G. Vinal"
"1909","Marshall (WV)","3","2","1","0.58333","107","95","12","Boyd B. Chambers"
"1910","Marshall (WV)","5","1","1","0.78571","91","14","77","Boyd B. Chambers"
"1911","Marshall (WV)","4","1","1","0.75000","122","22","100","Boyd B. Chambers"
"1912","Marshall (WV)","3","4","0","0.42857","197","94","103","Boyd B. Chambers"
"1913","Marshall (WV)","4","4","0","0.50000","85","101","-16","Boyd B. Chambers"
"1914","Marshall (WV)","5","5","0","0.50000","231","168","63","Boyd B. Chambers"
"1915","Marshall (WV)","1","8","0","0.11111","86","257","-171","Boyd B. Chambers"
"1916","Marshall (WV)","7","2","1","0.75000","267","102","165","Boyd B. Chambers"
"1917","Marshall (WV)","1","7","1","0.16667","8","345","-337","Carl Shipley"
"1919","Marshall (WV)","8","0","0","1.00000","302","13","289","Archer Reilly"
"1920","Marshall (WV)","0","8","0","0.00000","0","247","-247","Herbert Cramer"
"1921","Marshall (WV)","6","2","1","0.72222","86","41","45","Kemper Shelton"
"1922","Marshall (WV)","4","4","0","0.50000","155","94","61","Kemper Shelton"
"1922","Marshall (WV)","1","0","0","1.00000","71","6","65","Harrison Briggs"
"1923","Marshall (WV)","1","7","0","0.12500","28","277","-249","Harrison Briggs"
"1924","Marshall (WV)","4","3","1","0.56250","48","110","-62","Russel Meredith"
"1925","Marshall (WV)","4","1","4","0.66667","138","29","109","Charles C. ""Trusty"" Tallman"
"1926","Marshall (WV)","5","4","1","0.55000","150","99","51","Charles C. ""Trusty"" Tallman"
"1927","Marshall (WV)","5","3","1","0.61111","194","75","119","Charles C. ""Trusty"" Tallman"
"1928","Marshall (WV)","8","1","1","0.85000","175","33","142","Charles C. ""Trusty"" Tallman"
"1929","Marshall (WV)","5","3","1","0.61111","184","79","105","Johnny F. ""John"" Maulbetsch"
"1930","Marshall (WV)","3","5","1","0.38889","111","130","-19","Johnny F. ""John"" Maulbetsch"
"1931","Marshall (WV)","6","3","0","0.66667","214","84","130","Tom Dandelet"
"1932","Marshall (WV)","6","2","1","0.72222","161","58","103","Tom Dandelet"
"1933","Marshall (WV)","3","5","1","0.38889","109","103","6","Tom Dandelet"
"1934","Marshall (WV)","3","6","0","0.33333","93","111","-18","Tom Dandelet"
"1935","Marshall (WV)","4","6","0","0.40000","139","117","22","Cam Henderson"
"1936","Marshall (WV)","6","3","1","0.65000","304","78","226","Cam Henderson"
"1937","Marshall (WV)","9","0","1","0.95000","297","19","278","Cam Henderson"
"1938","Marshall (WV)","5","4","0","0.55556","274","67","207","Cam Henderson"
"1939","Marshall (WV)","9","2","0","0.81818","277","91","186","Cam Henderson"
"1940","Marshall (WV)","8","2","0","0.80000","334","75","259","Cam Henderson"
"1941","Marshall (WV)","7","1","0","0.87500","237","47","190","Cam Henderson"
"1942","Marshall (WV)","1","7","1","0.16667","52","118","-66","Cam Henderson"
"1946","Marshall (WV)","2","7","1","0.25000","145","190","-45","Cam Henderson"
"1947","Marshall (WV)","9","3","0","0.75000","342","125","217","Cam Henderson"
"1948","Marshall (WV)","2","7","1","0.25000","71","243","-172","Cam Henderson"
"1949","Marshall (WV)","6","4","0","0.60000","168","147","21","Cam Henderson"
"1950","Marshall (WV)","2","8","0","0.20000","107","249","-142","Pete Pedersen"
"1951","Marshall (WV)","5","5","1","0.50000","218","194","24","Pete Pedersen"
"1952","Marshall (WV)","2","7","2","0.27273","192","233","-41","Pete Pedersen"
"1953","Marshall (WV)","2","5","2","0.33333","109","180","-71","Herb Royer"
"1954","Marshall (WV)","4","5","0","0.44444","203","214","-11","Herb Royer"
"1955","Marshall (WV)","3","6","0","0.33333","159","192","-33","Herb Royer"
"1956","Marshall (WV)","3","6","0","0.33333","122","185","-63","Herb Royer"
"1957","Marshall (WV)","6","3","0","0.66667","120","112","8","Herb Royer"
"1958","Marshall (WV)","3","6","0","0.33333","111","165","-54","Herb Royer"
"1959","Marshall (WV)","1","8","0","0.11111","72","343","-271","Charlie Snyder"
"1960","Marshall (WV)","2","7","1","0.25000","58","160","-102","Charlie Snyder"
"1961","Marshall (WV)","2","7","1","0.25000","62","183","-121","Charlie Snyder"
"1962","Marshall (WV)","4","6","0","0.40000","137","237","-100","Charlie Snyder"
"1963","Marshall (WV)","5","4","1","0.55000","139","139","0","Charlie Snyder"
"1964","Marshall (WV)","7","3","0","0.70000","120","93","27","Charlie Snyder"
"1965","Marshall (WV)","5","5","0","0.50000","150","168","-18","Charlie Snyder"
"1966","Marshall (WV)","2","8","0","0.20000","113","210","-97","Charlie Snyder"
"1967","Marshall (WV)","0","10","0","0.00000","72","311","-239","Charlie Snyder"
"1968","Marshall (WV)","0","9","1","0.05000","129","358","-229","Perry L. Moss"
"1969","Marshall (WV)","3","7","0","0.30000","207","281","-74","Rick Tolley"
"1970","Marshall (WV)","3","6","0","0.33333","138","202","-64","Rick Tolley"
"1971","Marshall (WV)","2","8","0","0.20000","57","299","-242","Jack Lengyel"
"1972","Marshall (WV)","2","8","0","0.20000","93","254","-161","Jack Lengyel"
"1973","Marshall (WV)","4","7","0","0.36364","212","288","-76","Jack Lengyel"
"1974","Marshall (WV)","1","10","0","0.09091","111","291","-180","Jack Lengyel"
"1975","Marshall (WV)","2","9","0","0.18182","148","296","-148","Frank Ellwood"
"1976","Marshall (WV)","5","6","0","0.45455","151","243","-92","Frank Ellwood"
"1977","Marshall (WV)","2","9","0","0.18182","234","389","-155","Frank Ellwood"
"1978","Marshall (WV)","1","10","0","0.09091","113","292","-179","Frank Ellwood"
"1979","Marshall (WV)","1","10","0","0.09091","95","309","-214","Sonny Randle"
"1980","Marshall (WV)","2","8","1","0.22727","137","245","-108","Sonny Randle"
"1981","Marshall (WV)","2","9","0","0.18182","104","284","-180","Sonny Randle"
"1982","Marshall (WV)","3","8","0","0.27273","117","279","-162","Sonny Randle"
"1983","Marshall (WV)","4","7","0","0.36364","209","214","-5","Sonny Randle"
"1984","Marshall (WV)","6","5","0","0.54545","238","226","12","Stan Parrish"
"1985","Marshall (WV)","7","3","1","0.68182","193","197","-4","Stan Parrish"
"1986","Marshall (WV)","6","4","1","0.59091","287","199","88","George Chaump"
"1987","Marshall (WV)","10","5","0","0.66667","498","307","191","George Chaump"
"1988","Marshall (WV)","11","2","0","0.84615","370","234","136","George Chaump"
"1989","Marshall (WV)","6","5","0","0.54545","298","254","44","George Chaump"
"1990","Marshall (WV)","6","5","0","0.54545","310","162","148","Jim Donnan"
"1991","Marshall (WV)","11","4","0","0.73333","506","257","249","Jim Donnan"
"1992","Marshall (WV)","12","3","0","0.80000","604","292","312","Jim Donnan"
"1993","Marshall (WV)","11","4","0","0.73333","414","206","208","Jim Donnan"
"1994","Marshall (WV)","12","2","0","0.85714","560","212","348","Jim Donnan"
"1995","Marshall (WV)","12","3","0","0.80000","492","240","252","Jim Donnan"
"1996","Marshall (WV)","15","0","0","1.00000","658","210","448","Bob Pruett"
"1997","Marshall (WV)","10","3","0","0.76923","484","259","225","Bob Pruett"
"1998","Marshall (WV)","12","1","0","0.92308","405","236","169","Bob Pruett"
"1999","Marshall (WV)","13","0","0","1.00000","463","137","326","Bob Pruett"
"2000","Marshall (WV)","8","5","0","0.61538","367","297","70","Bob Pruett"
"2001","Marshall (WV)","11","2","0","0.84615","512","369","143","Bob Pruett"
"2002","Marshall (WV)","11","2","0","0.84615","457","315","142","Bob Pruett"
"2003","Marshall (WV)","8","4","0","0.66667","350","278","72","Bob Pruett"
"2004","Marshall (WV)","6","6","0","0.50000","291","266","25","Bob Pruett"
"2005","Marshall (WV)","4","7","0","0.36364","204","285","-81","Mark Snyder"
"2006","Marshall (WV)","5","7","0","0.41667","311","351","-40","Mark Snyder"
"2007","Marshall (WV)","3","9","0","0.25000","298","411","-113","Mark Snyder"
"2008","Marshall (WV)","4","8","0","0.33333","246","332","-86","Mark Snyder"
"2009","Marshall (WV)","6","6","0","0.50000","262","299","-37","Mark Snyder"
"2009","Marshall (WV)","1","0","0","1.00000","21","17","4","Rick Minter"
"2010","Marshall (WV)","5","7","0","0.41667","250","345","-95","John ""Doc"" Holliday"
"2011","Marshall (WV)","7","6","0","0.53846","284","372","-88","John ""Doc"" Holliday"
"2012","Marshall (WV)","5","7","0","0.41667","491","517","-26","John ""Doc"" Holliday"
"2013","Marshall (WV)","10","4","0","0.71429","590","321","269","John ""Doc"" Holliday"
"2014","Marshall (WV)","13","1","0","0.92857","638","294","344","John ""Doc"" Holliday"
